bei: ajo anu
gkj: gan wyi wpw
kfh: bqn bom cts apb ilh ioz
ixe: hiv
rcx: rnv rzs rtc beg buo czu asb and hmz
aqz: ihp hyx
yjw: wbb wcs wae won
ypa: lit wce dnn dus
ilm: hjm hff
dks: dhe dwa ddl dzy
ieo: hkv hfk
ydn: yos wjp woq dcs
rtj: cua avt api azf
kbz: bnh bfl ctc hyd hmq
gno: gtj gov wgd dek
lqk: wgt
yid: yht ynz yuv glr gjp
aso: ihx ipb img
rny: apl
yld: lyi lua gue goy wve wof dbp dff
abb: aaz ayi aqt iti
ypo: luh dqo
lst: gjg wxr wfk dqa
dbd: dce
czo: abg afk ivx inp
bqm: csl aax alh awm hfj
ktw: roc cnj aiz aju inp
bfc: bto hsb hmz
kfq: bpn bfz ckn ijr
rpd: rtr ald iwv har hpr hzc hzh
iob: hsi
riz: bff cvj cpq abi amf iro
ius: hbd
yxd: lho gtn wil wdu
koc: bai cur cot alt apn atu hsh
boz: cfa cot awi ato ihi izp
gxi: wcf wdf wjo wsi wmi
lis: lqn gdt gou wak wja wpy
rjh: bxy bte buv cqt ihx ien ifd
wzw: dgo jbk
bib: bon avq asg iry iwk
yxe: lbw lvh drg dgs
cht: acf afb iwc iua
ror: bze ckw iyd iva izx
ruc: cct ipg hlq
bmc: inx
wvo: dtb
chw: cdy igv ijw hin hqv
iep: hvl
cit: aae apo
ava: aog
awz: hrk
ild: inu hjv
rln: bnp cwr acy hfu
las: lxc wcs wxw dyv jre jbx
iaq: hla
cxo: aku anv afv itw hlx hdb
ydo: lny who
aap: axv azz ita hyf hfl
yry: ypb lkx lhx ltl wvi
rzo: bcj ajn hky hsg
lhg: lnu gvy wop dxg dpw
czq: cqq acu
wes: dco dpk
ivh: hif
bnb: bnt cjz akp had
rlt: rqb bjh crn cia apr hpf
cou: apa icu iag
lit: lpk gys geo guq wzi dep dnb jbk jbt
wce: dfw
cvc: cve aot igj
goe: wzg jbu
hmw: hzh
dii: dop
gcv: gpu gzb gup wkc wgp dgb
cyg: czz cqj cot isk
yiw: gfe gow whs wwj wpv dej
kls: kwk kmh rkp rac bbz bzn cha
rpq: ruu cku itq
adg: hyh hlk
dsn: dom
bnm: bqy cle cja axy atv hnv
irz: idj
yvr: lww ggu gnj wwg wem wfb daz
wbm: wzk jrq
bnk: cjf azi igz
doj: don
lsa: gkg waa dkf dbk
ksa: bwl iue hlb hwq hpm
aqb: izl hcu hel
lcw: lns lzz wrn jbt
ywt: ymy yum wco wdk wfw dgl
lkw: lkd lyo luk wzc dax
ige: idk
iqq: ito hak hlv
wxv: wug dmz jbn
ggr: gvc whi dbc jrr
klz: ris rgm bys bwm bqs abw apt iaa idh
wqi: dah
ril: btj cys cdd czv awc ijy hgr hwk
rop: bhu bnf ieb hmv
rqk: bzm akt alj adh aov
ghf: gel dur
yhk: yza wyn dha dja
cvf: ats aur
cif: aws
akm: ahr ihe izn
bgk: caf cxi hng
rlh: bct bzt cpq cfp awg ihe isk
ihf: hvr
gki: wvg dts jrx
bzq: ckh cxl aym hih hdh
bpp: cxm cza
bmb: bqb aia ijc ita
cmo: cqk hav
iwz: hix
laz: lwj loc ggm wet wni dso dxf
koi: cci cqm akg iim hjw
iuv: hlw hda hja hjq hel
hum: ycx ljr wox dlm dzf
gwe: gvd
bby: ctt hzb
bzu: cdx cxd cpv abd hlh
kju: kqy ryh byg hhr hfw
ifh: hcs hno
wae: djg dnz
ysl: lvq gro dkb dse dui
wyz: ddn dsn jkp
lrm: lyt git wnk dyg
rgi: rtq ckg agw iaf ieq
blh: cih hgb
krs: rke bkq bjt bzw btr iag hpi
clo: cor aem igf hcx hlo
dif: dvl
axl: iwk hbp hyi
arr: aiy anw hxe
kbi: kqm rli rdj rpz ajl igw hye
yxn: lwl ldt lxr gjv wcc wir wmh
kwd: kxh rvz rma rmv crd akm avm anu iau hgp
alj: anu hgg
rkq: rag bpl ctx anf hss
bzt: hfu
lkx: giq dsr duf
bwi: cnq hvc
bjg: ciy ciu acx acu anr itf
wnv: dam jky jre
wpl: wqg den
ajk: hwy
cdl: cmf czm hxx hxu hzl
ruw: ron biy axh iwf idx ipn hrx hlw hjq hzl
cqi: iuf hxt
cch: aie iks ius
dxn: dmk doa
cdi: abb hpz hzd
htt: gqc wtf dbq duj
axo: aqn
ryt: rnn aiv ipz hkr hzl
hun: lji wra wje dki
imi: hjd
yfp: lrn lpt ghb gny wln ddf jkh
drb: dtl
llw: wvc wfe
bgq: bfn bzx
gac: gii
lgm: dud duz
rit: bwu iyg
kqc: koa rwo rju bjx bsm bnt abl hco
cyf: cvy hcc
bhy: bxu inn hsk
yuk: lkd lob gia dzp doo jba
ara: ahy
rze: chm aeb ivg hwi
ban: ckg cry cxb ixj imd
cfp: ana auw ico iqt hii hzp
ksw: raz ref rof aes ise
btj: ird ixh
djk: dqk
rcw: bsi ahb hie hhr hes
icx: itq hey hfy
aei: izo hlh hmn
leh: gek dlj
wkg: wri wtl
cbp: iko iyf iuc hla hwo
lwt: lsw lux waj wnd dun
wgx: wqr
iuz: hgd
lsu: lmk gzq wfb wqr dcu
axh: aui igs iqb hfi hzn
rhp: clq azt inw
rrh: rdt rji rfy bcc bxp axk irp ibr iic itq hps
kqf: rtd roz bae bno ark ayq
wow: die dso dxj doz
lyv: lgj lvt gex wgi wuu dws
wbf: wpv dyi dwx
rcj: rxp rzx avb iqi hai hwk hec
lgb: gfn wju wvg dmz dfb
gau: gjw gje gsv gud wjv dfo jrw
chc: cxv icf hef
hug: lqe gvc gnq wry dxg dpg dtu doy
wuh: wob dkn dck
ldr: wcp wnz
kzv: rzy bjv ajf hld hmt
hkh: hbt
yrx: yyy yvr ypo llj gxl wfj dnp dqv
kak: kye ksr kea cja hvl
kso: rfd crh aar ioy
kid: ryi rgd rfg crw cby czz
aem: hhn
bhk: ahs
igi: ifo hvf
hkl: hrs
akl: iyx hlj
kdc: kdg rqm crn aru ilj hys
yvo: lxk gxt daf dop
bsl: ctk hhp
cpz: ack iwo itu
cgh: cfs awo ihl hgy hjx
rcg: rpb rur bhc bex bnf clw cuc aeq
kvr: boh cki cnd
ylk: yxz lbo gie wfu wtw dlf dpn
rno: ccg cfs ach iak iyj hgd hxi
aos: izi hxa
ihk: hzd
itu: hxe
bys: isp
rxf: rzo bvt ibs
ygx: yjc dem
ysm: lyh ldl lsi ghg dym
yca: lke lab lwk giw gyy whp wjk
lgk: lwi lfo gvm wem dek dmw
kvn: cby avo iay iqk hno
bmg: akc abg ajv iqe hci hyk
rja: bnf cvb cuw cou afs hax hzc
bsw: bnm cjn aka aik iyz
lyb: ldp lnl gaw gda wdp wvd wpx dco dpe
cid: csu awg
yle: ydr yup ltj wyj wlg dkm
ikf: iyr iej
kea: raj rox cya cus ibk hkv
ymr: ytq llg gbi gbu glv wvq
aao: aik iad iob hdu
wnp: wuw
kwg: kpa kzu blf bjk btk hhd
rkp: rpx aad anc
rew: rzk aso aev ier hgu hwi hxs
bnt: aov
khj: rwe cyv czk ats hrn hfd
cnw: iua hds hxe
bhn: boi iyi idy hih hel hex
ktg: rql bdd ccy cvr axh idv hcm
ijq: ifs
ajp: aew aqa aqu hwd hjd
rza: bum cdn avb app igg iml
yvx: gen wld dav dec deo dpe
alq: aud ikm
djv: dti
gis: gpd whp drr dgx dvk dty
lff: gau gva wjx
hyl: hlu
abm: iwv hxt
ykf: yll yzj gln gui wpq dlr
yyp: ylb gbm gwp wsu dhw
wry: wic dch dqk
ixo: ifs ioa hxq
bsp: cki hkc hhi
wwb: dad dvo jbw
bsq: cgh cfb aki iwe ino
wzs: wtw
kcx: kfj bdv akg aih icv ign hpj hmc hme
rev: bre bpl cfo aoo iut
liw: wgx wvf wms wqq wun dcu dau
yya: ygu lae lvj lxx wcx dxc
grc: gqd whz wfd dsi der
ghv: gjd wax
lgz: gki gkm gsj gnb gqg
kqx: raj rhs bfc bzi aox ibj
ijm: iuk
rzy: bcp caf hvx
dcc: dfq jkj
ctv: cut ikj iyq
kwk: kqd cfm alq ikz icl ipr hfk
ymg: lxy lor gao
dgh: dxe
djm: dfw dov
atr: iac hkl hao hgg
boy: cwt ijj hly
gym: wdb wxs wts dye
ljd: gew wtv dvo
yfg: lix llc gqo guc wou dlr dfs
rmp: bxf aur
yyt: lfk wgz wzn drs daz diw
dhh: dhe ddr dpe
rai: rvm rei rqc cmr afa
hce: hzh
hbl: hpo
ctu: acv ahz hhr hpo
dir: dye
cfu: iey
lna: gny wss
rad: rjx rek bjq caw aim apx hhf
gyt: gsc gpk gqg
bcz: bvg ibc
wsh: dxh
rwp: rez ccj ajz hsd
wfs: dvs
kpw: bws btt ctu asq igs
www: wph wpz
bpt: ckr ivm
lot: gra gvq gnz dkc
cxb: acb iix iev
wcu: dca dce dpg
kqs: bgn beb ayp hrr
bhd: byi blt chs asv apn aqg
bjd: ctx ipt hku
yvw: yek ynn lkc lkt ler gyi jbm
ltu: gmq gzl dkh dha
adp: irx ioc
hpj: hmi
hyt: hjc
gkb: gyi gfi wrf
gdx: wag wit wqx dir dib deg dod
gsb: den
wiv: wls
wds: wzp
wox: dgw
cgf: cfi hly
cut: arb
wuk: dsk
wda: dmx
gbt: gse dgk
cwl: cff acx inr ifz hpz hni
rxn: bdm crq ctn hjz
cmr: iph hxa
iqh: hvs
gsh: whe dxt
ikd: hae hqe
afx: iyp ioj hdr
iyk: iqm
hky: hij
bgx: bda cfi axq hbf
gxq: gxt wrf wrz wts dlf
hfg: hqi
dhb: dqp
gfb: dto
bon: hbk hpv
kwv: rab bhq anv hql
kkg: axd iby ida ido ise
rss: byn beo hbt
rig: bhu boz cxq adi ipv izt han
wht: wmb dln dmd dox jrt
gbk: gid wmw dcg
lfw: lfs wzd dqp
kqj: ktd bmo cuq iej ifa hyo hqp
wxl: wfr dxq dft dtv
gju: wiy djc ded
hsy: hfc
ceg: hge hzr
iak: ihi hkt
bcd: buz avc azi ive
rhr: ryu rwk rvx rnd rqh boc
lpl: luw ghg ddx dep
glz: wnm
kug: rcf bad bpi bqi cxw izq
hxb: hnj
aea: iuc hxl
yiv: ldj weq wnl wol dss
kip: kzg rgi atb hzw
khh: kql bci cqa ioe hnl
dmj: jkq
cup: adm ico ieb
huj: yco lgt gxu dla dfd
yii: ygs ywi ynb law wkh
yme: lou wvl
bzr: ckm agt haa hhi
ddc: jbx
why: wfr
rei: cze aqo
kxw: cku cpr czd ijm hcg hwr
bzl: cdl cje hhv hwn
kqa: rrm roz axv aos hla hxd
chp: clj icg ing itw
gyr: geu gtn wyw wmb woh
wor: woh dkq jkr jbh
hiu: hpd
wja: wux dlz
bqa: btb ceu arm ivt
gnh: wrs dsk
ylq: lbk gdw wht jkx
bep: aij ahu alg hkw
lgs: lxz gpt wcp dkd dxs dtb
lan: whu dla
glv: gvd
dli: dfq dou
cvv: abh agi iuv hbz
gfa: dzo
wil: dar dai
cnq: iid hbv
caq: cjz czh adt imk hgy
bsi: cwc apx
rwj: rdd reb rmu cvc hde hek
avv: apv
ixw: iqu
iyo: hcg hzx
gyk: wfp wov
cqk: akp ayf
ytq: lcn wjq wew
clc: hkf hsu
yqs: gnk dzl
dna: dux
ycv: ygv ghx gza dal dfo
rjv: rpk bmt cjj cxt ctz afb hjk
cjh: akn alu aek ijs
isu: iqp hrg
dht: dze dtp jky
ylf: ltl grz glf wik wtf dea jrn
bnu: cgx cja haz
adw: aei iaf
ibb: ipy
ctz: hrc hti
cvg: cqq aap aur
kmw: rhp ruy bvg ccz cvw
laj: gdq gos wht dlh dxt
gha: wha jbb
amf: azb ima hcg hmc
yjp: lll lxk lne gdo gnj
gkz: glt wgj
gwj: gvm gzc wvz dri dre dcx dtd
yit: lgj gut wsr wsq
anm: hva
ale: amw icw hbn
ler: gcq gps gzq gqy dca dci
cig: aqe icl
hct: hjh
lml: luv djq dsv
axm: itg hij hyn hxz
dsl: dsp
aka: hbw hac hso
axe: ivk hyt
icm: hbf hht
lee: gbo gec gue wzw
cyy: abu hcq hih hwf
csr: cfh arj aug
dgj: dgo dnt
dpz: dzd
ayy: ajr aqw hyz hlu
rvg: biw cog acw aua iuc hrd
kww: rzk cxu aqa izz
gqc: wfx dab jrf
cpf: ags iar ixw iol hhc hef
dij: dlk
ydh: ynb lhc lgz whn wnw
bdf: cyr czk his hsj
idt: ivp ixg hin
wpu: dph
gxw: whp wph
iav: hrq
bzh: cmr aey icx ihr idq hed
bkh: cfx ieu hkm
lzn: gkv wgr dxu
caz: aao aqv iie iwe hbg
req: rnw cai ibb hia
jka: jbx
gly: wfi dmx dud jkk
acq: iyf idy iex
lkq: ldi gvf gfy wsw
yvk: ypp lsa gac ghz wrk wrz wnp jrf
btg: ctx aqu hid
apo: ijf hlr
yyn: lpp lqg gaf gme wsr
ltm: ghw gms gul wjm
cfh: cqa hiq
gwi: wwd wpx dzp jkl
lkd: lbd laj llr llz wsc dlm dod
wlb: wgq dsi dsj dog
haa: hln
ykv: yge ymy lqb luk wxa dck dew
cln: aic hyf
cwi: ilu
ajh: iyj
dak: ddz
rct: roi bsz cqg abz ask itm hdv hnc
ama: hlq hfo
yjr: lrb las lwu wzr
cfo: auh ilv isl
dzu: dqk dtm
dri: dfo
yno: yqu les lxs gwd wdf div
kvl: kvo rom bka bqr
kwt: kfq rmp cpl axy haq hip
rdc: ctz ikc isb hcx
kdu: rxn asl axq idz
wgt: drw drt
aim: iks isv iqq hzl
iui: hfc
bvk: igk igu ipe
bmp: ift iqw hrx
wnn: dar dur
grt: wed wfc doy
cab: cjr abl ayh iyv hpg
kgp: kpv rsr bap cxx cpu ast
ymb: yul les gvw www wvg wos dwp
wyt: dqn
weq: dpu
cxw: icb ivl hgh hjz
iip: hnq hzl
gzu: whk dke dof
kbx: khx kel kxt blq
csf: avz ikx
kmu: ako azm iew ieo hgi
gaw: wxg dgz
kkt: rut ros cfa acu ayb als ieo
hog: gfa wda wmb dlc
llv: lwb lol wed dwk dvd duk
bls: bfj crx ave aeh
rtx: rui bhw bpp ibk hex
dqw: dqn
blk: bqh iyq
hkc: hru
alw: anq ixa hrq
yig: ypb gor dbp duo
wnq: drk dyy
cyz: ier hjx hpy hqj
rhx: cye cjx cfb anw iht igd
kqi: adw afm hsj
ypt: lnk lzp giq wvz wuh dqn
dmc: dmn dnb dnq
wkj: dcx jrc
avq: hko
ahv: hie
cbq: cxk arn isf
dbm: dta
rqj: czm iva izw hbv hwb
crl: cbr cvw akp avo aex anq inb hkw
kjf: aoo ind hyw
llg: lei gav wwm drw dau dia
bto: cam clh iay hey
hgv: hnt
bqi: cps agb hgy
izf: ioc ioz hcz
bro: bhk bqg crt aoc ihj
gvx: wzu dtr
agu: ijf hwn hqp
lio: ljv lsm lpq gst gfd wcv wgf dfz
grw: gbv gim wiz wxh dxe
wyo: wfa
wwh: dtj duk jrm
kjs: rgd bdy cnw ame ijn ivc
kpn: rgw rex rph bxb bnc acp alk atx aoa ivt
bav: bwo atc iyg ize
bte: crt akd aud
idp: hmp
gpl: wgq wnp
kzm: rzo ayb atp iky ikw ige ite
wbr: wvc wzg dvg dpm
wgp: dpk dms jkk
wrh: wiu wwc dym dzj
kuo: rrq bno idz haf hew
iqe: hng
gev: gpx dhk
ruh: ben ink hem
wep: drz
gtq: wdq woy
rra: rcz ckr akl arm
wbx: dvj dsv dfo jrt
wbz: why div jks
wxg: dos
luj: loh gmv wxw
cro: hsq
yte: gbw dxx jkf
wbo: wgl wmh dmr
kpl: kna cpe aig aga idm
gms: dlj
czz: ayw iog hep hnj
wlp: djp dvp dml jkg
lpa: goa wad
chn: cso cpy ibk hrn hcb
rwo: byx buy ajl
wpo: dch
gow: dck day jbe
wlh: wdt jkp
iho: hka hiq hyz
ros: bbb ayx
kgs: rgb bzj ido iee hlc
iqz: hvz hfc
ayh: amc ijs hrh
ygw: ymi yto lmf ltg gjb dvt
yip: ywm lgi lxu gvk wle wtd dje
asb: hxy
lsl: dys dts
bxx: cbz cap cfg aeq iim hqh
rur: bgf bje bpv cek cxg hgx
yow: glu gjg gxc wqv dki dcb dvx
lud: gjt gxw gzi gzv wlg
wkd: wcn drq dwm
cer: cxp amy hwq hsu hmk
bec: ayc
gtd: wnw
abf: azj hip hjz het
aie: ice izy hec
bnr: adt ize
wyr: dtz
avt: iyc iqq ioj hvv
wbk: wxd jrs
ibm: ifi hpe
ali: hbb
rgu: bwd hhl hpn
ggy: gjs wro wni wtq
cpn: ack iut
gyi: gtx
hoj: yko yyo yzk lif gal wgv wnw dlg
idc: ipc hpk hnr hzz
lct: lhf lfh dtj dus
wcx: wyp wsk wei dpf
lin: lli lqq lqo gzk dnh
iag: igy
yzm: ytc las lnf gdf wxa wfs dac
rva: bds bzm cjp asv aet
lur: wbk wzf dso
igv: hjp hmb
wlf: wsg del
alm: auw
izl: hwx
bad: afh iid ipq
ajj: aqk idr ixd
kre: aqs ire icy iyf hnm
csx: aqz hnq
wpy: dvd
rpj: cct agy ans imn
czr: amk
dil: dec dmu
bop: chh irk
bdr: cby cww cei apv afc ibl
kbl: rrb brz bnq alf ioq hpw
dnw: doj
rvi: caa apb hce hvl
gji: gez wnu
bsj: ccf arq ieo
ycs: gwm wxo das jrl
rkf: rqk bou icl icp ixx
dkg: dwn
rrc: cwu iur hcc
luq: gcc wgr wwm wjq jrw
rwe: rtz cgu ivi
cso: axi
box: cnv
hqu: yyw ysm gge dey deo dnj
wmk: dzc
cnc: cfr
grz: wwv
lmb: gkv wbm wcp weh
rgs: rdk bsa ann azj
ifx: hqd
gjm: gvq wad wdm wvz
cez: cqd ini
wdx: wua
wtu: dlt dzm
lze: gbj wnn
gff: wcw wub dpk dpx
yvh: lrg lpi gat dos
cic: cip ieh imy hcz hyr hmg
kkc: kwb cgk cwz csq ifd
csm: cok adv apd hch
afa: azv ivo hvc
hbx: hju hev
htj: yrd yrv yih lva gaj wdp dig
clh: cwx cqy ago hng
cpm: hky
ybr: laz gzb guf wcj dae dsp jrc
apf: aos itt hix
gqb: wan wpr jrj
drt: dob
lty: ggw gwz wrn wgs wuy dbn dvv dza
aas: hpz
buh: but cco aan imo
yvm: yfk lgy gfc gts wid dou
kiu: kpc bri hrv hfa
rtk: ilf ist iem hxb
cli: cmt abe awt aji
akq: arn ibr ibj iuw
cyv: ana hvq
guw: dvf dzh
akx: ibd hai hmj hqs
cqw: arv ipa hma
gmn: wmc dsv jrh
atv: aub irl hrw
cav: ahw apw iwr isr
bqp: aqp igb idp
yng: lfn dbz dww dtj
dqh: jkr
kfy: rbr rny bvd cca hpq
bfd: btl akt iik hyu
acv: adj hgl hxl
ibv: ibo
lnm: gmm wsp drm dvx
ysk: ynw lmx gwi wrn wnb diy dtw dug
iyy: iqd hjm hvz hea hpq
kta: rbp ras bsq btt cdc hgk
kqn: ktj bsd cdn ipc hry hjw
lnk: log glx gnh
cyo: amj auu ich
dce: dqz
kfk: rky bks ajj avp irq iyy hhp hvw
ahp: ivc iza iuu hhs hjg
auj: aum ipk iol
rnz: baq bye bsl
gqj: gus wgs wec
ldf: lew gdg gvb gei
kci: kor rwh cnn asn afd ikc ijh hcn hmy
kxk: rgs bul cbs axd azx aqz iup hnv
hwl: hda
gsw: gxh gto wca
wxc: dlx dwm
ber: cdu acl ieu har hxx
bds: bnh chg inj
dit: dlj doh jkk
rac: caf cde iyk
hbw: haw
ywl: lmp gvr wai wip wwc wmu daf dyi
wrg: wlu wuy
wbu: wak wyj ddu jrs jby
adx: amw hap hik hep
ybu: gyh ggd gty wrp dhx dsq
bjq: bxm aky igp
gsi: dwu jks
yva: ljg gsr wis web
arg: asw aqd aob hal
auc: hkf
rzi: bgq bdo bna cdy idn hlq hsh hpp
wzf: dtw
cls: cel ayp azf hfr hql
izo: hgo
ltp: gnf wjf wev wfl wtz drn
bwa: ajn ita hmp hzx
ldv: wbl wiw dmy dmg dun
bpg: cag aqf iau ids hjz
awo: ass iul iuf
cih: cjh cet hzu
ydl: leh gkg gdh gdv dsx
itl: hbf hpg
coc: atd ifr heg
hcu: hga
lym: leu dlx djp dnd
rog: beq cgb hia
giv: ggx wit wsd drd
bhu: ifd hzi hzh
ccf: ajg atk ibp hil hwg
kcz: kln rvw ret rpi cqw atj
ggi: jkm
wld: wlz
yqe: ljc lsz gmo wnw dbz djr
dxi: dqn
cjz: cpn aag ask igl hhj
ghi: gdr waw wav dsc dtl
ryx: rmb rno hrn
htg: yfw lio gkz gsg goh wul dcx dtp
ajb: axz ibz hjr
rff: cqa ihh iyr iek ifn hha
yfm: lni jrn
rag: rpc bss cmc hwr
gqw: gtg wno drh dpn
cyc: cdy cpz amc
ysh: lgm gxh gxl gfj wsa drk dds
bjh: cdc aiv ajy ivj hbj
awv: icl hao
ldz: ghy gou wlc dhx
knq: kfg rke btj ckv aeo
ret: bqy cbg adh ifp iuj hgf hvx
kys: rwj rvi bvw bvo cxq cmr abw ivb iuv
rzl: avn iuw hev
iax: izu
gof: wlg wgs dwu
wjg: dax jbz
hym: hxd
lmp: grr ghl gqu gtv wsg wtn dem dqi
rvj: rpm bfe irm hen
rtq: cad iri inx
dip: dqo
gsn: wdn wsq
gpr: wno dnx dfx dob
abx: amh iyb him
lsq: wet wqu drh dym dsd
lbv: lgw glm wbx wcj wui
bki: brj bem bzb cwi iym
ipu: hjb hqe
cbd: atr hgf
rhq: rwu bhb bwq cxx ais iky ijk
klk: ryg rgb rmm ciw ikq hke hvu
lsg: lpm grv gho wbn wym
wts: dde
atz: hzm
ynq: yqx wti dgl dmm
axd: isc
wsz: wmk dnc
yek: lgy lfv wvp
gkg: gps
ghw: wcp
cqd: ayr
rty: bjg cux aet him
rbu: rsg bxu iju hfe
cdb: cvo ivs hjq
wpb: wza dcl
gqf: dca dse dxa
loe: waq wge wwc woi diq
ggk: wky wxm woh
kjn: bat czt adi aer hnn
cqx: cou awj ikh hge hmy
gzb: www dxb jrz
lgw: lzg wzo dsf dzw
krm: rgo bmd bnd cia ctf abh
hae: hfz
gkt: gwc wwv wzp wtb jrg
rij: rim bnw cwg ahi iii hxs
int: iui
ddp: dnv
hio: hwq hfz
yci: lod ghz gvo wog dzc
aod: iyl
gbl: whb wto
wyw: wuc duz
bve: bmw ihp hhc
grm: weu dkm jck
cmv: agx ivz
wcc: wiy wns wuw dgx
yln: lpk ghd wcn wds dpp
lay: lsa lxq gsk wpf
brk: boq atr igk hbq hza
yka: gwy wjg jkw jkd
loq: gmt gnb ddb
ydx: ysl llp wdf dwv
icb: iak
kgn: rbe bkm brc brv bys csz ijy ixl hiw
cgc: aoq ilx haq
hoz: yjr lsd gxw gqp wct dlm
bhh: bea bqx ckz hbc
dcd: dlq dmr
lvh: ghd wrs wmh wnt deq
wcy: wqt dlp dzo
kni: rcw rsn cxa anj atx ibf hle
cub: awd ick ial hct
wit: whg dki dzl
doz: jby
kkj: kre rdb bpy buz aka aui
afn: iuw
rdj: clv ans hlp hnn
yfd: yqg ldr wcz wjt dij dqs
rub: cqp amd auc hyk
kjo: kvo rab cyc avq
beh: cij czc aql isr hiv
knf: rkv rvk bku bdt bfw cdk ipl
ccz: iks hja
yrj: yfn lqr wji wsm dyl dft
cds: hzz
whi: whu wxo
lde: wjv wez dwx dpm
kkk: rzw bag bji cqv cof axj aob iwe isc ish itl itu
dym: dvw dns jrp
ciz: ift hwl
wva: ddt djo jrb
hmp: hqc
ytt: lay wwo wsh dge
bxo: crr aty ato iuq
gjn: wcy wil wqu wtn dlx
gaz: gnh wjg wov dxq
ido: hiz hdv
ayb: itq
reb: ruy cwh cps ibb
iwh: hmc
hbo: hlg hfn
rmj: ruv bkc ccv cty cod aqb iku ivv
lka: lkg lbj gqm dra
bqb: cgx cpt
kos: rhm ckd apv ihz iqe hxp
adk: ict ipy hid hmy
crp: cjw aot
wpj: wzw dck
yhy: yuw yuv lhz lqy gyx
bky: bbg iqo hct hix
rgl: rqe bds bvj bqh bor csw ctm
gqz: gto gon wcv wla wmc jkh
rku: rpp aby ayw
hup: lwo lex goi dsi
gcs: wta dhq dxy doe
kba: kvj bfk cgm ayt apa hnm
kyy: kfz ram rgd cvu cmt agd azw hgn
dwa: dpi
lsh: loi loy gkg gns wfk
yfx: yzt yor wey dwz
gtt: wyk jbz
lpy: gri goo dwn
bns: ida ipn ifp
rsl: rzb bky ble cyd cjs ctk hdc
adu: iiu
gsv: wix daj dye dzs
bqd: cyi cum afg iil
rsk: cyy awx ioa
rlv: cjv aed
kpu: bha cir ajo ird ixl
rzb: adt ivv hgz hdg hpl hnk
cin: ilx iwp ivl hdk
apm: hdd
gnz: was wpb das dxd dom
ggq: guw dyy
lhs: lsy loo gyz gdu gsr gng
csj: cpj ihe izm hsx
ytj: lkh lyc ljh lfl gsp wop
wyd: wja
bvh: chk cud iuz
ktv: bzd ahp aom hyt
iyx: ixd iqa hsy
lng: gvd gmf wzw dww ddb dnv
lwo: gdu gnd
wxj: dxe
hrw: hzd
rez: rtp crc age apk iki irb
wis: woi jkl
iar: hyj
lsj: lui wce dkm dhy
ije: imj ins hli
grk: gls glu gmd dsa
baa: bqj anl isp
aec: ict iok hbk hmp hzl
rtt: cil cyj akz ils idp iuh hpe
kax: kix kfn kqj bbx ara
ijn: iuf
wsa: wsl wfj
chx: cwo aoz ikd hcc
csw: iyw ioz
liv: goo dkl dpd dpp
dld: ddd dof
dxa: dxp
dkp: ddi dsh
low: ghg gwk gmv wyz
liy: lwv ler gpt wqq dbm
gpz: dst
yzi: lnc wlw wmx dkq dip dhh
cno: akg ale ilt
kby: rwr bka chv icn
wat: wly wer dap dgf dej dmb
kal: kuq rwl rvc cug iqn hwd hvz
kji: cfo awf azb aoi
wrz: wjb wed wut woy duq
had: hpq
rek: rmj bfj bqz btc buz cek
ata: iys
lrk: ghx ggm gmk wkf
gfc: wiy wdy dxz
ylg: yxb gza gqn wrc wbm wsd
abp: iwk ien hbe
rkz: rxr atz aom iuq
wzp: dyk jro
wif: wmo wtr
ksb: rjt bnv avg ihq ivf hkk hgu
lfr: gcd wkd wvn dtm
baw: cbd ccu cyj aaw igg
dth: dtf
wgr: dil dhf jkw
daa: dql
lyp: lzy gms dkz dwx deu
ijd: hks hbf hjn
rvn: bff bzm bqb ahh ilm
ibp: hxs
yad: liq lte dby dbj dyr
bgp: caz hkr hbi hax
rfn: bfz cws adh ike ipc
itm: hps
ldm: ljr lsw gif wyo wph wfv
wdd: wxx ddf dev jrg
yyr: lct wdl wto dcy deu
kap: rwc byr czy ijt
chl: cxa cfr cor
cbc: aes atz
hcq: hmd hmv
kun: rmo rul auk
rti: rub iyt had hdr
whx: wuw
byd: bzj cqw alr anu
loy: gkx gkq gxi wbi wim
ilj: hio
bbm: bci bwc cft cqd ajj ato ijf imp hgq
dyr: ddl dde dsc
dwj: dvx
yod: lkm lwm gvh goe jbk
rtm: bra cbu cvx hqs
knk: rij rqx bkw bwg bdz bxz hzu
wxa: wqs dlt
krx: kqt ktb roy bpx
lbl: ldq lor gli wuz dnb
ghc: gpv dyv due jck
dfu: dzp
ggf: wrb wtz dpp dtf
lbs: llh gcp gjx wbn wao wer
cgm: hcv hmk
cve: ijg hpa
ggo: wjt dwo
rkh: ruc bav blt chg ibu hez
hyp: hwk
dki: dhj
ckd: cga cpw awj iab inc hrw
wmq: wzf dsw dnv
izh: hfu
giu: glp dko dfj
dar: dul
iim: iul
dtv: jrz
krt: kxm agz afr iaf
hnp: hzr
ddg: jbz
ynf: lka lay lve lmg lme lqs wfp wuq dtj
bip: hdt
cfn: aab hxo
gwq: wdq dal dwv dnq dzd
dra: jrb
yvj: wlq dyz dnr
gtn: wku det
kvp: kpd kpu rvw rum hnt
ghk: gum wmf
bgv: bmu ine ifh iut
ycg: gdt wgp wwg dfl
rqf: brf byo hse
aou: ikb
ggg: guc wbb wov dkh
yua: lxh wtm dis dgi
luf: gyn gdk gtb
kti: rpt cpq cte ikp ihy hel
wak: wlk dej
ysc: lmc lnu wlo wgl
ceo: hrl hlh hei hmn hfi
bsz: csf awk ixw hbn hyp hxj
ryy: roo chy czq aen iah ihe iuf
iuf: hri hmd
ium: hhw
gaj: gvt gey wpu jbi
yze: lqz gbn gjc wmk dqa
rda: bgk bqc cxd ajf azk iee its
yly: ytv ljg wjf wzb wzy dsh
bzx: icz hyn hvm
wer: dtw dtq
kaj: knx rau rla rvx bfr
bwr: cym ctg aws awe iff hjs
cnu: acg hrd
hgp: hpq hqp
gwv: gnk dco dgv jku
bau: bix bnr abv aon
rnv: izj hky hbg
ixr: hpt hmh
kll: kuw bkz bwx amj anb iyu
czm: hdk
gto: wnl wos
gvp: gxd wxp
gsz: wjj wzj dht dqg
htb: htw ybi yzv gpx dai dlz dtj jbb
gke: wih wsk wsp dka dsv
rin: aed ibb hsd
aal: hsn
dhj: dgb
lgf: gip guc wxu dkr dkh dzn
ijj: inl het
dzb: dzg
ygo: lww ggd ggt gdh wjo
kny: rbc bzk ccj cod apd ids ifm hro
bdj: bmh ciu cqk hku
bvf: bqr ahe hye
ybc: yar yav gqw god dzi
ljy: gkl wyh wsx weq
lhl: lmj lze gwo gzt wxk dkf
kkn: kcn rxo bpx anf irx ipb hdq
ivd: hhw hlz hev hft
lsy: gog wbs woz dis djj
rdi: aep ius hku hhq hly
ksr: rbw riu rjw boh aus hih
cgv: ifc hvl hed
gwg: gen gxg gol wxs
ixp: iqg hql
aes: aqe
wfc: dow
kov: rtg bjj csn ajv asg icm
wqa: wuq dbh
lyl: grp gcj gdc gtl gte
bvd: iro iiy hfq
wie: wwu wtd
yve: lvl lui gnb guh wzj
yok: lkz ghc wta
iky: ixm hqp
gcx: wzc dbh daw dik def dfy dtp
rof: bar aly hcd
alx: ief iuc
bwg: clc cwf ago iww hrb
djc: dtd jko
wui: wov
awq: hcb
rfq: bhk bnp ccq aiz ihn
hte: yyg yma ync lpe gaj gix gsu wkq wiq wwy dcr dwi dup
day: jkr
yfv: lla lsp lzs gcy gvj jcr
bol: com ikw iqd hyl
lgg: lfn gdu dmx dnw
lpi: lof gdp gzf whd wgo wul dcy dwc
guy: ddg
itv: hls
yvc: yzc yol ljq gbr ges weu dgi
bou: cxz cfm iyo
rfb: rfn bln cxh aap ife
rzg: bhc bfr hzu
wni: wot
kus: bhe cgy aou hlh hjj
cnj: aoh izs
cfz: abn ixl hrh hni
ddo: dtt
dea: dup
rvf: rnn bbq cmk cmu alx ikr iwy imq
yrp: yja yse gmi wrk wqa wud
apb: aqp aus iqs
dhi: dht dgx
yuj: gag gde geh gmz gmo wxu wta djd dfw
awa: ijm hbf han
rxo: cga iba hai hen
arb: aga
dko: dqd
bkj: buz ais agt aop
ijc: hka hmo
lnw: ggj gew gok wbf
khp: klq rbu rld cwz cdu ahw ael hli
kej: rfu rqa bhu cby ajc iev
kod: rwf bgc bdt cwv ikx hxf
izz: hbt hln
igm: itk hvf hzq
lkg: glh djh
wlz: wdy wxd
rta: bac bur cvf ayg ihy iml hiw hfr
deq: dnw
kms: rpu bfb chk cqj
igk: isq
lzm: ltv lud gdz whi
bej: cbk
kpt: res rpj bmg boi cqv ino
bmj: cwl czs ibd
ryk: cki ceu aws avf hnb
kuj: blf ccq cil ceo cfm ixf
iks: iud hgo
kke: keu ktk rds bue csc cxy hbw hjm
cel: cow axo icz hqy
whv: daa dst dme dzr
kbo: kgt kno rae coa hag hix
ydm: ysb lxm lqo dcq
buo: cuj axc hhd hdp
bcg: blg cwq cuz hka
bel: bua czj agj atl ieb izx
ywj: ghx gsj gqe dvr jrq jck
ruu: cko ccj ctn iiw imd
axw: iqh itj hxk
knm: rhj rwq rvu rsy rei bvw cuj
grj: gss gef wll
yax: ysf yoc lan llt lsu gxo
aay: igj ify
wnu: dyu jbj
run: awq ihz
wyb: wjg wtm jrm
ksy: bks cld irj inh
yxc: lre lea gzb wcp dwf
ljq: wwv
bpm: ibq hrq
aep: axb hao hwa
hro: hcl
wwe: wda wxz dsh dpf dmg
whu: wsl
dwn: ded dup
dly: jkv
kje: rxc cpq ici hjx hql
wsr: dzh
hqt: hup lyh luu ggd goy djq dpe
izv: hmq
woi: dgu dpd
ajf: afd ivg
csc: cqy agg adz aju
lrc: ltw gkm wim wha wpy
lbm: gjh wjw
izq: hcw hzk
kie: rat cep ctd ajt imy har
bos: cao csh ann
kmg: ktj rmt akn icn izr hyt
rul: bvm ave aqc
rdd: rqx bpx hjn
kqu: rdw red rxw cje amn ila
ala: amj hfv
gmv: wlb dsz jku
wdn: wzk
clm: ahz atz hvn
lcq: giy gwm gzy
asq: ija hcf
iqi: hqa
kqz: bcf hbj hvo hpu hfm
gpj: wsg woo
rpc: rfx bri hbo hvl
ctl: ayr ajr ajf ivn
cvx: igl
kpy: bxr cwp cto alg ika
aau: alz agu azk
wba: wwp jkl jkp
yfu: lna ltd ghi ggd gsf dyp dgs ddy dpf
gbe: wep
cpl: ctr
gch: gxe whp ddt dts
aci: aay aiy hks hgr hwd
wtv: det
cvo: cqq ivf hct hjz
rol: bqy cxq cfw alt iwo
ade: imi hsc
cek: azn ilt
lkr: lcq ldw dgh
azk: iva
yqa: wba wgl wmo div dhs
dbw: dgy dsk
isj: hez hmm hzk
yff: yos lro lit wxx ddj
gxy: wde dvi dzy
rpo: bab cvx aos
gzw: dkh
gjt: gfq wji dcr dwt
yhu: yje lwd gxp gpf dkl dnr
rqw: byz cbt chv aej ibh
gsg: wss dzp
imr: hgz
lnl: gyg wvd dar
gmj: wkf wwm dtp
yrc: lag guj goc wke dzr
cos: igd ivs ipg iqw ioc
reg: ros cfw ibf ihb ivq
dxz: dpv
aqf: ijm
ctn: aay
dxh: dfm dzd
ltc: gdj gvt wkp ddg
kmm: awd ajq amm itf
yye: yyu yzb yqy lni ggw wio dcm
wri: wao wjp wqb dhy
lhx: lfj lqc gjm dlp dwz
rnb: rou cts afc idt
wnf: dad
gim: gqj gur wrm woa
rbg: rqz bex bfv cyo cle axc hcr
wii: wld wut
ddd: djn dpt
btr: cbq cvr cnb hqr
bcc: cwc
bgf: aux heq hpw
lwa: gus wxy ddp doc
rtn: cqz aqh ier ixz ipl
rhm: rfb hhw
ybh: gzr gus gov wki wkq wjk drk
gtl: gom wlo deo dxb
cho: aaq hgy hms
bkq: cwr cda ajp
coo: acb icq igl ifj
gie: gfi wda wqs dpu
kvk: riv clu czq ahx axt
cox: aue iih iwb hla hll
rde: rjn clh aao ajg
ciy: atu irw hij
bpz: cio cvc cqv air
agr: idz hid hyp
kif: rhg cgq ava aue hrt hqk
aui: hwm
kat: bws buq azb ilf izu
rks: rqh ifk hrd
rre: rhk csu cex czq aqe hat hps
rjr: cdo aif agi imf hln
yiz: yfm lun lox gql gqt dra jbo
gwh: gpq wlb wgg
ria: rtd cau cdv iaq iut hxe
rah: rni ruq cqv icd
avf: ilw hdh
bdo: bjr atf iwa hhc
gmz: gtb dvn
azy: iyr
klx: kds kot bne abs awd adj ajb hre hvb
csu: isf itl
brg: bup cno ikl iry idd
ghg: geb gub wik
rsq: bnv cwq cqe icp iir ijx
ynd: ynx lbf lnw wsk dzo
dyu: jbg
yaq: llm lmi los gbf dyu dfk
bmq: caz afd auw itk
ldk: ltl gmw gtu dhj doq
ykj: ysp lei gpo gfd djm
kqt: kos rdx bly bts cba
yjd: yzr waz wot dqh
rkj: rpr cim aeb aui
bid: bub avd amq aoz idl
kow: cbb cpb afa iuy
brx: bpm cak cio iyw
bwq: bnn btb ikg
gdr: wnb
ahu: ajc ave ipr hrr
bne: cbh cjg ate iom hsy
lcu: gkj gfb wnb woq dmq dud doi
hof: lkp wlb wfb doi
ccx: csy cpt hex
djd: dxk
yrr: lno gjk whg wpv dyq
drf: daa dhj dxe dqj
ltt: gzg wwj dek
cgs: aol ilr hqh
gdo: wwf dcj dgn
lcx: lqt gva wnb dms
yqb: ytq lri lgj gls gex
ygg: yjr yeq lhk lpw wwc dib
cap: cma axn ivf
gti: wur dwx due
kxv: ryk bpk ajq ixe hii
bdy: bon cym aec aey auf hbr hvm
iuj: hrj hni
iol: hlg
bvz: cwb avg axb ibv hjg
wxy: dng
anp: ibt hvb hms
kqe: rtr bpe ckp ccp cvc hwr
cix: iya idm hbc
wmx: drp jbw
wvp: dcr dwt
yxm: lmn lue ggv gxj wrd wqo dql
rkw: bci bjy crv cyp cfv izs hxp
ahk: awp idq hql
gbs: gng gts wcv dbt
ybb: gvn wbq wck dcb
doc: dot
lqj: gac dbx dim dla
lrd: lsy wks wrm
wsn: wqi
drz: jrx
lyr: ldl ltd gwu dcz
wix: wti
cwx: air hjw
izr: hch hne
awf: hkk hav hsb hnz
cuq: ali apk ikd hil
rdk: bhs bvc boa ada ifc hyr
hgk: hgf hnw
hcj: hnu
arc: iqq
ipa: izs iqy hgx hnu hfb
rrv: bbp blw ihp ipf
gkw: wab wjh dkn dhm
wic: wgj wst wnf wuc dhw
gdl: gmw wey wzi
cjs: cen ark ano
ypj: ynx gkb ggu gqd goe wyr wea wmz
ayi: afi afv icj
wfw: dhc dxe jbc
lwu: lel gvz dfy
iaf: iir hsi hxo
rxw: row csl asp hda
gpu: wya dhe dox
afg: hym
bpy: bfa cyu cej akj aro iip hhv hzm hqg
htn: lsv lpl gax gwa gdh waq wnw
klr: rzj cvt idh isz
wqj: dgy dwb
cgg: coh ahc hey
wlr: djh def dpx
kfg: kqk cyr cfr iot
bgm: bth cud awz hvl
bey: bfo azm ikx ipi
hod: gmh wlb dal dfm
cpg: afk ixg iog
div: dew
rik: crf cla cjf cpq czn ihe
lry: lml gue dlt
byu: bes bzw cxf abg aaq hsi
gee: gmu gux wmj wfz den dto
wyq: wqv wqp drs
ged: dpq dqj
htu: ymu wwr wmp wqw
kkr: kvh kfu cgj axx ifs iux
gbo: goj wjs dxx dqt
bco: bje cqy ctw ijt itu
kcb: blk clw ada aza ivo
lno: lfx lov dgw
rnc: bdo ihq
bso: cac ijz iph
bgz: bgo bfg cwl cpx ant
ica: hkt hjo
bgr: cjb cpw iwo hay hwl
kzo: kui cqi ctn ash irj iuc
gsl: wyj wlq dmn
wwd: wxm dwo
kes: rjx bto cdk cef
wyy: dav dzk dux
wmj: dik
lsd: wza daw
ykd: yme lla lwf gjo wdb dld dxe dng jku
lew: gnt wjr dpk
buq: izj hgg
aju: ike hkh
klj: ryu roi hjs
wyv: wvr
rkl: ces aah aek aqz
hft: hzr
knw: bpf akl iaj
kyd: rjr rtj bgj adu afi hjj
rqz: bgd bse ajg idw hfd
rzv: bzr chf cqf adv hyy
ryz: cbw cvr izq iqz hva
ywx: lwp lzu win dcs
rxi: brc abz ane hbv
byb: ars ibz iwn
loj: gbn wvp
bxf: cqc abm alo
aqj: ien hyp
yqc: lmy gwr gmh dqy
wql: duf
wej: wtf div dfl
dlw: dfh
bnx: bue cbk icg
apx: afp auf iqw
rns: ruc cnq azg
yia: yjl yzo gjy
ymz: lqv loq ghw ggg gpy gnm wsj
agx: inr
wir: ddq
ddy: jkx jbb
ymm: lrx gkf gvo wxi
bce: bsi ixy
kdt: rle bkd bui chh acz hnu
glr: wkh wnh
kqp: kua bjk cel akz atm hwq hjt
idm: hly hjm hsi
azn: aqz ice iik
cfq: aeu ivq hzh
wqn: dro dgj dxb
wty: dwt dvu jbw
lpe: wel dhd dti
dfr: dfh
gek: wey drv jrx
ytn: llo wqc dhx
wap: wjq
gec: dfx
ghm: wxe dij
kvq: ktj reb bcw bpj him hdq
ksf: kzo bpv cww arw ixq
cwy: apw iao iup hrz hph
gdd: wkb wsb wqu dhc dso ded jko
lid: lsl lqu gle dvf dfu jkn
kna: atn imc hjp
ael: ico iys idk
rmn: ayn ijc
gov: wkg
gjs: gut wxt wzl dkg
ast: apy iwk
lla: gld gvk dim dsp dui
ybs: yed gso gua gud dyt jkg
aqm: imp
wky: dbc dcj
cbj: caf alk iin itd hnk
wzu: dhb
ibj: hjj
bhc: bpg cbm hwi hqb
yfh: lhy loo wsk
whk: wqk
bmr: bmh buf ahg awz ibe ipg hga
crh: cdc hks hlp
lvv: gcf gfm wca wlf dge
ado: aji icl hgp
rtl: ros bli bsd aky ijn
kmk: rve cpm ahb ati hyu
gzp: dkb dvr
ydz: lpy gkb gom wqv dcj djl dvu
ins: hpa
ydi: gbv gin gmj dse
cqr: abx ago asr
kwu: ban ckc hyd hzf
lij: gkq wia wuf wok dsv
kur: rky rvn bqb cwc het
lmx: gcm wbl wqn
wgc: dwn dnt
gcf: gdt duz
ymo: gvq wdr wvb wen wxj dvv
yux: lcx gqg wfg dbj dbf dyb
cna: iso hal
waj: wgq dbp
yhg: geb wcf wmr wqr
bnj: bor cdd agp ilb iwf ixb hej
bif: bwk bxk cia cdd ctb cof ioe
ytm: lxf wcr dfw dol
kio: ryk ccx imp hgy hzx
bgc: aji hfi
gcb: ggb wic whz wyb wzk
gyp: wrs wsd wtb dgd
lxe: wwd wfi jkw
cac: aqx hzc
wyp: wsq dfo dqa
bbw: cke ccj cdw ihr
cvi: apd aot iow
ymy: lal ltz gga geb gqo guy jbt
brp: bho bee aaf
wdc: wof
hjb: hvu
lha: wse jkx jbx
rtb: bzt avi hvr
avg: ils iet itx
rba: rgu czj ayw ajz igc iga igq hyz
ibx: iei iqj
kja: ryx rfm rul bnk awp aeo hil
can: clk iqt hnt
cci: ayk azp ija hkg hbz
chg: aea afj ifu
ajo: asf iaq iiz imz
kvt: rjw bcd cil hjy
amn: aua
dnh: duw
lyi: git gyq dby dxd
ioe: hhb
wsd: drn dya
iod: hre hww
kau: bjq ayv hxd hzc
dkv: dks dhb
hpu: hfh
ktz: rbx raf awm apl iyj iva hdt
krd: cby cjv coe afe iex inf hes
lrb: jkz
kgc: kdr rzf bfc cgb agn
cuv: acy hyc
kwi: rrn cgx cjx cjp iyh hpx
yuv: lmi gyc gwh gei wkz wbv dnx
kht: bqa cju hck hdd hdp
cra: iym izy
bhv: bei hrk hlp
cuu: ioi hyh
gnm: goo wio dha dsk dep
ihp: iyf iep
bcb: cdv ayp avh ica hbd hsw
wln: weh wqz woq dns
wjh: wem dwv
lqv: gzn dhq dvb
kwo: rbl rvk cdw hpn
gbi: gdr dma
rrd: raq byj bva bxv cku cid inj hyb
rvd: cuu iar hmy hqh
ras: boq cfd ajx hij hwv
hbp: hcm
yge: yda ysl gjs gzl wkw wnw djn
acu: ien
kaq: rjc rsk bkz bzf hxp
kbq: rog bjm ail ago ilf
lel: lmp gts dzm
yex: lrh gyy wrx wqm dpi dfy
wan: wlt wdl
gqa: wec wxh
kkf: kuv rxg rnm ijg hez
wlc: wmp dbj
che: heu hqk
afe: isy
kpa: rbr bgd cke aoj
wzy: def dqq
dfq: dof
yxl: lgz gmf wgd wza dly dgi jrc jrt
kok: rcn cru ayj iiq hfa
kup: cce cgy acu iea hnb
gua: det
gmy: gny wqt dey
ysq: gjj wvm dxl
yaf: lbm grs gsv wqv dso dnb
afk: ixs ifd
llh: gwa wah wti
rpv: rnl blj hkf hyq
czw: acx hkn
wpn: ddl dfr
lwi: lse gfo wjy
kro: knu brs crv cjc axf iae
ibh: hhg heg
inj: iov
bkb: agz asg hgg
ycw: ycx ycz yiv lgj ljb ljo wrm weo dhp
wff: wtz dcw dxl
crk: cbk ipm hex
ypq: lcy wxa wpa dct jkr
gse: gps wsm wpo dsq
wpg: wqc dsg dxd dmi
wwz: wet
hut: ykg ybu lav lye
rbd: bbc biu cme cqy izk hza
gjf: gex wuh dcd dxk jrw
gja: gjj why
cto: coq abj hgx
amd: iwc itc hju hqh
dwe: djq jkm
ibe: iaw idn hdf
gvt: wbp wyl
agj: apg amy izk
wuw: dwg
aug: iva hcg hfg
lvk: gyi wkd dpe dpf
byn: bti cqf acq hfe
wjm: dpc jbs
kgd: kja cmo czf icm izc hdn
cpa: awn izl
asn: ish
bfb: ccd cxc icc hee
grd: whc dgr ddk djk
ksk: kze bgd bzd ako alb ibm hzg
ibq: ixm ita
gxd: gms waf wdm dqn jrp
yyo: gij gsp gtl wvh wth dcj dcs dtu jbg
klq: rsz cup air ipj hlv
ckr: avg ibh idz hjp
rww: rqn cht afl ixd hks hwq
iei: iug hqw
gea: woi dxm
yfb: lhi ltn gaf gsh gol wyv wlm wdv dan
ahj: azl hha
gde: gow jrr
djs: duc duv
ibc: iiv hxn
kux: rnj cpb apa iba
byj: bzg cxr aam hpe
gwr: gey wra wum dqv
gmk: dig djy dsm jbs
lfk: wih wiz wow dyd dmg
byo: bjl chh agz iws iuy hvg
cni: ahe iym hvh hvf
cie: czm akq abd
rky: rit cac anf ili hxn
lhz: ldm wjd wmi dgo
rqe: bde bso bff cyd iii
ayj: add hgk hfn
asu: iks hir hit hzl
iea: hvd
wmh: drp dxx
yys: lvx wka whs wwq wvi ddt
gfj: wka wcb dvl dmk
ylw: lps who dyw dvs
dfk: dqg
lzk: gkv gfw wdv wsy drg dhg
rbh: rvs cgh czq aba izb
hom: yrk yft yzv gwd gdn wci dzs dqi
gxt: wgb wmm dqt
aus: idu ift izc
rwl: chv cnl aty
wmw: wzj ddv dzs
bpn: amt afo iub hmq
ijy: hfd
yae: ywk llu gzx wut dhv
ahc: aqj ath izy
inc: iou
akk: itl hpf
ayl: alj isp
ldl: lna gjl dbp
wne: ddh dsn due jke
gfe: wmw dlw dnz
lwf: loz gxf wru doj
ami: ifi ioy hrh
iyu: ifx
ywm: lqn goi wnl dvl dni
ynh: lrw gcs wae wsi
ciq: czg czx
bhi: bjn bqm crg che cna isu hga
ita: hei
yak: lin lzc gnm wmn din dlw jrr
rfs: rza bwu cwj cmh isx inq
rzf: cgo cod api ilp ilo
bba: btz ccy ary imt
clu: cep czi abc aal aho amm hmu
kxh: ree rou bpr adt aps ijq izm hps
yby: lar gvd wwe wvv
asj: amg ihl ily hlx hga hxg
ivw: iqc hdi
ymd: lar lgq lxe lph gbt gir wmn dxo
kyl: bin bqy acl awp aes ixz
brn: bad bsp ame iwc hwx
lmu: lqq lug gnk gte wtt wor dac dex
wgk: dai dox
kvf: kot ahq hmz
kox: rcq cwp aav aoc iru ijq ifq
aro: axw afg ihr
ckc: cic cdn ihk iyn ite hiy hxg
haj: hmj
bac: cai cla cnl ast iot
irv: igq hsq
rzc: bqu cfu aqx hkh
cmw: ank hgm
wqm: dzu
yji: ypl lzh gcf gan gio dmh jrh
axj: igx
wro: dyg dma
rfk: bao cjf hbs
cao: ase axy hit
lxw: lqx win wsd wsx dvf dms
wee: wux
rfh: bkc bkz azf
gco: gfi wkj wal wxf din dqy
dxw: dnd
bhg: cyc cjz iqi
lbr: lyk lsv grm gim deg jkj
anw: aut hqr
ynx: lrp lyi ggo gsn gme dbf
hhh: hdn hzz
cmj: acy ahd had
wtd: diy dip dha
kwr: kmw rwb aph
abh: apn hbq
wsl: wsx wtr dcc
dgg: ddo dff
wha: drw dwl ddm dqj dtd
bah: bhd cgg cfa agb agn iba hnq
diz: dya
ati: iqe hsu
yqk: lrr gng gut wwy wxk dkj
ijv: izh ity iuc hei hmh
brf: acu adf atq irk iwq
kps: cbj cdo cvh ikn ivk
kit: rll rmu bhr bpo azk itr
cki: cjp cet aym
wiz: whq wmf
blz: bmr bmg ibg hrl
ynm: lka lbx lpb gvl wlx drs
gia: gzp gtr dei
kxp: bkx boa cut aal ikw ixx hke
gax: gqn wct whr wxy wft
kzj: rzm bvb bpe cdt ami hgd
bqr: ipx him hzc
dho: dgj dxm
lxj: ltp gvt wvj drn dyx dpr
lpw: gru gll wps drr dri dsw
akp: aer hdm
bca: bjk bsv bug asg hlv hxd hmn
rrw: blu cbc inr
dcu: dnu
gpp: wma ddk dqq
bvu: bxm czz awk axy int hwa
rmi: bri iia hgu
ghu: whg dvp
kxj: bqe cuj aov hnp hzt
iud: hgj
atb: hdo heq hpg
kpg: kpf rli rxq rov bli bzz
wms: dsg
cod: ahm axj ilr
ymk: grc gan wyg
aen: iju isg
yxb: ynh yua lzm ghj gsi dwj
goy: wvf wxh
rep: rfx ruu cyv ahh hjt
coj: cox arc ape
ydg: ytt lne ltr gao glz dng dfw
bde: bvn ckz cir cps
rlx: rml bej cvn cnc ipk
gna: wkg wke wdz wvn dwy
kli: kql rue bfs azh ifz hiq hsd
bsv: cse ahc
anx: iph her
wuj: dto
rkd: bhz bzj cil asb ikh hse
ryq: rdm rdo csn cup akq
kwz: kfa ril bhq alc agt hev
gfv: wlw
ghh: wdz wtl wue dsh jbv
cyk: cld cfs ajw apb anz iag ild hvd
rrt: cnr ait azw idz hrb
cej: aed afg
ayf: aja hdh hpj
yyk: lxa gyo wsw dcs dot
agv: iwp
wmb: dyx jka
crm: cgv aod
roo: bsu izh hlm hwx hea
acb: aht aud iwe
djg: dou
bmy: bmd cru auc
kgq: ksf rwl bto csx
gjb: gmq wah wpg wfo wqd dfi
cnk: adk ine itr
aoq: hvv
ygb: ygd grg gbq wqj drp dhe
ynl: ldc lql wio
dkm: jry
iij: izk hgm
bzk: cwf cnn cta akq itm
bxl: azy iid iix
gll: wnb dzm
lyh: lyt lxw waq
dsu: jrc
hed: hnx
yeu: yna lda gpd gnp gtm dvl
hbe: hxu
kic: kja ksm kus bjc iqy hyq
ied: hhk
cdd: ajc iyl
kim: kwy rvi rzx rqi bfo abv ibx iih ili its
riv: rjj cyu cst cuu hex
wmc: wnp
ybi: ysl ynd yur lch gjg gqy wap dru ddn dnk
ldx: lxb gfo dyk dps
ahl: ijj
wbj: wow dkl det
bfu: cgg cty ilg
izm: hdw hzw
dqm: dqz
cgu: cwg ant iew ixk
wsi: dbc dvq dza
ygy: ydc yjn gju wxy dhj dvc
bik: css iyl
gwl: gdj ger wsn wol
irp: iab iaw ila
gwb: gto wif ddw dff
kjy: kzi rwi rxq bcv ahz agt hvi
rjd: bnx crq amq aul ics iio
ryp: rom bmp bzj axg hhu
gxo: woz
kyz: koq bit cfw acj
aeh: hng
rkv: rcy rhm bgm bej cay csh cfu cuk arm iob
ynw: lvw gwq wit wus
yjt: yoh gip gge guy wtd
gxu: gpu wrr wdi wea wni drk dec
byz: bmm cxz ctv ipd ifa
lvn: gxl gqk dlg dxx dmt dox jka
icr: iva hyl hgt
gks: gcs wea dko dus
aoe: iyw
asl: aup iwv hik
acl: ijj hjl
lcb: gsi gmq gnk wko wvy wzj dtx
kuf: kog rfr atx iwc iov hmf
axx: iei itv hat hle hju
kld: raa rwb bok cby chi awa ijt hrx
izp: hna
ltb: ltt gdb wyv wwh wwl
bdp: att hii
apd: iak heh
aqt: ivx hgb hnp
ckq: crp clu
yyb: ljp lpy lpg lmz gld wey
gci: gwu gdx wkv wgx dkd dox
gyd: wma dlz
ylz: lpg dix dwn dvh dvv dmd
yla: yps ltj gjk dzj
hca: hnh
bfn: ceb ago hmv
gdp: gmi wla wuk djy
aji: hhf hlb
gjc: gzs wdn drc jke
yzu: wjb wzz wot dwv
czg: abr adg apx hbd
gux: wky dal dhb ddz jkx
rux: rom cly cgt atu
ycl: yyl yun wce dik dlr dzp
drj: dgj jku
wqz: dkj ddl
bcy: bsc ahc apd ixv hvb
ycq: lwy grs gar wje wnr drl
ytr: gzs wcw wzc dnd dom jkk
lek: lxc wjj wql wtx dwj dvk
bkc: btl adu aqy hnt
wtr: dvd
kwa: bju cgh ave ivm iuj hsk
wjn: dnk
dmi: dzr
wrm: wdi dij dxl dpt
ams: aql iuo
klm: kgf kui rrg rwt cee
gnv: wyc wgh wqi doj
waa: wfj
lep: wbf wjm wzx dxz
ltl: grj dcd
lrq: lgi way wwh jkq
llp: gsc gzv dqm
rtd: abe iag hqa
byi: bjm avw aoi
ikk: hho hsv
rbw: bun ckj ibs
ykt: ydt ymz yfy lek lor lov wro dbv dec dqm dud
gsq: drj
lmh: wfh dbd
aip: aiu aem izi hmh
lyg: lvd ltf gkj gbd gaa jbl
amv: aqg hfn
cyi: aex azh iqr
rgh: bpg cjb ach ifi ifm
hon: laz lfc gum wbe wjh
dcb: dyo
gga: gjc wuy ddk dmv
amt: iyv hci hjt
wdt: dee dtr
rce: rzg beu ipj
csy: axo idf
gej: wxe dfe
kas: kss knu rhx brv bzd
gah: wcn wsh wnv wqx dku dtc
wdu: dmo
ked: ban bhk cde iom hvq
lue: whf wlc dbt jbm
ydr: yxt ldy wql dlq
arl: itt
bbc: bcu bej bft csy
byl: but cie afm hlx
ycm: ghz gxd gxt wmu daj dwg ddq
rml: byc bgq cne cts awb axj hcq hig
rar: rdd blh bnp iko hgl
kga: rpl rmp bgc ccf auy
ywg: lyq gkx gyj gmn dqj jrh
ynr: lcq wvf drc
rdp: cmb aff ihs ixn
ady: aen iqy
waz: wef wzo dfx
gbn: wge wpe dhq jrl
ynt: lua gfi gfq weg wob dia
hch: hhw
yli: yjs wkp wds wde dhh
kws: bod cdh cey ikb
gvl: gpw wfn
dba: dgt duy
dbi: dib
kdi: rxi rpf aez imu hhs
wex: dxr
ijh: hab
ykk: lbf lcj ldp lns gla gdn duh
aft: hpp hmr hzs
kac: bau blq bpk ixv
lkb: dvj dqt
aqy: igt
bqc: hce
gpa: goa
lxk: lnh wyx wjx wul
die: dwk
bsx: cci icc iye iwz
rsu: bpc btf aqe ilm hfp
gfu: woo dhi dyl dsy
ajl: avv atz idx ixp hed
hul: hox lkq lad lqx gjl wah drv
rer: ref rzf bpm bty btx buu chr cne aga iow hxr
ylb: yjg yfq loi gbc guu
dgq: duy
iyw: hmf
cwj: ctl
wkp: dec
rsc: bfe cqz aii icv isk
gqn: waa wng wzn dye ddg dob
dlk: dop
yxf: gwg gdk dvk jkh
bka: bss ioa hcl hpx
wkn: wdc wxx wfz dme
cxf: hzr
ygm: lva lfv lqg gpo
ijz: hcd
yjk: lbd lqb lqy gyl gqi wvc dhm dyk
bxn: btb bup cex iuu hbz hya hvu
avw: axp hxg hnd
dgt: dwb ddx dfh
wcr: wha wlw wxy
wqq: djn
gex: gzv dfo
ygf: lrj lpp gbu ghv gdz wym dkw
irj: inj
dye: jbg
ccj: ifs hfi
cbk: acf ads
bug: akj ijk
yzs: log gxy wrt
lxq: dyg dei
ljw: lzz lte wxo wfj dgp dfy
wvy: wxc dyf
dcz: dyl djo jbf
rco: rsa roo bhy byw ill
bkw: bcy bwv ith
ain: ixe iqp
lrr: dsb dzd jrs
loi: wub dof
gcd: gab gij woc
alc: inc ifl hko
ckk: cey avi hsw
hll: hlj
bvw: car hbe
lnv: gtz wst dea
ytf: lap lpv gov wbx wdf ddi
yct: yye wdj wjc dud
bbb: bwt bsx iet hsq
bsf: btz agi
lpk: gne wxr dim dma
gml: gmo wmq
rro: rfr rfu bro adn isd hlb hju
rka: rli rzh awl asj azp idm
wsv: wqm djp
ycb: ysl ypb lwx lej gao gil glh ged wkx wxj
yyy: lsw gcu duj
yis: lxe lxu wrt dzv
amj: iil hng
ydj: ypx gvq gso wsb wfy ddo
cqy: ahu
gmr: dkg
gag: gjp wkt wdk wqg wuf dka dgb dds
ixj: hdu
riw: rgn rwn rof cdy con irp ivu hpo hno
gox: das dmu dny
kpi: rmw cyu inq
ken: buv aex amj idv hyk
giz: gtt deq dni dtv
gdh: dce dgy
wot: dbm dhb
cpy: hwu
ikv: ium
kfr: ktn rgg buz cjk ctk axl idi hki hdq
lnd: gan ghm gvr wwk
bjm: bsr cbg
rcs: ryf bqs cdd cma ila
ckg: czr ikc iqw hbd hig hzq
rwa: rzg rti bzc aze aqo
bhf: cga cdg iax hjg
cwp: csy hkb hsq hzy
bhq: cvs ihb hxy
cad: auq
clz: cud apk anb
hke: hnc
kul: rvd afi hhw
ily: hrb hpc
wul: dvk dvu dpy
kku: kmy rsk bhx blh cdh anb hda hxc
aop: hdm
ryv: chf igu ifl hco
hib: hvs hei
inp: hky hbv
rcl: rzp rqq ccm cth avi aea atv auv irt ivv iqp iot hbc hau hwh
blg: hwq
wno: dap djb
wrs: wgc wey duf
lhu: lvg luf gtz wsh ddb
cir: hxi
lou: gbg gap wel wzn dwi dtl
gcc: gyb goc
iac: iia igz iqa
gon: dfu
dwh: duy
lvd: gcd whw
lpd: lzm gjo gqx
byv: acf agr aua hyc
rgc: rwo roc byo bta
huh: ynf lan gyg wge
wib: dsi dma
cfw: ack icq ior
rqa: bbn bwn bxs cvm cuv aeg ido hph
bkf: cgj agw ieg hac hhg
blj: chz cxs czx
wcv: wcf dkj
bxh: ctt arw als
yst: gvf gon wrc wwy wqu dqd dqs
rpi: ruu aax ima inp hiv hxr
lwn: lpw gvg gqq wem
cml: age ajz afj
gzo: wyc jkh
isn: hgz hdc
bii: bxy agx icz idv
ddq: dqv
kyt: rzr bxs aqq ijz ief iqi
hnb: hns
hea: hmk
kft: kzn bnx cgs czn iad
rut: brs bcd iem izr
iow: hkt
gal: ddb
cya: atl hef
goz: wer wea dhz
aoz: iav isu
apw: ifk
rqs: run cse iuj
bee: bff
gkl: gqd wqc jrp jrn
wst: dmi dts jkg
clk: icy hph
izg: hcf
rdm: rsa ima hhj
bju: cwi aax
imw: hvl
ipo: its iuo hdq
ltz: ghw wad wgv dhb dmq
kan: keq bxq bqp cvz hyl hvw
wyc: wyv wzg dxf
rrp: rxt bvi bmp crg chq aga hyf
llk: gdt gxv waq wec
ycp: yhf luh gco gab wda dlj dzk
gxa: daq dnv
bbt: bfa cfy ctp aic adb ans azu ihy ipf
gpw: gol wmr
rzq: bcl ali ajm aub auj hxy
auy: aus iis
bri: bhs blb avx
khu: rsb rtt bks icg
bbx: afc iie hcs
lxs: dfb dtl jro
gan: gfu wrg day
hwt: hsi hsw
crv: cpn awg ild ilf ifn hcr
btp: cwh ime hbf hab hwp
yhd: ypj yfc gds dyz dnb dfv
cee: cpp abs ajs aey azd hpl
gnp: gqh gtq wgz
ajd: ick
lwz: lvv lfd gic gjz gzw wag dvg dol
yts: gca wxf dpg dna jbd
yum: ljb lmn gpo guv
bmx: cjj cfs amj ivf ixe hil
lal: lyo ggl gmd wxp wod
rhw: rgf rxt axr ihn
yeb: lyc ljq lsu gyl gje dgy ddn
dll: dvo
ajm: ikg ivw hbc
lnz: gym gvy gml wuu dwg dpm dot
bpf: crb ajm afj hlf
yyi: dkv dne dty duy
gqi: wkk wgm
afh: azc irw idd isl hcu
irk: him hza
kko: kfe rki rbu chd iqk heh
cct: ceg ixp
ryh: brn ihx hhf hlw
ilk: ixs hkh hlz
yfq: gvt gfj wrb wvt
gla: gse wwh dcv
len: lfg gsn dcb dio
kyc: kxd riu iyh iml hdr
cvn: icy hvj hni hff
aqh: iwd hyf hdm hsd
hud: yya yuz wsm dht jkk
lyq: lvx lsv lqg gag weq wnj wuq dth
rcz: rqf bma cdj isp hkq hze
dys: deu
kxu: rzc rqe bmy ade
cja: csd
rbb: rin cjb ale icg
hqm: yhw lfn lfo gbl gvf gmv gtz wcj wxn det dqu dut
lls: lgr gyt glf gnd wcs wlc dlu del dfr
cha: cdr ayh apm anj hgi
hia: hqw
gjp: wdx wss
dkf: jrd jrm
chv: chp afq
ryc: beu cfh aus hhy
iua: hvy
yub: yuf lkm lca llt ldt
lzl: gwk wrs dcm dor
gce: gua wuv dor jkz
avh: axc iuy
ynz: lti gif wnf djv
lda: lzb dlh dmr
ynp: yzc ltn goc got djj
kmc: ktd aim ift hlo
lnq: gal dsf
gak: wgj wzy wql
dpt: dow
crc: cdy amz irw hjc
kzd: rvh bex bmc cua
yxy: gpw dui
kka: kel cci ajs hvg hzj
gvq: dqn
igy: iun hpv
dyp: dlb
bfw: abp asv atx icp izw
gmd: dry dax ddk
rkr: cjn cpa hyi hff
lqp: gmn gny wgo wpj dyl
bvm: cog iaq iog
blc: ahv asj hpn
bsy: chb cjt ads ire ihb
lcp: lzx gks ggo got dqk
bhb: czf asx ist hsx
kcp: bnh cag cib agf
bxa: crh iyl ill hze
hbj: hsp hqb
kbc: cvf cnt arh awv ape
yzc: grh gcl glh gll gue wkv wjn wtj dpj
dgf: dob
ytg: wfr dlu dev dmz jba
dbc: dhr dne
ydy: ynk yus gke gna wxe wtz dbg
lww: lmr gjb wjh
rwx: ccg clf cvo cey ayy aog hnr
bzf: cse avo ipp
bda: cnq aki ibk isq
lvy: gpe wru
gzh: gzq whu wmz jko
bfx: ckm ccr ici iwa imx hwg
bjs: chc ajt anb ilz iqk
cnf: cqw iil inl
ikz: hka hjt hsn
bwe: bzx chn cuu aro irh
kxc: bbb btx cta aof hyf
bst: cym aso aqr iiu hcq
kyj: kfh rji rxz bwl bwu bnp iqn
gzm: wzq dzg
gqu: ddt dsr dqw
bdt: aar
rnm: bad cck cas cmm czq
ies: hrp
cwv: coe ajc amj iie
whj: dtq jrf
gjz: gvl
rbf: rfd bmq aai atg inc hyx hmb
ivs: inw
gok: dlz
wiq: wgd
ixl: itq
hts: yrj gol wzr dfd
rci: aob iek hhe
lnj: gyw wfh djx dul
ixn: hgs
lvx: lmf gqo dcb dqc
gph: gum wct wsd dbo diq djw dju dsj
ggj: gpg gnn
koh: bgx cca cdp hng
lzc: gbj goj wyl wlj
gzq: wny
kgg: ksc brs bik cbm cqm hsj hek
aml: ily
yjv: gwm wzg
rvm: cbk czk avm ikz
ake: avz hfp hqa
lgc: ljm lxd lng lua gqc whk jba
wdv: wxx dfx
amz: afn
bpv: ibi ize hfz
rvz: bbu bhx apm auy
biu: bje ixq ipm hfy
ylr: ygx giu gxn wir djr
wli: dzp
wml: dyb jkn
alg: axr iyy ile iug
bze: boz che avt aeh
yzr: loh gae gnz gou dvd
gcg: ggc dkk dwh
hac: hqa
aob: ijq
yqo: ldf gxm gqu wkp wvq
rtz: bye idm hdo hnh
avp: aqy
yyf: yxq yfb lnq dhx dtu
gaq: ggv gdl gjw gnr wjv wxs dkz
lge: lsq grn dcv djw dex dmv dnh
kah: rap byq bgy bgm cdo apt iqr hrt
kdj: kus rul cdl hnz
lap: lyf lvi gcj gig wjt dcn dhv dsv
koo: air asg hcy
wmm: dwz dzy
lbg: guz wsy wnu dth
hcw: haz hvm
ckz: ace
abd: afg iwt itp hvt
lvz: lmd gdl dan dhr dth
rvu: rqe bqe ckz cyx cek akf aem amv
liu: wiz wsf dko
iqo: hlf
yzx: ytk yui lbu wio dcl dcu
wmg: wmn dyo
ycx: git gye wld wom det dzx
wcq: dyr jkd
ald: iyz
grh: gqd wni djo dzd
lqo: gxc wyr dig
yhe: yga ldr ldc glz
gvg: wdv dia dyu
dmb: dqu dub
ino: hvp hpj
ljt: lnr gch gjq wef dir dqs
iyb: itf
ymv: ljb lvf gnt gfp
gxf: gox wiy wms dux
bvo: cgv aiq iva ifs
wzt: dtc
byf: aht hdl
bdn: bvg cjm aye hza
gam: wih dgu
bct: blz bjt aar adl aum
itb: hxh
ieb: itf
lil: gxb gzy jrk
lnn: luo los dbd dbz
ktp: brz bbs ifb hdx
bub: aek amh
gbb: gxz dey deu
rgy: btf cmf ilw ixf hpc
awd: aup igk hpl
his: hnl
gcj: gqu wcu wjl dqg
cth: akk ahg avb app igo
rsv: bic biy abz ica ism ipq his
lke: lbj lbe gkr wwm wey djf
lch: lvc
gui: wrk whg wvs wsf
dyo: ddl
ccc: anc aoy ixu ipr hmz
lhn: gwf gfd wss div
kpp: rxb cka apy ima hkv
dtx: jrf
gli: glt gzf wus dhn dvj
aev: apj hxo
wkf: dcl dyg dll
awp: aqr ivb hka hdx hqx
yaj: lhf gkp ghl wfp dmn dfk dzs
wfd: dsc
aak: icv hcz
igs: ija
kgm: ksq rfz bwu csl csq aiq ajz
yug: lvw lsg ghb wij whs
hcb: hjq
yjh: yjn lry lcl gev wxz dve
ceb: anv irn hfh
lfh: gbh gpf guq
iov: hkx
acj: iry hyb hwl hvb
cnh: cqi acg axi aod itv itp
dky: ddn djs jbq
bln: aja iyx ije
yqt: yuw lyf gtm wdn wzt
gzr: gus wsc
bli: bsm akv igk
igo: hre hme
gfx: wcd djp dxa
bmf: axw azp auq ixi hqk
wrd: wsz dyc
gcz: gdo gvv goi who jkl
lwq: lxx gdo wsw jbp jbt
lir: lsb lqk gkq wkq waz wxu dpa dqi
cwe: cmz ioh hlf hpz
wpi: dql
whp: dni dtn
wki: wyy wwk wwm wup
gsa: gxb wsx dih dyg dwv dxs jkc jbq
rry: rad rdc cgf czi aka afw heg
wuu: wox
gri: wbh wzg wtc
izt: hlq
lxp: gmv dch dhp
gyy: dta
gko: gra dbo dtn
auq: ioe
klf: cgr ihh izc iqr hhj
gpf: wlr dqb
cbr: cok azs
grs: gjm
lte: luw dtq
rpm: bad bvq chm cjp cny akk
diy: dpc
ctg: ayt aqv ifm
ayu: adx avl atr
asd: amw ipf
yms: ytq yue wrj dgi dxa jkd
iuw: hya
lyt: gbn wqn
bks: bpm bzp chm
gjj: gul
icv: hrh
hak: hlf hjf
glg: dls deb jck
lbk: lcj lwp ltg
ibr: hvs
hic: hwa
bbg: bil chw aob ine
wbv: wce wgd
lnc: ggo wyu wsr wzv
bbi: bop ccy cob hkm
loo: dhy
rid: rxm btj crh caf ich
ddx: dus
gty: wiw wsa dul
cmz: ipi iph hks
iji: ijo ixg itx
cld: cma cqz anm hhf
ckb: cki anw iio iho hxk
ifa: hrs
gyg: gpg wyn wmt wqm
iil: ipq hen
abe: avd ikl ivx ioq hgc
gwd: wlt wva
gfr: wdj
hyc: hsb
ahe: ays asl hvv
ljl: lux gwl wcr wye wvs dfq
csh: imi
gzj: wlj dct dll
riq: rvz cva ipi
rbp: rzc bte ckx cml cnc
ryn: bky axs afg itm
bmi: bnt cht cts iwi
ifj: hap
kbj: awt axn idf ijo iei iqq hgn hwt hsz hno
azv: ign hsc
ryo: bbk atm iaz igh iqc
rox: bjy iht ixd wis
bwv: cxr hay hwi
kvj: bfv ajk hsr hsf hza
cdw: cnm aya apy
wqx: dty
hrg: hba
gzl: gtj der
wtt: dww dsw dej dtk
rqx: alp
rfc: rtn bhx bqb axt isw hid
dhy: dxo
cxn: apu hvn
apz: ixw itn hwp
lws: gon wew dgx dji dpn dzf
axq: idr hyv
gsu: gul die ddr dej
wqf: dcl dfv
lbc: lls lfq lqh gfn gqq
bij: byq bxr cph hrz hng
ibk: ivr hww
hui: ybg lxc gxg dvt dxy jbr
yvf: yzn guk dek
yga: dco dhd ddc jkb
bzg: cde ajf ict hht hek
dmm: dfa dtz
rte: bxj auu aox hic hmk
gxs: wes wph wpn wug dcs dpo
cva: cmm czc adt azw ihb igp hbz
dkw: deg
rgv: cxr abq ank aoh hzp
cgo: cjl aji hbl
rmu: bry agk ieg
hiw: hxa
kxr: bzf aiw ibq hkn
aax: ios hiz
ial: ilj hys
wwu: dww
keg: rbk rnw bjr ctz afn azu
byk: bya cwg cdk cdl akq iex
cxc: igh hjw
brv: clt ces avk amn ify hlu hwr hmq
aku: hbv hcj hen
kpm: kma bfg crp hnp
yju: ysm yeg yeo lba lny gan glc wiq wen wxb dqc
asm: aek afw ial igi iwy
kfv: rpk acz ikj ixz iov
awk: avw app
wpe: dpc
imu: itb hbb
kto: rkr biw bqq ikv iha
ytv: lol gim gsb wkw wqr dha
aiv: asg igm itj
cpc: art ast iqb
key: bqv hkr hba hau
kdm: clr adb iax
aco: alz hgm
ljg: gjy woa dvb
ldc: gme wdh wjj wew
ipe: izi hsr
anr: aqv iqp
crf: cbj cqw ian
rha: ruz row biu blh ceg cpa aue ifw
hjj: hpz
igx: hcx hpv
rmo: bcc bwj bdu cus
lnh: gil gst gza wxe
ivz: iqo haf hnr
ker: keq ccu cgd hyq
wmu: dir dqc dqi dor
yew: lvk gzy wtb dvp
gkr: dbo dgh
wsy: dhn dvo
yir: leq wua drl dmz
dgk: duo
rcd: rny rqz imy hnx
lrg: lot ghp gyt whb dkn ddy
bpq: but cqb aac agc icb hgj
btn: cbl aty ibz hky hwj hfz
ika: icm imv hjv
bqn: bqt cbo cxw cfs
bxr: chb ixt hae hzi hqd
ljm: ddz jrj
awb: azl
com: aeq iry hyt
ccp: adp
gyx: wyh
gcp: wzb dli
rii: rtq aoc iby inl
lox: gid wiu whp wsv
rgo: bir cba aap hsz
ysb: yug gaj dlw dop
dsy: dqr
khb: koj adj iki hea
llx: lgd gbm gle dqd
kem: bag btg hcm hwk hwv hvs
anf: hax
cpt: cux ifk
rjq: bap aee api iom
gmh: dbv
wye: wln dhe dyj dzn
cvb: aig aun iwy ijb isn hds
rli: ajz
kzt: rqd blr cyi
cgq: axv afl igu hlj
yba: gvh gsa wdb wzy dap
rhg: rei bgq cmi
rcb: ryh aln ipu hly hzf
bjy: atd
lcr: lvh wnd
rgm: rds cjz
ggu: gec dzs jru
yxh: ghr gwb wou dak dyg jbc
bna: cyl ahl axm ihs iwe inc
dpj: jbc
cfk: czq arp alk iki
rcm: rym rss bph hsr hmb
rth: cdb aef inl izx hvm
ylu: glj wnq dyn dwh
wvw: dmo dfd
blq: ihw idw imz hiu
dmk: dmp
iiu: iwx hbs hjm
gpe: whq wfv did dmq
afy: iax ivq ita hss
wfk: wzi
rup: bxf cds abu hpb hfu
rxl: rot bbv bqs aoc
blw: cxo czo hgb
rkk: bwp bxx cbr ipm
gyu: ggx gfh wzj
koj: bhw bgp bvy bxd coy anh iqt
ioo: hwg hex
iph: hia
rkn: cue awh hxi
bmw: aii idj
iwn: idg ifv
gpq: gnx gzv dkc
wfx: wos dnm
gvb: gmc gzb gzn wmg
ykh: ytt yos ggq gnq wqy dui
dlv: dle
kin: ksd kzi rce rgl bhp aik
isb: iez
rvv: bsc cgk czi isl ioi
rsj: aho anh ats auv ikk ipj hzq
yoc: lva dag
cpu: iqc ham
ifi: iuh
yeh: lhz wvq wqp diw dyv
ytl: gay gel wvk dgv dff
grn: wiy dsl dxn
aow: ijk ito hln
gcr: gio dba dbd dcc
ikr: iov hxb
czy: hza
wxk: wnw dxf
lzb: gvs gml wba wxy dex
yoo: lzn gya gwj jbc
bxj: apu idg ipz iou hew
gjh: gqn dhr dya dzu
imz: hnc
htk: ydb lgu wdu wfd dtw
rql: bjb chg izy izd iox hkn hbx
dkt: dns jke
cje: cur avy amd hsb
lfm: lte gam wln jbg
wjv: wpt
ibo: hhr hze
ykc: lbz lhq lvy woq
gnj: wrq des jkw
dby: jbl
kuq: rsc bcj bdw ird hza
wzl: dgs
bbk: ayh aty
dru: dfn
rdo: bfe ihb hfp
kog: rrw bfj cll hvt
ixq: iff hkk hco hyt
aag: iak ham
lza: gyn gjy gxl wxh dog doj
wtn: dug
kbm: ktb rar bvt cys isx inh ins
rju: brw isv hlc her
aru: ija
gat: dmc dnt
cfi: ijr hvs
lgj: lpo ltl guy gog wvz
lzr: lth gjg dte
aof: icg ifg
iwr: iqk hlt
ywb: yuu lrn gdx wtr
wzr: dwr dns
cqq: aiz ifu hdr
bxg: ahk ihk hki
rsa: bqc buq cuy aat azq hgb
lcj: lqv gde wrt dad dwz dfp
gqg: djo
kbd: rge rns cui ivz hie
wgy: wwu wsb dkd dok
cjd: iwu hcd
cen: aqg iaz
ckl: caj cpx ihl hlh
kjr: roa blf cfp agi aue hzo
azd: aua iwi ixb
kum: bsu crs aek aea ifb hhv
cqv: adp
ytd: lsw gkd gwe gmm gtp dkz
beb: bqf cnj ily
buy: ctg icg
rqr: rte cev cfv iwx ixo
kff: rur bqz akm hyx
lnp: lzr gdv wrt
cow: aio hrc
agz: iyz hhb hwm
bvb: cco imk hit
ihq: hii hjl hfp
cym: hwe hsb
iom: hld hdw hek hmz
cby: iyq hxu
aib: aor itt
ghb: gyx ddz jrg
rey: cbu ick igu ino hat
dwo: duj
chq: cjc hqs
dik: dfk dur dor
dyb: djq jkf
led: gkg who wgh ddw dfd
bho: aks ara iia igo hke
wns: wzo dzb
bng: cxq ayd hgs hvk
ilx: hsi
lfe: lql gqr gtc dnv dfl
gzt: daa
rse: beh cbs iwr ifg
iym: iuy hqv
krv: kps baz bnl hja
rus: anc aua iec hdt hsb
kqv: rpy avv icd iji
bww: bsw bqe avi azo hkh
res: buz avx idx iso ios hhe hjc
knx: ryb ruo alg iwh hbk hdj hjv hpd
kia: ksn kqg cwg his hvy hzx
lql: gsa wsc dsc dea dex
crz: avu asn ihw
ypd: lhg wkr wyg wti dyc dzm
bdg: agp atd ixu hck hcv
ybp: lij gwq gvw gzb wnc dff
clx: cvb iij iyk ins
bpb: cis chg adp hwz
dju: dpq dzh
iue: hvc hzm
afd: hwx
akf: atj ilo iut
bjw: cwh cph ctl ahv aea afd iwp hma
cly: itj
kzz: bdu bfn cst irm
ble: cdc cfe ilp hry
hok: yaa yzs lbh wmg
wfl: dje
lai: lmi gws dgp djt dzd
rhl: cne ato hau hsl
arp: aha ixj hgp hpb
alb: anh
lwl: lsp gki wnr
ipr: hkq hes
avy: iov hcn
cvd: art azu hrd hfv
ljn: gkn gfz dyb dfs
lba: gid ghu wzk dft dur
ibl: iwa
ysx: ytu lva lnb gbx gze dsf
ydu: yxr leb djw
iiy: ilx inz hgx
cjj: avp aes igy
rzp: rqi btx arj ayr azs iyb iqr
lpu: lns lol ghp glq gvo gec wdj
gns: dvk
hoq: ytu gcg ghv ggy wrl wga wzr dai dax
gum: goy wfv dvn jby
gdm: gjd gft dzi
wcg: deo jks
bps: cat cyg iph iqq hga
wkx: wim dyy jbr
llq: gqz wab wir wod jbh
buv: ctw alb amy ili
kuh: bju afu itb hpt
ajc: itw hvg
hny: hzu
bcl: bil cwa izy hrd
lfv: gji guy wmp dby djl
rhb: rpg czw cus iyn hxx
ggd: wnx dem
art: aln awm hhv
aks: hko hae hgy hem
rix: rfi bnx ajr aqu hjf
llf: lve lxt gib wlp dst
rxs: rog cwa ikc
lhd: lnp wab wze dwc ddz dni
kor: rmn beg ahi
anz: azq ian ihy hga
lpf: lzp wrv dtf
gye: wuo dgn dqg
yje: glb wrp
bhw: cmy cuc amt imx hyi
aiz: ank izr ior hbh
avr: ils iqn
lxl: lnp gyy dhe dqd dos
ktf: akw icw ims hwt hdd
yhs: lis grm dec dto
yrl: yyr ypj ytz lbw lsm dce
czl: apt ibp
yhm: lsn lqx gap gqz dnc
kca: byh cwy cek icj iyl ivn ixb
hbi: hbs hbf hwg
rxx: bji buk czq ift hcj
ywn: yja lbo lel wci dpk
kao: rim rzn bay bgf buk ame
aaa: awm iaq hgs
lik: gao gne gzw dnw
kjd: bbh cfn awt hvs
yxz: yqa lbb lpw gys gds wra wxg
bwn: cmn czc ahj agw
bdd: ixu hxc
rnk: bii bvi hnj
byx: agt hxm
bdw: bfs bot cnw
rat: rtc cco awn iec izd
rcn: reu blx bfl ccp cfn iyz iez hld hvv
bux: chl csd czb awb ihs ijt itf
gid: jbu
aiq: iwm hhu
lhm: gbd gwo wrc dyz dgd dsg deb doy jbk
rwd: rfa bco bsx bzm ckz imk hhs hyi
bfq: cjv cps cqa ayl ams hrp
hqn: yhw yvo ymq lax lgd luf gsk woh
bnc: bfa cgb iil
kpb: rig cre akd hkm
kql: ryr bkv ivt
rqd: row bar bih bjy cpx iwy
gkh: gya gte wyd wes
lpx: luh ggm wpg
kib: kln rhb rgt bkq
ytu: yoc lnu whd djl
hrl: hiw hip hpi
raz: ryo baf bxo iuo
rhn: cwd aif icv hir hwl
knp: rbs rjz chd
yjb: llv lvx gva gpl wke drr dbw dje
dap: jkv
ark: isb ind hjx
ywa: yng gaz gvv wio wji wny wte
kdn: bph bui aqo imx
dty: jrg
yif: ltf gwp gem wbw wig dpo
isy: ixo iql hcp
liz: lho gib gnl dql jkc jka
ikl: ibb iah iln
asc: anq hnh
iqm: hye
rav: cds cnn ikw hvf hmi hqj
hjr: hnc
bew: bob crj acg acq
lnx: lzc wff dtk
yzz: yoq lcd wob dlr
yyv: grl gjf gtg wig dks dwb
leq: lpc gfb wzc drc
bvy: cdf ahh ipg hab
iws: has
cvs: aaa ajd
whg: wwt dot
kcl: kjf rxn bgr ajq auh auz iyt hyw
ggn: wbq dja dxr dqb
kch: kvm rjl bsm cip hek hpn
gos: wvo dvl dxb
grp: wmu dsa
rmr: atz auk ixp ify
lni: lfi ddn
wla: dmp dfa
gol: wzs
wna: wfx wzf ddb djv
cpx: aml hxc
kob: bce bnl czj amj
hwy: hpr
ips: izx hex hzj
hua: yrh lda gmg gfy wde dhl dpx
cba: css cnc akp alm atw hvr
bml: acl
yrd: lmo gsj gtb
ymt: gmi wzs wol dsq dtg
lfd: lqk gdr gpc wwz wnx dev
yrs: ypo gfq wwa wti
gcy: gem gzu wzl wze wue
wze: dhb
kbn: kma rxo bwt box cdj cfl cqa iyg
wgf: woo ddm
gpx: wib wgo wqg wuu
bld: bdz ibp icw iqp
lag: ldc lns wpc dre
roq: cwj akb ayz hqx
kdl: rhs rxc arz agu ika iav izn hdb
bsa: chi izg ior hja
wtc: dix dja dxe jra
bxw: cqz inw hgy het
yqn: lxg gmr dfv dzq
axp: anv
cjy: cut coe abe itm
imt: hju hei
iko: hlw hpv hqx
woz: daw
aca: aom ikn hcr
kvm: knu rih rit ara acq adc ihh hdj
rtc: atr ihj iwr izy
hhl: hfy
bis: bwj cwp ahn awb hzk
bqw: buh cro cse cxb aka afv hhx
yru: yij lvt dcy dhh jri
ktu: rzj bqk ajv aml
rtp: bxg adh
rnf: blx bqr cti
bpx: cut idw ioh hwg
wzn: wup dpz
ymx: lvb lzc dku dvk
akg: amu aqi
ldh: lpf loo gtt wev wxq dlq dmj
wrf: wij wsm dik jkc
wdr: wvy dlx dmi
ijg: hpo
wgz: wwu dnq jks
rsb: bsa cpe hgi
kxf: rwo rmm bcs bmb clv abr iwy iso
kix: kea bkp bug awt afo iui hge
wsb: dxf
btk: cox ayy iim ivu hzy
iia: hkd hcv hmc
dyh: ddz jri
aor: ibr iwe
lqh: gqh wdh dat ddu
gxp: gmr wic wjp wuu dys
aza: ite
hol: ldb lfb loa gmx wnj wtn
djh: dou
gpv: wak wxt dyf
yal: lbb gne wym wmh wqm dpl dta
hhg: hde hjn hzz
dei: dfc
dvi: dqx
ywv: yoy lao wkl whe
rmc: rmw ikq
ceu: hck hin
cce: alk aop hjm hvt
lps: gzf dap deb dmb
wwq: drx
ydc: ggf djj
win: wom dvy dmy dzy
yfl: lja lvf gbe gvc wiv dso
lmj: ggj wvt
bed: bpw cjq coc adv ajx iwl
cyj: abz avh
ajx: iwv hgv
rye: bky bit bqh ajv ajq axo ilu
aad: aww igx
cge: ala afp auv hyg
rzh: rzo bka cmx cnp iif ish hxs
drx: dea dqw
wup: dpl
wrx: wwc wvr dgj
rws: bax cqu ibl iwu
dxd: dub doo
akh: acm iec
cts: hrc hra
wpd: dck dpd jkz
yvg: ysf lbr lmh gju gof wwf dav
dpw: duh
ycy: lhf wyd wyt wvo wqy dmf
wxt: dwt dzj
lyz: gyc gwk gnn wzd dvg
cda: css csn izo
ypm: lch dbr dao dwn dxz dnw dos
kdp: rjk rfk cgk awo iya hcv hnl
rve: bve bfp cee abq act atv
clt: ibl ihz hae
rud: cgm cql arm ipv
rnp: ruf cll ifv hkc
kih: rat rzw rtl ruc buf crt cpi
cak: avq ikc iqo hpp
gqm: wcq wuv dki dql
lnu: wpw dkp drb dgm dml
cle: cth aep
ach: amg ifn its hla
lkf: gkc gaz diw dhl dlj
rdv: bef bxz arr arv iwo imf ius hbi het
kep: rpr rnh blw ajb
kwf: kfm bbh car cws cdw akt awz ams hsa
adt: inw hiy
lne: wkk dkv dgq
cur: iff iqt
ree: cdu alb afa iqw hzd
arh: aqj iun
bft: akx iak ixu hcl
gxn: wit wpc dde dtp
ixf: hzj
wdj: ddp dtl jrn
lpz: gsa gtz wao wtl wub
lam: gkr gwg wso
kpc: rkm rrl cgk adh iff
lzg: gud wev dco
asw: hia
bxt: bfk cln adu imz
cpe: abb hmc
krb: rxr rqb blk bow cfc
ciu: aiz anx afy hvw hfc hfv
iyq: hkp
czv: ita
cog: ilt hvx hmd
cmf: ies
iyn: ijs
auh: ibo hzh hzp
kxx: rdt csr cth iki ibl iec hwe hvi
yyg: yfk lvp god wxp wqh
wdh: dkv
gib: wgh dzp
ruv: bho cdz ixn
wyk: wmr wnq
gle: gwq dfy
cex: cfc
ktt: rkm bcq csu ctj alu ijb hnk
leb: goq wkb dba djc dzz
iuc: hvu
grq: gtw dyp dxs dnr
imh: hfs
cnn: aby
hmy: hfy
gyj: wdf dra dsu
koq: bft ixo hha
dsh: dms jru
weh: dvf jbd
rzr: bkn clf ahq hac
rpl: css cnp han
wdw: wnt dlo
kiy: brc bgt bzz awx
kbe: kwr bco bga ctq abt ifz haw hfh
iyg: ijk
wxb: wzn dsa
gmt: wvd
whd: dhu
izc: iur
aws: ixj img
lez: gkh wex dqg dur
wbn: wci
csn: avy aft
dvo: dpb
kjh: rbj bey cvo coz
wbt: wpi dyv
bph: cyn axf ihz
khr: kvs ktj bev clk cvk cfx
auk: haf hqx
ayv: afj irz ick iwd hwz
gxr: wbu dqk dtw jke
boo: cpk ctt cod ibg iie igl hrn
aqu: ivz hzh
knj: kzh kuc bui clr cgp aro aba asx aud ioc
kmv: rng ruy aet hxd hmr
yfs: lqf gro gih dbk dbp
dan: ddu dtt
kex: brw bdr cvv aus
kzn: cyb hve hnn
cme: hej
iet: iuj
idx: ivd iqd hlm hxh
adr: aqm ink
cga: cwx hyl
gif: gug wdb dap ddf
bhl: bvx bqu cfj
ctp: aqf
gxx: wxt dkn dok jkt jrh
kla: klu rdk ikl igw hyh hmr
kwj: bbu btu ckv hkf hbo hgw
yvn: llr lxe wev dkj dyo dei
cys: cuj ado hek
cis: chd ady
bor: ikt idm izf hre hyq
bio: bpc bod ctl hyg hyn
yei: yns lrv lli wud wun dze
iha: hwd
hkm: hbs hau hig
bpu: bfx ahp apa isg
won: dyt dsq dxi
cbe: ant aqe ial hkk hgp
lxo: lqw gly gqh wuk dyn
cqz: ioc
iam: iix ixa
ybv: yfb ytb yuq lzj lqv wzp dyl dwe
cbm: hcq hhl hff
yda: ydy ypk gbc wbz
yth: gvh wzh wtq diy
rnq: bdp aqv atb iiz hnx
ypz: yud lpp ghb gdl gja wfs duh
ywc: yfh lto gec dcw dpi dom
lse: gyf gdq wrq wtu dzv jbs
rtv: bgt cfn cza ald hbw
lhk: ltq gws wnj
aov: iio isg
ymu: lrc get wvr wfa wox dqz
dib: dqx
gme: wcg dml
ajt: iso hld
wyn: dgq dma dni
rqc: avw ipd iqg hdn hsg
wop: dbn
wbp: wlb dwj
wxi: dji duu jbs
yxu: yzy yol los gzg wgk wxl wxu
kkp: krm kpg bkb cew iea iur hit hva
dnq: dtf
gaa: gug wkx wti
wea: dhm
ljc: gdg gpk wqn
dqk: jbh
cgt: cfy agk isj ixs hch
wzq: wqv dwq
bza: caw chh cud afx ijs hap
gvw: wde
ksm: cpr isv iql hrw
bkx: cax con ikx ixl
rsx: rtq blg cka cvy iyb
wpr: wnw dcg dzx
kgj: kox avx iht iwl ipu
kzk: kze cjh aoy isr hxa
geb: dat jbn
rfy: cvp cmk aqn hkr
bfy: cpt asw irt
bue: hnn
atj: ifp
rrg: rgd rje ciq
kik: bgi bfy inh ifa
haw: haz hik
acg: ikp ioo
gil: gjz wta did dyp doc jrw
aur: hgh hvx
yui: lvq lnw gry ghm wro wpv dtm
dct: dtu
lhh: lgc lgw luk gac gyu whv dqf jrz
bfi: crw clm abo aeg hkx
bsm: awh iwh hne
gao: goa dlz dzh
khz: kut rls
hav: hpu
lfn: wzy wum
lih: gvw djo dsr
apt: ido ium hry
wkc: wpu dyl dlq jbv
ary: afy icr iaq
cst: acp hsh
bwt: bxw igj hvv
yar: llp gqf wsz wxv dhi dwi dxx
ris: cmy ias hrx hzy
atn: iqr
yzp: wrw dci dvk jri
law: lzt lqr lug wuc
idk: hkd
gwy: whj wuj dei
iny: itw
yjx: ypd ldi gdx gzg wmz dil det
alr: aej
rgg: bwo bvh irt hvz
kcy: ryr brk bvk adq asd axj hrn hhx hzd
gnq: wfh dba
rsw: roq cxw cnc aro acd hnz
dkd: dbe
cam: cdo cem anc
wgw: wws dab dfg
ygl: lbc wjm wsm dkd daj jrx
air: hkz hxg hxj
cfy: cqx hvh
bvt: bsl bxb ahp her
dvz: dna
ykr: gof wpz wzh dzi
yuo: lfq wyz dde
huv: yyi gla wou dxd
yvb: ldq wxi dxd dfa
atl: iqh hvc
bwu: bfa bzf csl avj hzo
aig: amd idd hit
kqg: koi rrz rio bkh bkg bur agv
rfg: ajf aqi idi hwa
wls: wdh des jrg
gbh: gsd wsj
rya: rwv blr bsf bxh bng cif cgw isk imb
yzb: lsi gti wsn
kwn: kdv rav civ act hkd
gay: gia gho duo
yto: gsx wxl wod
gkf: wju dss dok doa
bia: ihn ihq iso ipd
gzz: gtd wgq dnr doe jrp
gpt: wyt wsz dgy
iqf: ioy
wks: dko drp dwv
cma: atg ipw
cmc: alz ixk
lxn: lzw gss dgj dvz dfs
wza: dif dwk
rrz: bos avy ham
cvz: cmm ajg hmc hzf
cpq: ibg
lwb: gbe gmp wto wuv
als: ihi igw hbe hqr
gzg: wkr wol
ign: iwu
axf: hxf
lvg: dpy
gth: wwf wvy wns dtc
ggc: gqc wkm wuu dsv
cug: aat inz
imq: iny haa
yoj: glw gvl wje jky
bvn: btw cdc had
kbp: kno ccx cin csq cuo agm hvw hej
rrj: rqp rta awa itp
hyw: hvx
apy: izl
gmf: gqj wnn djw dsx
drk: dsa dev dpx
alz: inn hdu
hox: lek wye wmy
iaa: ilr
cyd: cen hed
blb: cdo cow arr aoy hgc hxr
gft: gul wja wpa dub
gqp: wvw wqg
kpo: bag aof iqu
dcj: dyb
dwm: dni duv
gbx: wkc wpg wmo wfo dac dqq
dmy: doq
bur: cxu avh
dcr: dcp
yik: yiv gkz gzm wkg div dgd jbf
cwn: cez coz aop ixb iqu
gdw: gqh wzl ddt
gdn: gzm dej dpx
gzn: woq
krk: kjj ccs amb ijn
yil: lyk gak wxf
icg: ilb
gca: gwv gee wgk wod dbl dhw
irx: iej ipb
wjd: wup
red: rpr bbr cmu hzn
rxb: cjg axm hjt
ihy: hhr
yqv: gkf won dzt
cqu: ayi hbd hec
bzm: cyu aqa aof
cvy: ina ifi ifz hik
ghl: wip dvj
aek: hrr hli hgo
rzn: byl bdw auv irs
cbx: igx igo ifa ife hfg hff
bpr: aab ihd ixz hje
loz: wss dlk djn
byh: ikv
lks: lkx lro leb gkw wbb
lcg: lgv lmv gab gfv dpv duq
cul: iix izn hcc hce hwa
rpw: bzl bus cti
kek: keg bvg csi avo
wge: dbx deq dxr
lph: gpz wgo jbr
cea: cfa ilq hjb
wsf: jri
bkv: cop abg axe aog hsu
ktm: brd bof ani ihx ieg hdt
axb: ipk hiw hes
cxu: cmr icc icg
kev: rye rlr bas bhi cld ctl
knn: ciq cvl aiu ilr hbb hbh hax hej
kae: kln rwy roe cvc iwf
lhe: lyh lln gpz guq wyq djh
bvp: ckr isd hio
ame: ieb
knd: rkw rrt bbi cha add igw hsc
hqo: yvh yor laa lym lsn lxj gdy wvl
bra: byi cbc ajh hsx
hdd: hfa
beg: bun ccm ceh aay
dsa: dxw
cnb: iyj hcg hdz
caa: agg ivv hhl hpr
kyo: bmp arf aza iuk hbd
lkm: gpl dhd dtx
yan: yue lef gim wlo dct dxw dmh
yof: gan gat ggi wwl dxt
cql: aou
wcs: wnt dkw
gbu: wlh wwq dvx
wwv: wmp
ron: ivj hma
lqq: gjr wdr wvt dgv
kgb: ryp cvp abq ajo iku igl itk
ano: ate ijo
wso: wef jba
apa: atm ibw
klg: rqk cyo akm ixl hja
bfg: iiv hww
idn: iqg hsx
guo: wii wxq
cbb: hwh hzc
dih: dwl ddp
lmz: gcw wio wmv wuc djt
itg: hrv hjv hsv
hoc: yvh lln was wyw wzg dxd
wbq: wcj dee
bpj: ibz hgk hdf
lxh: gau gyz gfl wpt
lkk: ljg gdb
bdl: bme cjz aje ibc hky
iti: hkv
dbl: dgr dsx
lmg: geg gft wnc dvu dvo
bwp: aox haj hdh
wfi: ddw dvc duu
bdq: bej bpt iwo isv
lri: lym wyn dbo jbc
kcd: kyk kod ris rzv cck iia
wgg: wnr wqs dhr jkp
yah: lgm lvu gpk wcl dgw jkp
kcr: khz kfy kqi rcy ryr rlh bge cvz igu him hjx
rzw: azj hlm hzr
iml: iof hmo hnr
rlb: rlx aac ion
bfr: idp isf hcb
wjj: wsf wpy wfu
roc: bss com azt ihy ilo hed
iat: hgm hej
ksc: avs iyg hpm hfv hzv
klo: kuk rzi bqg bun cbr azk igt hww
kyb: rdk cwz act aoi ivi ipb izo hgx
gvz: gur ddh
rvy: bac bww alo iws
dya: djy
hoi: yqh lup gdv wkb
yja: gfv diy dxv
yjf: ltb grp wyo wpj wfd
yxi: ldq gip gqy dci
wco: wyk woa
wsx: dhr
wpx: dnj dzq
hjw: hmv
bqj: bov bop abn hbg hyh
gdk: gqe gqt dlo dxt
rlg: rgh cyc awx img iop
akr: ixr izg hes
yxs: lig lxa lqn ltl gen wtv dbi
knu: bfu
wku: dqr
gcn: gte gob dhp dws dqy
ruy: czx aof ifw hpr
rmd: cca ayd anj
hgi: hjs
rma: byf bjq csb alg iht ieh
yab: yef yxx ytc laf ljv lse lfm
kda: kfa rxp rza brk ifm
lyy: lgr gre dvt dfg dfq
abi: avf hkt
gfd: dfm
iru: iim imt hzm
ysg: yos lil dlj
ksx: rbv cya ayd agr idi ifl hkq
bss: ikg hfo
ryl: cgn adt ini
lxm: lxz lmf wbw dzm
rih: rsz cez aye ijb
iao: hht hfb
irf: izp hwx
ivi: hlm
kxg: rhl rse bdk cyg aul hge
iqk: itr
rrl: rfd bsi cwb cto afg ihl iue
cru: ahr ayx iix hpo
rov: cia cdf ato iqg hdf
cqt: idx hpo
gqe: wli dkt djr dmf dfp dqg jkn
gvu: gmk wgk wzb dwl
kfl: bvx bpp bpm aqo hxx
ayk: atz ing hie
yxx: gqr did dqh
any: iiz idk idh
clw: cnf iuu
dyw: dzw jrw
wfo: dsv dfm
cot: abw
iyr: idd imh hmp
dbf: dhg dya jkp
wci: jri
glq: wje jre jbg
kds: ksf rlm bhx bmn cmd cos asf aum ikt hnc
aht: ile hkl
cag: agm ihz ilm hca hlx hnd
crs: cho cmw aae apy aqw ifc hat hhf
iln: hky han hes
ila: hix
iss: hyd hjs
rko: rgq brp cxj aaw
kel: rwx cfw czq
yzl: llb ljq wil wtf dee
lev: glo wuh dhz
dau: dua
bvi: cbd caa ave ieb
bmm: hjl hnv
hdh: hjz
rdw: rpy ruc ruy bks anp hhy
ryd: bnb cnn
ccw: ats iml
yql: wba woy djs dni dti duz
gje: guf
amk: hhf
kmo: rva cjw apw
wbb: waa doa
dlt: dwl dpd
war: dnl dtz doa
ahd: hhx
lzj: lud wlj drl jkw
afr: hvp
klp: rin brh bqe akg arg ala auf ibd ibp
rzs: cbd cpv aal hav hpn
lof: gnv gnf dkv
ywh: ypv gaf glr gex wax dch
luu: gyi gvw gfw dfj
wiy: wyr wfu dcc dit
aje: iub hzf
bfo: hiw hxp
add: asb inl iuv
lrf: lan gjl geg wld die dwq
bqg: aps ixj
cev: arr ayx ajh aom
yxj: yor les lff lfu glq wfs wft jrx
wqt: ddc
hsr: hzd
liq: lzf gaj wjr wjl dvu
rej: bbx bqz cid avl iol hdj hfm
ash: igw iey hsb
wvf: dpt
dzc: jck
clg: cei acq ier hbi hdh
lxu: lon gnw gts
ikm: iov hrq hlc
aoj: iml
rfx: bov adr ihi itd
kmp: kqy rpc arr auy has
dyv: ddv
amo: idy ity hab hqe
ger: wna wof dxq
rzm: cbv cvg apa
dgc: dwy dds dtq
cqb: ayw awv hgl hzs
rjz: clh hra hsl
gcq: wom jry
biw: cpl hax
jkb: jrn
bil: cnr hzg
hus: yko lro ljz lmn ltx goc wje daz dvw dxw
rip: rxv bbw bwh cvh csw hen
hiz: hjm
iin: ivk
dkz: dlj dtc doz
lrv: lyg gig geo dtf
krl: kvq rin rva rul bhc ake asu hzy
rbv: bmc cbt cam
yzt: lgv ghu whh wyf dop
lzi: gjk wgv wmh wmm dik dpk dpq dma
att: iye hjw
lye: gbh giy wkk
wum: dao djj
lzs: lzm dim dpl
ddu: dvt
yki: ypi wng wzg dpq jkw
yxg: lcj lha gll wwd wzd woz dkx jba
gfk: gqq wkm drg
kxt: kqn czv ask ixa
gys: gnb dct
web: dfa
bwb: cqf iok hqb
wgh: dvr
ion: hyi
kxd: ryd rja cha
bxm: cgi ihv iym hsy
wqd: dcp dew
rqm: ckh cqh
gxg: wmp dop
bzd: cby ifu
cmx: awx aoq ibx ipf
rsz: bye bzx alf hsk
aqk: ikn izr hlf
rvs: axw iyf hvr
kha: rpa roj rox cif iny
iaj: iis ihh igd iuq
ktc: aug icp iob hhb
wjy: wjt wsr dmq dtu
wpp: ddu
apl: idd hwu
rlu: rwa bkf aro azh hjw hnz
klb: kjh knl reg bgs cxz aiq iot
bea: cuq ane ioq
bez: ckh cnb iud
bkg: aco amb ide
bfe: cbi cfj hpg
wfu: dgz
bay: btp aoo idd
rru: bwy cnp ahg iww
kqk: cae hpg
ylt: ytl lcz lly lde wwu dtq
ryj: rlt bip cyi asy iqt iom iof
yiu: yjv yeb gip gyk djw dub
htz: yyz yev yqq lkn ltu wcz wil wup dhy dgq ddj dvh dtd
ljr: wiu dkx
ltf: luq gww gwe wda wuw dvl dsl
inq: hca ham hms
wvt: wxm drh dar dpu dmu
rjp: bhl bwi cts aly hyd
yxt: yty lkk grj wdq wfp dbq
anu: afm iay hce hxa
rms: iri ibv hyb hsc
cbz: cud alb adl ads ihr
kly: rii rne bwc bqi cbu axn ins hwb hpe
gbw: wcx wtt
yet: lsg wde wer dcn jrx
rcq: bsm avz itw hms
blt: acu ivj hdo
kvx: rah adk aox ing izi iox
lwh: gkt gad gno wtw dre dch
bxs: bxx btz iqw iqo
aix: aok iql
ads: hkl hau
wue: dru dwj
rki: bfg cvt hsq
ksj: kqm rxz bwk cxl cpz alx ija
abw: ifc hgj
bsc: btv cde cvs aby apk
luc: gha ghz gga gzm wau wdi wdw dcf
wny: dbx
lld: lwk luo glh geo dvh
kii: rnc bdu ckb cdx irq hkr
ikh: hbf
rem: chp awc aqd iiw iwn
asx: iii
kuu: rhk blw hwq hwo
aze: hym hdu hsw
wmd: woe dcs dad jbk
gsp: gfk whn dmp
rwv: bot aqy auf hqy
kri: kqg koi auw hne
hor: ykc yhp ypk liu lhl lvm wha wgh
kln: rgt bdi cfe hgg
hao: hxz
gba: gxj war wyz
wnh: dyx dje
bbn: bsr bny aeg amy
czd: arh all asr hlx
apv: ipq
bgh: afd auw isw ifz hga
bfa: ahe iap
huk: ylu lbm wvw wtz
klu: roq cen asl aef
ygh: yee yxd lbg lco lnf wkc
wqw: diz dvx dxt
kjv: rns cjv cmd ctn amk aqj
bre: ics
beq: bxu iyj izh
ljs: lmi wjn wff dkb dzi dtb
bjj: boc adk
hkn: hnk hfw
ybd: yaf ymv lcq dvv dps
lbd: wbm ddt dpi dqj jki
hty: ynr ljc ghu ggp gtp wte dmb
bdz: apo
bax: aqw imk hje
gfo: wej wms
cgp: ayl afm ikg
cec: agy awl ics
lgq: lpo ltu loe gmu
rak: aat isx ied hka
yyj: ywb lys glf dvj
wcd: dbz dwm ddz
yuh: gwg wrb dtu
azq: ieu hxn
wok: dpb dul jrc
boe: ccm alr aut ire icy inb
ybf: yym lau lxw wpe wop dwe
kmr: rkq rci rft bvc chg cym imc hcv
rfm: aaj ahv heh hpg hmh hqg
rkb: rvy rto cix hxv
ltq: guw wsx jbi
kav: kvf ikq ied imd izq
hou: ygd yey lya lmh
wpq: dwp jrj
cud: agk awg
rjw: clr cxd hqe
yfa: lrl gnb die
ilo: hqa
lkn: lbi lxp gvq gsz wca wxr dtd
los: gwe dlx
kpd: rka raf bcy bcn isg hir
lsc: lep lxs gex dwh
kua: bjl bqy csk csh
afu: ibd ihy ijq izk hmk
yks: yuo wbl wfy wtx dni dnz
cuz: iyd ild hpc hqd
ifp: hsw
ydb: gkf wij dwq dvd
iii: ijl imr hmw hzb
bpl: bnd ajm ibo hbb
yoi: wbp wax wwt jbv
dne: dfy
ral: rwn aif amk aqa ivx iun
yzj: wrf dmx jbo
hlt: hzn
whn: wtr jrf
knt: bkx bcc cvk cpd hpc
cgr: ays aju hvm
wnz: dds
ahb: ifr
wmy: wfn
gvh: wsu wfq dgi
lqu: gvb gxc gzo wfo dbm djh jri
yur: lch lcd lhn
ggz: wkg wog dlq dpt
irg: ivq hru heo
yym: yjv lbr gyn gdo gop wlt wqv
rjx: rnc bsw agl ann aqz hlz hwf
gpo: www wuf wou dfr
yco: lkc glp wpi
bot: cdx ayo
ggb: jbq
akd: api afi ieh hri
chb: cpb adz
rfp: bvf cmf aaj igt hyr hqp
knl: rqj bjw cwe iiu hkc
idi: iox
bxv: agg aeg aqs
kra: kog ror cdt ico igz hfe
klv: kug rlk blv ivs hho
ieh: hep
ihn: hqa
rld: ron cwg hgv hps hmk
bbe: bmw ifp
ixx: hwg
czb: abg ahp awh
gdj: wfy dxh
yej: grt gyv gvs gok wgn wzz drs
bmz: crv imf
kmd: rwa rmf rqg crz cia
ypc: gnp wyd dil dsi
wtg: dih djw
ilf: hec hqc
gts: wik wfh dsw
wuc: dkk dvt dmv
wdb: wzr ddd
ilq: iud hzw
iew: hco hpf
aaz: auk iic
ibw: hrc hxw
kut: bip bmy btc ajr ajm avm icd
bku: cce cgv cdx hvm
cua: coo awy axq aqs iae
cdz: cev ihg hkr hdu
ldn: gvw wsx dlb dur
wxo: dvn
cuj: iuu hdu hnu
kdb: rau rhc bcc ckl cvo aej atm izz
cqm: awu ajv hfm
gae: gdn gqp wiw wyp dbp dwi
ihz: iwj
ixc: iqv hnb
khe: koz rla bcx ckm awq
wvk: wnz dxg
kcf: rkf bpv bzv apj iza hfm
yfy: gte wag
lgu: wyp dbe dle dqm jbu
lrn: lzv waz wgh dus
baf: iim iev itf hlw hjz
hjh: hnt
yoq: ljf lom gxf god wvz wzy drb
alh: azj ils
bas: bno iiz ioq
gld: gof wfm dqk
cgz: cpw aul hck hes
lvf: lnv gen dxg
wlu: wvq weh wxl dsb jkf jbf
gvc: woj dbq ddr dnb
hhe: hvv
rdr: rei rfs rtk bpn hbz
lfa: wya wds wnj dri dzc
yob: ldh gmp wsm dhs
rgr: bny cqu aki hhv hdr
ghe: glh gdr doh
aai: ijx
ihg: hbq
iib: ilq hca har
wsk: dsm dpy jbe
gva: gvu gpv wle wme
dzt: jbw
igt: iqj
yrk: yhn yxd yng lzd did dtg
row: aua ihb iwl
rfi: cfc czf ata ijx isz hht hsz
kyg: kqc rjm reo bgq bzw cnk cnc iew hgq
wrk: dfg doq
rgz: rnf rnu abz hkt hse
ycn: ggu wbv www wmx
dbt: dxp
wru: wfq wtv dvv dsy
hob: yig yol yod lpa gat wpg wqo daz
yih: lom gzh dhk dsf jru
gjq: gsm wag wmy dcw deb dqh
wpw: dkl
kjz: bbs cwz ans azq hne hqb
csb: arr als hmt
dsp: dfi jbq
yvl: gio goo wuh
axy: ixi
rrq: rsi amm ihj igv
dha: dwa dzk dtw
ghd: wlv wgb wnl wuk dgh
wez: wxo
kbw: kmp rex rxs cpc arg iwq hwo
acd: ahy
kaf: kvr bvh cal ido
yns: lan gip gyn gmq wjv
gei: www dyw dnh
isw: ipb
aqd: aus
bfj: hkf
gkc: whf
ysz: liv lwd lvl gjd gxk dlm ddr jkp
ysf: wsd wmy
yhl: ldy lnp luj gxc wbh drq
gin: goc wlj dmw
lbj: lfm glo dgf dgt
yre: ymg lhb lxt lzr wbg wwo dnd dqd
bwd: bte cqz ags ipg hwc hxt
bkr: bfu crs idq
rxa: bje ctq afr hiy hny
yxk: yme yfm gvp dgz
dgz: djz dpx
gyv: gjk gmd wsz dkg jkt
lad: lih dni dtd
cta: alo ags auh hyc
rkc: rxd bhr bqs isl izh
hif: hny
aan: adt aes
gby: gdr gvx wba wwa dbd dip jrq
gjo: wto dtb
wme: djb dxn
yvv: lay lvp gbf glm doh
dtt: dug
wqs: wop jbr
rds: bag cjq cma hbu
ltr: gja wzd dkl dhm dve dpz dno dzy
kvw: rdv csp czk ctx
app: ixt hke
lzx: grq gch dbm
ifd: hyv hvx
inf: int hpy
wbi: wax wuw dic duv jrj
arm: irn ipi hdk hmx
lvu: gct wsq wta dro djm
iww: ixn heq
ylx: yqo gyn dkm dmz
ghp: gsq whw wgz wjc dny
lix: ljp lty ltp gkh glg gea wjp wzs dwr dox
bzn: aah auc ibx ilu hre
hgu: hfe
rtf: bzs ihy hcc hnc
hdo: hqa
cwa: alw hlo
iug: hfp
irc: hwj
byq: csz hpv
rzu: cdn abe isf
and: ija hgl
lbn: lyn grb gvw gpb wud
dpl: duh
adz: ihe iwb
bgo: acy aja idx ixf iox hco
ktb: bct bxg cmx hkp
wwt: dbw dmd dqw
kva: kni bsj cxn avp igd hdv
ltv: wvg wxb wfr
gpn: wdm dbl doz
wcz: waj jbh
gdg: wcx wwf dfp dte
bny: cca cdt adg ipn
axc: hbo
rnr: cux afv ilv iok hjq
dhk: dhb
czu: aco hyg
chh: cua hni
roj: bij cma cnr ajp ivm
roh: bri bbk cbo aab adf
kub: rlz rtm cjw cox isj imw iqn hla
yck: lui wlq wnz dxj dxs dfi dzq
gve: wkq was wux
ytz: wzu
bfs: iwb
dva: dto
aly: ady avd ami hes
rhh: bbj cpw aai hlp
iiw: iiv haa hxs hxo
got: wsn wpl dgd jbu
aej: icj hcw hds
csi: cuh ibe ies ipf ifz hjh hnm
iqc: iqj
axk: aum iol hkn
adv: avs
ldi: lva lqg loj wrg jro
rnx: ckk cip cll cnj aki avk aub has hnu
lmm: lzq gaj gys wpk dcf
yuu: grn dhc djy dum jkv jbb
aqv: aor hnf
yap: lvi ltq gfe wyj wmr dos
ydk: lxp lpq lna giy
lkl: lnx dnb
bul: cbh cwm izm hhp
bup: agd
amb: hvj hsj
wqo: dnk dfg jrb
ars: hrz
glc: gpo wcx whh
lyu: ldp lof dmd jrv
ltx: gcc ddp
bme: aso amr aur
yse: ynr lvg lte gxv wck wpw
wga: dij
dgn: dqk
awh: ipm hni
bbl: ccb hgq hes
gwf: gmq wyq wlz dcb
dqr: duj
yha: gww dru dhr dxx
wsg: wzf
wjo: wtl dpa
wjt: dkj
cxy: aqz hyg
blo: cbq cvg haq hwk
cbi: cgo cvu cpa
aot: igm ims hhi
bpw: cob iru hxv
rmq: rzd cyz arq hhp hjm
amx: ieq iqv hsw hfb
rvo: rnk roh ctt iob hgc
ajz: ibi ilv
ltj: ltu wkf wcv wnl deo
ieg: hmu
yim: yyr lev los gbv gju wos
cqn: arf aul ipt ina
dpd: dmf dnt jbb
lvc: gax gei wct wvh dwq
laq: wgl wja dyo dda dma dnc
bma: cik afp
lvs: get wml wtp dvo
khm: bqh auz iig ivl ifd
wam: wwg dkx dci
gmx: gfr wcp dus
geu: gnb wpa jbt
itc: hna
afm: hgj hqr
gck: wap dnp
yef: wmb wmh dwa
cpr: cqm hgp
yic: ynu lte gwn dug
bdh: bum cng ard aei
llc: lqk ggf dpa dzr
huu: yrc yqy lkm gjk god wfx dzc
gtk: dih dho duo
hdp: hvm hej
yhn: yvi yqb yty glm
amp: izv hmv
ccg: ahd ipw hhw
yws: gwh wji wjj wqx
btl: cko cps ctn hae hsa
lzh: wex dhm dgr dtn jra
rsr: bxe cdw aay aua ikg ikv hkf hay
wyx: dhm
wgb: wng duo
yox: lbk lcv lwn lpr gvv wyh wjv dxk dnn
dez: dnm
rpe: bog crx cgs ivg iuz
rjb: cyf aai adg hfu
aho: alr hkd hxk
kqw: bdv caj cgo ahq ipr
ynb: lzz ltx wdb dnz dov
kxs: rbj rdi rzd buz csm aku iuk
ang: ize hrw hfa
yzg: gin glt gxh whx ddw dsz
gtp: who dka
lcc: gxx wur dbd dxe dqy dov
rkx: bqv hyu
ggt: wbc wvx dot
rfa: bsh buy ako
cxt: cnu iln ioi
cps: ize hcm heg
wou: dct
bdu: iyl iwu idt
bvl: ado auu iuk hmg
bvx: cka cyo cmj amf hdg
hii: hhn hvo
hiy: hhj
yvz: lwp gdq god wyi wjb woa don
dhl: djs
wwr: wvc dfp dus
avd: izb hrt
wnc: dhv
rwu: cvt atu ihu iep hds hek
rvk: ats isc hfd
lhy: ljc gbj gmw dry dnj
htq: lag lmi dkn dnx
rzk: ine
riy: rex cww akf iyt
yix: ywf lwv lew gpv gfv wpe jbr
lvb: wcg wtc dsr deq dqw
wfj: ddq dnq
igj: ixx
cwb: coc alq irl
bmn: cqx aia hin
lzu: gxh wvs dft
ckj: cgj hxr hzx
kgz: rte bgd afi iif ijt
iul: hrj hlc
rir: roa ali hlt hgj hjy
ltn: wbu was dxz
keq: rlo rpu blp cfa ahl igf hri
ywz: lmr gyp wju wxg
ght: gwf wxj dbh dhk ddj
ifk: hnm
aki: agg
bsk: cxw coi aen iaj hbr
yoe: yot gxp wqz
ase: iuu
wew: jkl jrc
cze: icm iig ipz iud hyj heq
avm: icp
kei: kfj atm auo ihn izj
ibf: heh
yqz: gxd gfx wbd wvv dhh
iwd: ism itk
lvt: whj wtn dyn jky
acp: acm azx ibf iwl ixw ify
bvs: cdt ceb cpo ctq
ydv: lpo gmy wlh dbb
anq: ivh hcd hew
aqp: ibv
cqg: iwi isb
wqb: dje
kce: ksf rld baa cmi apb ann anq ijl hjd
avb: avf
byc: ccd arc iyk hba hjl
khi: ras rwe cdz aab hvp
bhz: ctq amb ihz idr
bgj: beb cro cvy aim aum hdl
ryg: rqe rub btz crm cde auz ikt hev
rlz: bmm cbi cuo axa atb
gjw: wde dgr
lqz: giw wdj dlc
yaa: lvn gqr gqa why
kwq: rzj rou aki iks hrb
ceh: cfo amm
bsu: irb hmm
czi: ayt ief
khd: cpi abj ada asr hft hzu
inr: hck
rib: bgr izu hkx hwz hnm
btw: avu hxl
wkk: wwh wvp wtx
cvq: ibl iai iau
cdu: axa iai ind hys hfi
rbr: rer bkg ctp cob api aux
dle: dgr
wei: dgr dfs
kol: rak crz aef axa ila hxz
lmr: ghf gph gti wty dpk
dke: dec
hya: hmb
dvb: dpo jki
lsv: lnj ltu guh weu wzz dzg
hco: hha hvn
lui: gwi wvt wez jkd
ipz: hra hmh
ixd: ini hwe
ldt: drt dwu
ywq: wye wve dsy dom
ilv: ige hbr
bbj: cln ahm isk ixv
bga: buq ibq iut
whf: wsl wnf dvs
ity: hax hmb
yhj: ydo ypb yur lpm gck wpb drc
axi: iik iny
yhc: you lsl gcb wjb
bxq: alh hmf
dms: jbu
axr: isd hxf
ajs: imi
lbw: gyd gdn wbl
wjf: dic dpt
rvh: bdt cez hlm
yfo: yti lha ljf gvr wju djz jkw
krw: kwp keh rbi bdg cul apn igv
gpm: gul wqi wox dsr
bqk: cjq iye iod
gpk: wzm dts don
wdg: wtb dcz
dcw: dgz dss
ksp: bhr bxo ipp
rgx: rwt asz afl hrj hhs
hmu: hzs
cbs: asl amx azf
aam: aqs ity hwa hwn
aww: ank ikq izb
roi: cjl aci iek
cjv: hsv
lvi: gei gpd wyh wgu
ysv: wek wuv dhd djf dux
ipb: hfy hqj
bnw: cuy iyp hvc
iwx: itz hxd
yfz: lpf lou ghv glr gjg gme wnq
iyv: ify iqt
glj: whe wmt dwa jck
ksq: ktz byp bwl agr
gjr: wbq wud dsb
btv: cam cau aex inc
lac: lpv lfi ggo wvz dco
lsm: lxq wcd diw
gre: woi daf djz
ide: iur hry
gbq: glv gqs wzw dpb
ynk: gcy wdb wxv wqz wux ddz dxf
gor: wmh dsw jrt
bhr: byl ihv ivq hhf
yhr: ynv las ldg wpd dwd
arw: irs
bmo: heb hfu hqw
iub: heu
rhj: bal bvx bnb bqb ccw cnd hhz
yhx: lgb lvp gyw wmd
gur: wyj dra dha dhf
bpo: cqu alm ibz ifp
rui: bkt baj cwk
knr: kou rhs bau axf hsa
kdr: rfo bcy ccy cdr ise hhb
kyk: kwd rlw bcz bqq cge hzo
lwy: lxg gib gps gpo gnv gom dxi
yzf: yqy yoa lmf loh got wig wmj dwd
dbb: dyf ded
lgy: ldh lea gam
gyc: gsv gfb dxz dxo
dzg: jrd
wel: duy
dhw: dhs
lum: wly dkq dhx dvo
lmi: gfd wrw dcd dyi dxn
wkv: wdo wtl
kgh: rnp bki bsu abx ayx agq hra hnj
dyx: dwr djw dun
hls: hnc
bvg: chc cpt hcr
iux: heu
ypr: ypg yqs lrc lnq grh
ate: ijy ipo inj hzs hqd
wub: jri
ycc: yvq yem lst gju wyp dhw dsn jrb
bov: cns akc iaz iqz
wvq: wfd dmk
ill: idb
awm: axk ill hnb
bth: imq hak
yep: wlr dkj duz
bzj: iuj
cre: ctp icp hmm hfz
abu: axb ifl
bcm: ark ayb alv haq
wth: ddg djk
bvq: cdd cxx aah has
hqf: yha ynh yfm lrb gzz wsq wug
raj: rxe cum
bgy: buo bos cmw ivo
lgo: luk gfa dbk
lds: lvr lmf gbw gik wbi wtk dgl
icd: ijp ims hyu hec
yty: yob ltg wlc wtq
huz: yze laq dyz dvn dvq deu jkf
amc: hgl hpg
ctt: axg amn aus iwp imj hdn
asz: iba hys hdz
dhe: dne
yes: lzq gbh wxq woa
lmv: gzk wvb drv
gub: who wer wtk dnp dzt duc dun
anh: iyc iet ifn hde
lqt: wuo
gyl: wzz dlg dlp
rqh: bbn bpp akh abw hpy
afp: ive ieq
crx: cwn acs hhx
iay: ifx hwa
bcr: cso atl iss
kgw: rzp cgu axp iiz ijp hxn
czn: acp ien hnd
adc: iye igs hzf
czh: ayd hsl
cms: asu iex imn
dzq: jrz
kzu: riw res cie irc
raw: rav bpl aib aex isb
ite: hgu
wzo: wtq dzt
ccn: cfr ann iww ivq
you: lah gtl wdq wti wuw
ywi: luy wxr wug dfe
bxz: ccd hbl
gql: goz whj dhm
rfj: beb ben cav cdq cjt ajw aux
grb: giu gex gtf dyz
kcm: rwl rpz brs bbp
aux: ist iet hyf hxt
ayz: agf ibw ipg
dge: del dtx
avn: amw itk hii
rxj: bfo iin ixz ifh hay haj hfc
rca: rpf csv cey cxx ist izu hav
gfi: wrl whd djf
wkw: dpr
wsc: wxv
dkk: dsj
yzv: yoc wfd dcg
lva: ghr gqs wal wjz woy
kxy: bca bik caf chf cmm hfv
apk: iog
ymj: lge gnh wjl wsg dpz
imm: hwm
kot: rfv cbn atp ihc
aqo: iyc ido
dpa: jki
lqb: gye gmk gfs guo
wxh: jrn
hwb: heb
yzh: yuk gru ghs gvo gpe guq
kee: bid bjj bza bue cdh ari hid
ixz: hmu
ycr: yfp gxg wwv wtq dzo
atm: hmj
kco: bva cca cdp cso iyk ito
bnz: cdt csl awc ikm ijw
gaf: gnd wzh
bcv: bjc bsy bts atp ibj iam ier
rhc: bdc ayc hsa
guq: wak wvb wqk diy
lim: wxe wnh dlq jrc
yai: ylr wrf din dmr
cuc: hqi
yrt: ymg lnz gah guf wju dez dzb
rok: ble bxt akr iav ijn iub
cwu: idp ijl hgw
wzz: dcd dww
cri: cwo cpk irm hwe hjl hpz
igg: ivx isb hjg
wlx: wjc dld dxl jby
whz: wdm wfg wzp
ben: bpu buj irm isf
lpq: gld
cza: aea amd idd ivp hbm hcd hll
wrp: wht
awu: app izx hcl
yke: yby yej lko lty dds
ygu: yqm ljx guo dzd
gvy: gfj goq whl wxo wty djv
ijp: hfp
rwi: rzn cnx czs auo ivh hht
bgb: beg ctf ald aug hba hfh
yqq: wwa wsv dtc dux
kjj: rxl rfj roe bbk cly iab
rlf: rgx byx bjr cjg aib aqt
yyq: lru gmn day det duu
ywk: yvy yul gyp gpa gtr
guh: wll dva
lzy: gyo gtv dra dfq
cgl: aeh ihd imr hyp
kve: kpo rbe rmz bni caa adn ifp
wly: dln dgk jbz
wfq: drl
ktx: rwy rxj bgz avn azc hxe
bxb: axl
bpk: abj iuq hel
kvc: kpi rvd buj clv aem auo iez heo
rxk: rxb boz cue idq hbt
ygs: lrl llv gwk gnv wbm wcj
cnt: are acd irf
cmg: czt aof ijw ipg
rjl: brf bby bhi cop haj hjo
yfc: ytz dla dpc dol jre
asa: azt izl
ail: inr hsa
lkh: loq gcs gpl gfo wsu wpp doo
yph: lvl lte gvl whm dxd
itp: hjl
rim: byf cbb cdh cpy iqj
gwn: gfd wbo wus jko
llt: dpk dfg jke
llb: lol wcx wyl wlb ddf
ahm: hfr
btq: ipe imz iov
ksz: kzm bpg cec cts ama atz ijq izw
wct: wsm djm
gzy: gtc wbm dsu dfs
bix: bgh cno hyv
cpp: awv ajk ipu hmg
abv: ifh iqr hhm hxc
lgv: lwc lmu ltp ggb dlo
dxj: dxv dos
bui: ccu hvj
hoy: yri luo giw wir wod
lhc: gcg gwx gsl wiq
wfn: dmw dqv
gqs: dgz dqu
cqj: atz att
yqd: gol wgy wzu dct dfn
gyh: wgb dme doh
ygi: gkg grp gav ggl djv dtr dod
ayd: haz
lca: lwq lnr wvi wof dsz
inz: hgs
kuv: bqy adj atc irc hsk
keh: kxl bow afw att iuz hcr
lqg: gey dwu djg dxw dxv
kay: rnh ccp abb irh hbu hyh
grr: gyi gsl wdw drx
lrp: lqp wtc dkd
rnw: bll awt axs irs itt hew
rpg: iyo hlr hgi
coh: hsw hpd
rmb: rmz apz amj
dvw: dth
dio: dsk dui
iir: ipm
wac: wji wvf dyi
ygj: yzv lzs gpq wsr dyt dfx jcr
les: lpd gci get gpi wqt doi
ipt: iqk
bty: cpt arw axo
bql: cck aal hlz hzv
cwt: ihq hgs hwr hep
guz: goi wht dwg dqt
bqf: crt cgy css axc
hto: ylq lrd lyp llf lfz gsw wvf wuq
brr: bjo bne cra anf ira iif izi
azr: iyn
btb: clp iaa ixk hkz
kir: cdv cvm amz hml
dmw: dth
yml: yfy lpy ltn gih dsb
kmh: cwl aco ihn inv
cke: crj ccr cqx aav aoe isy hao
clf: abf ajl aza
kxa: rre bju bxr abx aix iua hrb
itr: hls her
ljf: wph dvs
ryf: bsb chh iee iza heo
gxc: wat
wxf: dxs dxo
kyu: rwz rvw rni rzj bjd bfe arv ack hfd
cyl: cql itn hpn
lxd: gcv wso
dvm: duq
luv: gyj gxe dab dxg
kqr: ryk rjk adc iva
buc: czu hsz
gkd: drc
bex: bxd coh iww
iio: iex
lxi: gfu wgy wtv
hcx: hgz
bly: bok cvc cnv aau iox hyv
irw: izd izm hlo
cwc: aez
cus: ids
yuw: lsl lee grn gnn
cun: asl apn ips
wod: dsf dtq jrr
htp: lke lqi gck glj dkf
aaw: hil
lef: gjv wbo wpa woo dgb dxi
cnd: amm aqk imn ing hwk
wnt: dku
yiy: yyn ydn giu wrk wda wfd wfz
abq: ado
dhd: doh
atp: ipc
bxi: btq cks ahi aqp
cat: cps cmi hil hqs
cng: alw hjd
dxe: jkv
cgi: iti hmd
ytw: lbu lvn lxs grq wyr wxj dcz
kru: kfa raf rmd bav byh crx aru ahk ixs itk hag hyg
hgr: hqc
gtb: woo
lpp: ghr glk gnh wcp wui dbb ddl
rpa: irn ipd hne
hvh: hsf
ith: hhl
rqi: rus bqi cur ibm hqp
wdo: dte
cnp: hpd
wkm: wno dqp
yut: yof lws gnf wgo dho
cdp: cfg agi axq atp ikq iok
itt: hpc hqy
kvs: key kft kuo blw
rlp: ckr ceg hhw hmp
rmh: cuz ibq hxk
wol: dkm dxk
ceq: iys itv hpw dsu
geq: gtb gtx wyn wxi dnz
gjx: dcw dmy dfc dod
wra: dfj
bqy: cln akn
ghx: gwt gqx guu wdd dee dof
iaw: iee hki hxi
aum: hiv hzw
rxu: bhj byj cav clu cdz hda
ais: inm
yrq: ywq wax whi wds
wax: dfw
cft: abe avh ilf
bdc: ctg ahk awl aev iik
laf: lod dus
csl: cew amt ivt
bvc: cay hgt
lod: gjw wbm wgw wma dfk dfb
ifq: iug hws
lfl: gye gps wcm deu dpb
dwp: dmf dns
hwc: hje hvl hmd
bpd: cst cxj iel hjw
czc: hws
wsm: dew
raa: bbu bhw ioj hsl
gzc: dcs dvj jkj
gro: gfy wkd wle dqf
ymq: ldz dok dor
ces: igl hrp
krz: rti bfo cve awn iji ivc
drw: dvq dew
gog: wdc
cyu: agf aqr hhz
dch: dig
aio: hle hdw hpj hpf
lqn: luo
lzv: loc gjo gvi wge dbv daj
hoe: ybz yai yjf lpj gbz gjh gnu wyp wqj
bcu: biv blg cdl aiw icu
gct: gxh dbd djf
gqo: drt
ygv: ydu lrs lik wtz
gho: glj gjs gfw gfm weq
baj: cqt aef irk
bae: bxq cvv hac hqc
acm: iaz hgr
wgd: wnx dxm
rxq: rft rzc csg cse
acc: ayl agv aol iyr ime hrp hsf
gcl: glh gzd wbu dez dnk jbv
kjp: bym czs afy atj
wrj: whv wlr wws drw
djp: dvp deh
wnj: dvd
iyi: hck
ior: hcs
cdo: icx ijb
rdh: bkm bbi bel akq ico hwe hxk
boi: cmm ahf hvd
kkb: kbx khe rev ccf cvl cny iyd hdg
bfm: cnm ihl hzb
ynv: lrc dkf dyh dga
aat: ikp hfz
ayq: ade hgw
agi: ioz
ywp: ydb lck lyk wzm dya det dua duj
lsn: ghy wkb wkj wpj
iqb: iuz hrk hiz
gsr: wkl wyq dfa
bqz: aop itj hbr hao
rji: bwd akc amr
khc: cop alp anv atn ird hju hjo
bua: cgq ady ioy
gtj: wvz wtj dho
ljo: luo gyx gev dnd
gyb: goa wcc wxw wqv dcp
yaw: ygx gsw dlp ddv dpe
rpz: rqs bfg cad cpl ajt hct
ldw: wat djw jka
chy: cgk ipd hze
hub: ycz gha gyu wxo wtx djt
yhb: ygm wcw wfl dfu
gqv: wny dlg dnz
bih: cvp aky abf iii
bbf: bur cir cwx afz aua irb ivw hyw hzw
lav: lxr wst wmc wti dkk dlv jbd
lqm: gdi wnu djd dfv
kgr: kdc bkl csf
bef: bmn bon cns aad ail
rnu: rzv bxe cwo cuh imz
kcc: kmx ruz bbw cut aau ijj hqx
ilu: itz
wkr: wrx woy
htr: ywt yea gqb dnb dfw jrv
gmg: wmd won dsz
kuk: bcz crv abu ilh itd hqi
azu: iba him
haf: hwr
goi: wtv dxv dzn
bgu: bvk bnr cib csb cet ctr ahl hfy
ikn: hes hze hzu
wlq: wup
aez: iqy hhs
bap: bnv avn afm
bsr: cml arh
knv: bcq bwh bxx bqp bty aml afe aqo igy isa hve
cxp: axb isq hca
gfg: wln wwp wog
hsg: hen
lwm: gsn dvo dnq dtu
avj: hxo
ysy: yel lkb lgb lof wnx dac ddo dtp
huy: ywj ysz gfa wlm wut dli dxa doa
csz: izu
rqu: bal cii ikc hng
guk: wbf dvd dvm dod
dvy: dvq duq jks
roz: bcv ibw
amu: itq hlf
yrn: yil lbe lcl ggm gql gtw wgc
yog: grq gsd goj wrl wan dhd
wtm: jry
dam: dmj
hyb: hmo
bqs: chy cpy awi
lax: wvj wst wfv
inl: ifr
hoa: yic ygz ydt lrb lys gbw gat dwm
bem: bxt bnv cbq irg hqv
daj: dye dem dml dny
asf: apc irj idd
icf: hkj hkn hea hfu
ggp: wes djw dxq doh
kdz: brp bdr bdy
yyu: yml lcq wlm wet
ave: iip ilv isq
ydf: yuu yoe grt gfh wvc
hiv: hxs hmo
lgi: lzf gdw dwi dvm
wwp: dfe
dgs: jbp
rob: bey cji abz iyh
gii: ghe gfs dkw dih dxo
kye: kle bxx bme ams hsp
cyh: abc abd acy iib hda
cpv: hxn
anb: isd
icj: hsi
wwc: wss dic
cde: hyb
bun: ccj ctp auz
ymh: lul gsm gua wxn dvx dep dnp
yrm: ywq ymp lkd lbi gwd gol wav wiz
rlw: bxt cyw cys ihi itv hyu hfj
cxj: hxw hqb
rck: rwt azr aob icj
irt: izo itt
cgd: aau adg aou hvk hvq hzq
hue: hok yif lkb lhu gfm dtp jbw
ckv: ieh hcp hml
avu: ant ihi iew hnl
ktd: rfk bup ijh ixc
yvy: ggf wsu dvl jrn
lwx: let lnx woo
llm: wyg dxd
wpk: dhj deg dxr
bff: hsq
ygt: yfd lri gpv gfj
wud: duv
wft: dxe
kpv: kpm kox rzv com
kse: roe cfl ahx azc ati imq izq hxm
imd: hyz
gmc: wsp dan
dae: dfm
ypp: ytz lgo wig wnt wqb
whs: dfl
avs: hgq
yel: yeo lrs wba wex wfk
wxz: wuj dck dho jbt
kfj: bup aak iws ixg iot
rqt: blz ctc cta iwg hdi hqb
djt: jrs
awg: afl aoc
gte: wfb dxq
lpg: gsb gna wav ddd
csa: ihg itz hbq
bbd: coe cou axa axd imn
koe: riq bli bmb aie ahz hbo hfs
bcp: bdd iik
hau: hib hyn
cwq: arz amj iec hwc hej
csq: cuw iaw inh
bud: clb coe alq
yeg: ldl lqj gsp wef dfh
ics: iqa has hff
rbn: bit agi ick ilj hhi hgk hdy
ive: isc ixn hjr
lig: lgp wry wxf
dng: dqo
iwl: hnm
bie: cdu cjc cty agb asj azf ice
huq: ybu ynh yqj dcv
gps: wte ddr dds
kts: bpd cbg cly cqd arj azk
rdy: rjz bdz bfn aqs ibr hxh hmx
yuc: lbv gtv wzp drv
kle: kvs bak biy cdn ivb hgc hsp
ghr: gez gzc wmd dap jck
rgf: rnn bxq btc ivy hba hsa
cbg: aay iyb ivx hgf hfq
rqp: bec bxc irb iyu ieo
kzi: rxg bra bdx bdn ayj agb afv ipv
kdg: kdz ksh rlg bea ibn iwt iss
get: dkp dat dde
kgy: kdo cyg aym
lvw: lnd gdf whj det dzf
kmx: crg acd aza irz
lmn: gtj wie
gta: gun goy wca dyr
czx: icu
cqo: acj hcf hsq
bwl: btz abs aga
ygn: ytp grs gbs gdt wpp wtn dyx
lob: gku ghv gnc dwd
kxn: rth ahg aww ilk ipw hmx
awy: aew ioc
dcm: dco djz
luk: wjz wpz dbu dsq
kfm: kfq rdq bhv bzh abo
iry: haw
iwt: ijz
afi: aup ivz hrm hlv
cfa: ilx
rqq: rua cum ajh aue ijn
glp: whq drc
laa: lxv gaw gwx gef wjr wqh dgm dsd
wmr: dbh
yls: yfy lcg gpn gny dkv dib duo jbj
wgu: wqd dfc
asv: aqn inn itq
ckx: acw anm irh
kdy: cjx ifb izv iut hhw hnh
whw: dej
yoz: gko wcw wiy wtt ddd
dpc: dub
ypf: yfh yop lzl ggu
yea: ytj lrd dia dhk dwc
yqh: yqq lqd ltc gti wje wsj dvh dvt
hux: yel lid gke woc dke dsd
bjc: cty agq
wvu: wty
bwy: cdj ceg agv aeb iue
rrm: ran bqx agj ijm hay hnd
wgv: wsy wmg wzv
lqc: wvi wuv dyk
bzo: ayr irt iaz hfu
gge: wds wjk dtq doc
kbu: biz ble agw iny ito
gem: ddh
kef: kqk bzm cck cxg avo ipp hbr hsw
aoh: hxb
wpm: wqb wut dtk
ivy: ino hqd
igp: hgc hsm
kxb: bzk cyn aqp aoj ikl hfz
caw: irk iio ijl
bnh: cbu clz cxz ash afj hjf
yxv: ytc lwk gvy dmp
wde: wfq dpg
lzz: gxn guy
gry: gwy wbt wjh wnr
cgx: hxq
cep: auk
ghj: geh gnk dek dnz jbw jbp
ayp: hpy hfs
gap: gxs gnd did dxp
yac: ygr gam gfz wjk wsm
yni: ldr glz wwa drz
cjc: ind
kmz: kty kot brl cnf igb hyo
rpb: rnt rfp btv ckg hfc
ygd: yvp yxc yxw dkn
csp: cew hyt hsq
lgl: wrp wpi wnz dkf
lcf: grk gln gfw wsb dpy
ypw: lgh gic gwy gdc gej wvq drv dsn dmg
bwm: ifu
cof: ana irp
cxz: asy aph hvv
gep: wvw wnf dzu
cuw: abt ibs ici hal
cgk: ces col anb ikm
gnr: wyy dhr dga
yav: lzf gbe gub wkl dhg dmc
cdy: ctz axv hcd hgy hvd hea
gkm: wpy
rlr: rfo ctx isg
lhj: gca wjs jkc
ldy: gof wnf wft dra ddr
csd: ich hwo hzd
brl: bck ilh int hxk hpl hmy
wlm: dbv
bjk: cuf
aqq: ifq hwy
dgv: dwc
iig: hsc
ayc: ajz apq irh
ako: iho hjk
brw: hdq
wch: wwu wms dil dgl dsq
rlm: rem bwb clp iwu hjf hpe
cuf: awr ire hlm
cuh: ahw ioh hjs
azl: ikz
awx: isn hkh hwh hwq
bat: cqe iet
cet: ifv
cgb: adi aju ass ihf hwv
bck: bwm beg itx hda
abt: alj hrt
rst: bek cno aes igy
gut: wmr dic
khv: rrq bpe czw ild igz
bse: ard abe agz ivw
kpz: kof ism iqu hhl hjo
ywe: lyl llm leq ges wut dsu deo duf
brt: akx iqz hdj hpe
bbu: bwb bvo clf czu hbx hxm
kud: rkb rca rzg bvm crd hpm
rpx: rny adw aox ikq iyl hpq
atw: iee izz hxd hpi
cca: cwl aez ami iyf hrm
cil: cyt cly akl aer inw hqy
kcw: rmw rfa ruu brf
kwx: bsr cye clm cjd aww auc hfx
hxi: hne
czt: agv ajp hxw
yjq: yzl llz grd gha gsu wmb dgn
kpq: rie bhv bwx clu anh aqm hgl hqg
ihu: iuc hjr
bva: cxe icg hwt hvb
anj: iyi
aeo: inz hao hml
wed: wzx
wqk: dnw
wuo: dbx
akw: afv irv ibr
clv: avx hby
gtw: dve dsb dmm
hwa: hpf
yqw: lbh lws lei lmh dro dso
dnp: dti jrv
iid: isi
grf: gvq wdq dbc dzs
dkc: dvr dxe dpc dut jbu
gbm: diq djr dvo jrl
ypk: lqj wgi wdt
kqy: ber cqn ani aqq igm iju hfj
rau: rhn brw bmc atd iai
kez: rlv rps bsb awr anl ipr
con: ibc izw hem hqe
auz: ikj ibz ipw hhb
wrv: wzt dbo dam ddc ddl
lki: lun wdd dgq jkq
kcj: kgj kup rcu bdh csv avk avn ixu hhz
kad: kth rku bib ahm asi
gir: gof wad wqr dta
cwf: cmi cno cfv adz aou
wqe: wqf dds
rmg: rzf bat ihb ihd iep
lcd: gxe gzc dxc
knb: kfp koa rfp bsi bek buw aid axf ipl hsc
roy: cyw cgr cpd hjn
chf: aml
glb: gna gux wbs wsq wmn wzx dpp
rjn: bus boy and
rtr: byy cnr cug aiv
kck: kci kdc bkt bqz ctm igg isr ifk haa
wxs: drh dzg
cfd: iiw ihv
cov: acc ajj asi asd icv ish hlp hzj
bgw: ahb aqr hcy
bkn: bse ibm
aja: iru iax iwc iwj
rif: alx ija
gbc: gpy gzv wyj wee dwy
buw: ali hjn
kfz: rka rzz bti ast hag hfk
boh: cit arg
btx: akb hcu
wta: dgh dja
kwl: kuo rnk bms cia
yus: lok dhs dzn
dxx: jky
gjl: wwi dsp dfh
rbs: rfm blv cah cea
grv: gaq wwi wtt dfz
bfl: ivs iuo
yjj: yml grd gpo wrt wou
ylm: yvl lew gjv wyu
yzk: gjn gur guf wjq jbr
azt: igj hah hdx
rrx: rib ryh bvr bnl csx csm avc auf iiz idf
rtu: buf avw hsi hxe
hvf: hsp
wxm: dih dil dms
rdf: ree ani hbk hmt
gdi: wyd den dxa
kkw: kmj rxn rfp bzd csg cxx ack hmp
ymf: yzw yot gza gtg wiv
bci: bld bjc buj caz
izn: haz hfg
kjt: bmz bzq ctr akj hwg
rmv: abg ama iuo hlc hdn
bcx: bio blc crd aim itw
ldo: loh gal wla wsz wqi dmb dto
kwe: bil cid cjc ips ipe hhk
imj: hnq
cae: icb iac hkz hlb
dlr: dje dts duj jrf
dlq: dwp jrg
wjs: wuh dxk
ikg: idz izu hcn his
isk: ier iqb hkw
gjd: wkh wze dfl
yzd: yor gsa wqe jkb
gxk: wel jbs
rnl: roi cbr cgu cvx ayd adk iri igb imm ina hyg
rbj: rjz blt cwg icw iwc iqe ite
coa: arq ajt hjr hjg
cbu: isd iel hdk
lar: wrz woc dqz dop
leg: lfg wyb dkr dna
cco: ahs amu
cpk: als aun
drq: dch
ilp: igx ipp hka hra
cmh: aky ajy hvk
brh: bhn iwu ijm
cxl: cfv anv hdm
iis: ipr ioo hlg
ybj: yuk lvt gnv wsx wso wuo
gip: dcx dna jbm
gih: gid gej whd
lbf: lgl ljw lzn gem wrv
cks: cjc avx ibs hai hns
yyl: gsp gxa wlg wji
rpk: rmh chz ajh idf hxt
lwp: ljj gbu wvv dbb doj
lbz: gwn dfp dth dou
bnl: atc
igz: hdp
lxg: gep wdl
bdm: cxe ael ipw iod
gzs: wwp dra dwm
ccm: cpx aiq ial idt
rap: acs hyo hdo
yny: lhv lqi gcy gyx wkd wws
aar: aep ibg hym
dwf: dpc
bob: cvs cfb aei iwf
wfr: dws deu
cfb: ctt
clq: aet ipy izf hiz hwc
kqo: kun rjt ijp
rbi: axy atz hao heh
rsd: byt agn hyt
lpc: gra glg dmn
irq: ioo heh hfh
are: aqh ilt hcf hdb hjp hed
inb: hsa
rfu: bxc aha aup idq hru hcv
rjj: bpm btv ieu hhl hqe
rbx: rti buc awb aoe hep
wng: wth
ccq: her
bzv: cvj him hda
gny: wtl dhr dnw
wsq: dho jkl
khx: rdv rug cky cok irt ixr ink
cll: abp aeu hca
lcy: lsc gjw goz dyf
rjf: bby bdx ciy aut
dnx: dui
gsy: wie wsp wnj dol
bsb: cho cyx cjl cfy czk
gkx: wpk wzx doz
yiq: ymc gfh whm dhh dla dlw
dre: dge dvm dpz
clp: alj hdt hxb hpf
wnk: dbi
ack: aeb ihp
rnt: cbu cfz cor aue
abg: aiu iad idv hbc
lfp: lqz gzs deh jrk jri
dnm: jrk
kcs: kii rld rdd ade ihv ijq
clj: csx asi ith hcf
lvp: ddy dss
rft: bpj auw
hhy: hdm hsp
det: dqx doy
yhw: yzm lpq gke wvo dcq den dxr
abk: asc azr hhu
wjp: dkq
bjo: iur ioj hak
gdt: gmp
yqr: yuj lcr lik dqo duz
yen: yxo gcp wwg wdp wed
bqh: aqx ivi
kqq: rkx rcg blk cag hfs
ivg: itc hpb
ifb: ioh
kbg: bdo bvl apq amq iek ifm hbk hmw
rax: biw bnr inx ioz hfm
ktj: bwk bjh ccf hag
lcv: wyz dsk dfz
hws: hsm
rfw: byp bjp ajp aef apw hln
auu: iur
glm: gev geo goa wsh ddz
wio: jrj
wma: wml dnd
hkg: hyr
apq: ilz hhq
wpa: dzp
acw: azt hdu
wym: wjg drd jku
yue: lme gcj gyo gdd gsn dsx dny dtz doz
lfz: gyu gqa wxd dmu jka
cjq: ajs iom hwm
icq: iwl ham hgj hjk
yzo: gwo wom dlx dxg
lqw: wzv dbl
yyw: lre gxx wqb dee
rxe: cwi aln hst
hoo: yep ghq wcq wnr wny wfu ddx jka
kpk: rpf ccl cpd hrz hig hid
ccy: cqd ano iuw hbh hbx hyy hnf
yyd: ysg lrm gsh dzi
gdc: war wiw wif wwi dcc
kvz: brm bcc apq afg ata hgn
isq: hci
gpc: gqy dxr dxq
cia: arn
lkt: ljs gud dih dvk dpj
wbh: dgm
axs: hsb
boq: ajy avz ifi
ioa: hza
yqi: gnj drf dtx jru
ane: hpo hzo
lqy: gog dxz dnj
coq: aas iiz ili
ggs: gmt gfd wdv djo
gww: dxu jkq
lru: gfo ddu dty
iwg: izk iut
boj: civ cfy ake iaq
rjg: iwn hrz hze hql
gas: wka wux dif
chm: cpb iif izg
byr: bjz bnx ckw abb hhs
ihm: ita hkv
yhh: lsw gsk gsh wxu dbn dls
gqq: dbj
bvr: bqi cfb akp agc azm aqh inm
lbt: gph wre dph
rie: cts amp isz hji
ayr: agv
azb: ixe hzp
yfn: yza gwy wwv
ype: lbx gee gtv jbv
rfv: abf hha
gbf: gxo dcr
lxc: wwz wtg
bwx: ckq ciz aai azy ibs ixe
buk: abz aha iwr ija ivo hcy hhk
lyo: lfe gst
chk: azq ieq
bzw: bqq anv afa
koz: rea bcr bsf cuy arl add ato ivl
cxr: avm aol
lfb: gzd wbc wxa
bta: aao axj iqa itu
cju: iak imy hll
wvz: dmi
rnj: run cgr imf ifa hwx
kgi: bvc aew anb igs ixy hrr
gdu: wdb wnz wql dky dls
yao: yes wnz wzt daa
lle: gyw ggv wwd wdn dkg
bow: afc iit hal
hvv: hny
cko: cgv ilc izx
kpx: knv rhg cip ahs amn isy
kag: kyh kzv bwe cyn axz icj ifh iqx ite hys
lzp: wex wun dyq dzb
bjt: btt civ cnl cue abq ait hbh
lfc: loy wrn dcq dub
aef: iri icm
yot: gtt whk dqg
yfi: lku ljd lvv lne gwo
ksd: roa abi afe isd ifl izu
kyr: crq cpu ahq inv
ytx: gcq gmr dwc djy
lnb: gfn dau
wxw: wtc dzd doq
gzx: wpr wul dkt
bti: cht cws iyq iqi hbn
axn: hfe
giw: dca dzd
ass: hzk
lli: dph dtr
yfj: yub llo ltm wwe dzf dqx dqu jkh
hig: hdo
iih: hky
lxv: gbp gah wyw dlj deh
bkp: baa cqz axb hle
ket: bmj bqb aag aot iip
gnc: wzn
ijr: isx haz hpt
bye: ade ioa hst
ida: izg hcq hyu
wxd: wxj drm jbi
llr: llq ghe gyv gja gfl wyd
kxq: knw bkb bci bee cka cjb czc aer axy
bao: bxg cjt akh akf
dgr: dfn
ybq: lrl lvs gxd goh dgl dgq doh
wwx: wfl dek
wby: wjo wfk diq doa jcr
dbo: dll
kdw: rqt bcp cme cnv azr igh
aun: iat ixp
gkk: grp gpm dyn dgj
ikj: ias
yce: lah ldz dim
bbs: aup ija izh hic hwv hvz
khg: cvc cnp aak aah aiv hjy
aqa: iqx
loc: gel dlp
rbo: rfd rok ibc inm
kgu: rjw bpr afw iyf
kvd: ixi ifj hcd hgc
dzi: jkq
ckw: cbc ang izi hsn
wrr: wil wzc dda
lfy: wkc wen wuu dpo dfv
lme: gyj wmz djt
kfo: bap akn ikr ilf
abn: azh auh hde
ybg: ync lpb grl gbt gxw gns gqk dlh
bdb: cao cuq aiu ihe ivn imd hni
cfg: aqj
cnm: cnf czc ixx hbq
wtl: jrt
ajn: ica iih
iza: hix hmv
hhp: hzh
ydp: lvg gwx wbq whz wvy wof dyn dwb
cyw: cei irn inu hcn
cbl: ccn ixt
raf: rvb rsi rmd rzu cgj awr izn
yev: yom lor gzg wis wdy dux
gvo: dww dzt
rga: beh bfs bqw clt avx izx hsn hqi
gai: gwj wre wbe wmm djc
bzb: cic cnh ior
cxd: avg hvl hza
dka: dtp
hin: hzg
kfn: kzm rrs cif cyl ceq coc
hkp: hyo hsf
idj: hic hhv
kyh: bye bng cpe axz iki
igc: ita hir
lyd: lnb loj gbm wwk dmn
byt: cgo awp ivx hab hgr
yjl: yse gcy gdc wsm
lqd: wpk dqe duw
yft: lkf lqr dmk
dwi: dtr jkl jbs
czk: apz amw
ddi: ddo dmo
keo: bvg cgu cvr cmk hzm
ipw: hka
klw: rvb bbs bca cns ich
gtc: dbt dex
reu: bcc cpy aca iwh ivf hgy
ruz: bki bid iha
aud: ibu ivp iqp iqm hja
afq: ics hmi
cuk: cui izv hep
ybx: yiq yhf lxt jbx
cjm: cfm iaa iit hlz
goq: whh dtg
rwr: rvp bxv che cuq iub
lol: wyo
cdx: aix ags
whm: wvu wms jri
bjz: asc ikt iog hpc
asg: ieb ixw
bbo: bjh che cdu
gkn: gis giz gys gth drj dgg dnu
huc: ypo lvf gpd gfv dhz dyz dpr
ahq: aty ibe ifb
cfj: afq iqw ior
lqs: lop grd gmc whc der
ruo: rox crr iui hyq
kho: key rpw bbo byy bqv awe asz ioa hdw
rhf: rht cfm cuy alz hxj
gnt: wif dfj
hth: ykj lih ljb gkd gbm wcp wza
krq: rht bhr cfz cqr hch hvf
cax: cdy ahd hxo
cvk: cst arl amb ikw ibn hdk hxq
yrf: ygv ywp laq loq gzt gqk wfe dyr dzf
yky: yyn wna dwd del
kxz: kpj kuy rfm rog ite
kjg: rsn rpp iob ioa
ray: rsu rpp bhc bmz chn coi axd axt ijm ioi hif hxq
dti: jkr
lve: gjr wgn dvs
lrh: lud gnx wjh wvs wxz wub
chj: imm ifq hhh
dbn: dyx
bet: cqe irr ieo itp
glu: gva was dpi
luz: wkl weo wza dbl dcw
rod: cdl ase ikd hkx
hxh: hxx
rwf: bit bdf cqa ivl
cob: aje ihq hjx
gdb: gqy dna
czs: ibj iob hcn
rcv: rvb bdu abo amb
wko: dwk dnm
ggh: gdp gfe wsx
yij: ydo wdc wpy wuf dgz dmf dtm jkp
baz: bxv hvq hfn
bwo: btp azm atg hks hey hej
dbh: jrf
gzk: wru wbc wiu wpo wfn wur dxu
wdy: wpg doc
ags: azq hnj
alv: ajg imy hlu
bai: clc czo aja ajg hco hjv
kgt: rhn bqp cid cxq axl ihx hma
ihj: hds
cbt: ijz hcn
gyw: gdh gvw wwc wfl
ypg: yof lyt ljg gyz gxb gfn dke
gdf: gzd dfj
iyj: hvj
yma: lxu gis dyf
kgv: keg bkm bgb aoi izt
luy: wjr dwh dqf
yjn: ldn gdg gvj wer dpz
whh: wll wsb dvi dpw
imy: iqx
ayg: adh ixc
ims: ifz hxx
rgn: rqt rtz bhv bqy cai cyu inx
atc: izd hel
wse: wml dfa
hlr: hes hzh
glw: gtz waw whd wji wog
ksu: cxi imo hkk hrh
ltk: gud dps dpt
yta: lik gif gdq gsb wuj dne
ygr: lkz lxt gim wal dbk dab
caj: csj ins
ago: iti hif
hbq: hlm
lkz: gul wrv djb
igw: ixg hjc
lre: lgh ldw lpk war dwo dnf duw
kml: rjc bhn btf ava iib iug
ilh: hgx
coi: iuq
wrq: wwy wea wnb dgy
gfy: wsm dnt
rsf: bvj cuc irf iun
kuz: rwo cni ayx ixk hqx
afc: ivj hmw
wbd: wde wnt won dvc dmj
lmq: lom gur gui wjd jke
wey: dpu
ilc: ifg hke
ike: iit ids
gvf: wdb
yeo: gbt wea
dkl: duw dos
ckt: cbo cef czd cuv alh afs aoq
rea: bqo ajs aor hfq
djz: dmd
hgm: hvm
ant: ive hxl
hfz: hfo
dhp: djx dpi
agg: ira ilz
lux: gri gvg dib
ixm: hkf
iba: iyv hrh hwt hjx hqr
gvv: dac dyc jri
das: dxx dta
bnp: cqx cun ala anr hmt
hqq: yia lxm gay dal dpv
btd: cib csj cmp agv idd hhy hwj
lnf: gyk gnh
cio: cgo
akt: iba ius
ges: daq dhc
lua: wky wse wnu wzb wua
ypl: lyx lvl gzt wqh
rsm: cwj ihw ito hli
yxq: lob log gfx wlj wvl
bin: bwp cox akn apv iqk
rrb: cbf ijl hyz hgv hsg
gni: gta wlq drt ddf
ltd: gad ggp gqa wko dmo jkd
waf: whf dxy dzz
ggw: whh did dvp
lfi: gry wsj wth woc dtk duy
bfp: ccz cnf ayr alh agv imk iue
azm: imn
kzf: ktn ixe ifz hnz
ljj: wwh wel dhp dtk
icw: icx iha ihg
ckn: icr ilc ifc hsx
bjr: bpf ilh igm hkz
kiw: khv cvs akl ais hkj hit
dlb: dsa
rjy: rqm bku bak ciz apr iwf
ywd: ymm yzz lus gob gop wyb wjb wjd dwt
kdx: rcj rhu cjj abo hrk
bzp: air ags imn
gya: wix wju wol dgg dqr
kqm: rcr rpr bdc cor
bpa: bui chj hbx hyl
agq: aey hkn
hwi: hpw hqg
kuc: rxi bbd bpq cef avb hrk
rab: rtf bwc bqd ail
drd: dzn
kkm: cak irn inh hyz hpr hmr
dme: dto
iya: hdy
dzl: jbs
ytc: lfk gjl gxi ddv jro
daq: del
rxy: rzy bcc bda aoh hkg hzv
lgd: gbi gzt wty dej
krc: rbu bpm apx isq
bsd: cxp ilg isr
akj: hwk
kjx: rnu bzz cxv aek ino
goa: wlq dlz
kbs: kam kjn rms bkn abs aoy
ybl: ydc lkl ghx gfc wcr dlf dja
amm: igd iqv
lsw: geg wam wwf wmt dip
bwj: bun axm
lzq: lzo lta lou gvl wbh del
ldb: leb gek gov wlq
aet: hdg hjl
gxz: gqs djw jkb
bsg: bmf bzz chd adt ajd apm hqb
dhr: djm
yfr: dki ddj jrm
apc: aqx atn hso
ipj: hrh hnw
ifs: hgc hvo
dao: dxq
lzo: gul wyx wva das dvk dxt
gue: wiw wiv wua duj
kqh: roj bcf cfg ctv ani ilk hnq
cjn: iso hvi hpp
rso: rqh cmi iou hry
ync: ghf gdy wxi djt dqo
rmz: bnx cvr aka
lhq: gad wrw wqa dnu
ruk: bkw iuq
cdc: csa cti ixg
rwy: bpe iwz hat hmo
cvj: csf cew
kyw: rdp bwz cva iuf hxs hmz
lia: lpj git gow wan wdd wxi
kge: blf cqj iid hxt hml
hck: hvv
wrn: whr
iro: hkg hrh
cxk: asl iyp iqx hme
duc: dor
aqc: atp isw ifr
kjm: rhw ced cny ios hfv
kxe: rlv bzl atz ikn
wzd: dfq
bzz: buw axd
cib: csi agi iuc
ybo: yer ytq lje lxk lxz dvq
rhe: rej rnk ruh bzt ibj hlj
rnh: rnv bbk bco cya cup aic ayx ixy hew
lbi: lcj gbo gjd wpa dxc dpu
wzi: wzq dam jru
rlk: rev rxh bbl awb hyl
kdh: kqd rhu rsa rng bxl btd asb auo
wav: wmt
wvc: dhs
guj: wcb wml dci div dwp dwo
drr: dqf
ljh: loh gcy gjk ddz
lnt: lul gkd wri wnu
ira: hke hwa hpj hzz
dql: jbp
rdq: rph rom bml cbu auq iss
crg: ccb iky
ltw: wzh drm dgf dvf dvt dmr
rlq: rmm cnf iah hsk hmr
ytk: lrr dga den
ctc: aio hsg
htv: wff wzd dlu dgh djd
keu: rwq bth aht iyq hyj
bkm: bbg cnh hdt
wwj: wtx wot
lqf: gkn gap ghi wmb wnd
kxo: rpp rus clf hhq
rdz: rpg bna clx cod hpb
ibi: ibn ibu hig hmq
hur: ygw glq gjj whs wsw
blu: bte cxp hzt
yqj: gev gzo dhh
lqa: gld wvb dnp dqj
ytp: ytn lic lle wgz wju
alk: atc hro
gcw: giz gwm gpj wlz wdy dpv
wof: dou
gyn: gzz gqc wny dvf
igl: hcg
kgx: bxx buk cmb aok
gpg: gmi dah dag dhh dzf
wtb: dsd
wgs: wws dzf
act: agm hha
amy: ioi hbr
bjn: bts crl ctv ink hvk hvy
ahh: idl ixd
lmy: gcq ghk gxa wgb dxy
dnf: jkz
gwm: wvh wpm dgk dgx
lrj: lpz wix drd
reo: bmf cdt csf ibp
akv: ajw atj itn hwl hmh
lxb: gkf gag geo wiz why djl dui
did: dzy
aqe: iar ivd hsj hfs
wog: dgt
gru: gmu dia dgw
yro: lbi wfq dee dzj
bht: bui aan isy inl
rpf: cqk
hyn: hjw
cik: cvl hrg
ryw: bmz igh hww hfj
riu: bkr bud atw aoq
lta: get gzl wau dbq dzl
dvt: dok
keb: bmy buk cnx cto
hmn: hfw
aeu: azz ifq hdu
lhr: gsl wij wsy dwd dms
wgm: dta
ljz: leu lud
rjm: rss caq cxi
gqk: dbv
yup: yoj llu lda dnx jrw
cas: cim cgh ikt iah hdv hdz
yun: lxq gea dau
kof: rxc rqx cvw akq iya idy hiu hgw
hjm: hzw
gwa: gdo gfj whn wub
awc: iza hzl
gku: gcx wkh whv
alt: iad hbt hyj hfr
aij: iyl iju iva
lxy: gby gnl wvn
whr: dly dnd
lsx: grw ggb gvu gsc wpp
llj: gtx wyo wzk
lzf: lqg ggd wrr wgo wxn dzw
rdb: bob ikh iec hzh
dvh: dso dti
glt: wcr wea jrz
dpp: jkx jbg
dsi: dtn
arq: auk ibz hwu hvg
ybk: ydf ysh yul wyo dri ddx
kmi: bzp buz box czi ill ijv iun hkr
geg: gti whw dhm
dro: djg
amh: aoz iwu iqo hpi
kew: boq cfi imw
kkq: ckq cgc aid hps hzd
gvi: gpr gns wuq dbj dbo
wtz: djm
lck: lcn gys ged wmh
glf: wgh dkl dys
gjy: whg wuq
rvw: bou cnu
acr: azo imz his hjr
wvr: dyc
guc: wbb wlu wuu dyd dxh
yri: yok lzz dyt dps
dpo: jbq
lpb: gir wdo dkm
cxg: ahs alx ijd isa
kzh: kob rcc cwa icb
rua: cki aiv itv hbr
wwa: wei wfm jbd
rsh: rfn cyr ajp imi hgr hqw
lcs: laj gkg wjk diz dfw
dad: due
kki: rde bhr byy abw abv aif hnf
lkj: lkm lwe dcx don
wxe: dnf
kxl: byo bdg avj apu imo izv
cij: cqo hxv
bod: atz irn
cum: ahn
lxr: wkb dqk
rhk: cjq aop ixs
awi: awq
lsz: gho wkl wfc
rri: rjw bmg bti cbl cxf cne czr iah igf isy hll hgx hvj
ydq: yvm yfw lsi gzt dca
adl: apj
rto: cqt ahd imr hcu hst hpx hfh
gws: doc jra
axv: iys
bzi: cku cle auc ioq
kvv: kzn rpn bvg cdv
hhw: hdy
lnr: gyh gva wku wzw dow
awn: hkn hrn
dfc: dqn
gka: gzv wdp wes dwr jcr
rwn: ruf bvf axu aqc ikm hge
cal: cps aqk iya iuw
lku: liq lej ltk gay glm wdo dbb dho
rwg: rml rqu bst bqm chs csd cnd
rbc: rid bpb com iqj hcm
bnq: cph aim afh
yvt: yoi lxy wbs wly wda wsg dbj jrj
kpe: bwf bvf ijs ivb iea hkn hva
bke: cbu ciy auk img iti
ckm: iyr hrr hdw
aoc: ihl
bus: cpv asr
kns: rgy rtg auj aol hrv hgk hpc
abr: aoz
rvx: rev ixl ini
gzi: wiy wqh dbe dxu dpr dff
coz: hgi hfa hqr
git: gwx gxe wan did dza
djr: jkm
rxv: rpo bsb auq aoz
bbq: cdo ado asv imb ifr hfx
ruj: bvo bov air asf
yqu: lhw whq wlu dzg
lgt: ght gxc dqk
wpz: jrf
yyz: ggi dpe dnj
kjl: kus rks rcr cig cyq cvd csw hzj
cdt: iqa
bya: cra cyq aud iah hva
gxe: dbv dui
agy: awh hdw hee
lwr: lov gsx gsq wdu dqk jrl
rje: adi ian iqb
lll: lwo lvf gqf wjc wnq
wet: dqh
ilr: iui
luo: gky wdi
wys: wll wgq
krj: kar ksk bdv bft cku awl iey
ljb: gqc wfs dkk dna
ybe: ywn yvf lkg lao wai dga dvj dsj dxh
rbl: rpr rtg bkz czf anl ihb
wzm: wow dyc
bzc: cyv aku awj amc anf ief iqx hmf
kab: rbh bkk bhg bjq bfh cbl cut iab
hwz: hnh
gel: wqo woh dyd
wmv: dmm
cau: aqz ipu hgv
lpo: gwp wsm dld dto
woj: day dpt
lqi: wob
yoy: lsj lfi wpj dea jkz
big: cna aso ihd hht hgb hwj
kmt: rgx chj cym asa
afz: ifw hfk
cdr: aby iku heq
aid: ila hdz
gvr: gvx wle
hek: hna
ipv: hab
yzn: gry dku dpb dop
wfa: dsd doa
ycz: yls ggd gpm dqz
goh: wbg wck wfv djb
ram: cbi hdr hxl hnv
gdy: wae diz
waw: wli dyd djw
daf: dfm
lpn: gar gua woq djx
ylp: ywd yvs lwf loj gtg wvp dqe
adq: ika idw ifo hbz
wvm: dwb djd
aae: aiy aqg isb hcs
ywy: yvp lcb daj dhu dzi
yll: yqz ltq lon gsz wdp
ylo: yti lad lqm wsy dkg dmk dob
yzw: lrz gwl gmb gfm wbk
lyw: gkm gux wio wpr wfb doe dom
ykl: lam lig lpw gcb wgb wgx dhy dfd jbn
ipk: hlb
kme: rzn ccp cwm ilf
ysd: yey lrp wib wsh djx dqt
wid: wya wly djy
lbu: gft wcn wnp wqn dhf dzf
btu: cbi ama iwg ioe
whb: wzb wqe
ccu: atu icg
ctr: iuv hmf hqw
cdg: czc adr iht
lao: wro ddy
ifm: heh
rom: bxf ckx cio ian iju hal
iiv: iuh hjs
hkj: hsi
ihv: hbp hna
wbe: dxy dmf
koy: brd bwq aco iip hdt
dbr: dct
cfs: axd hvs
dyf: dvc
bes: cvs app iaq
lwj: lso ler gvg dpx
kpj: rym buk czl adm hhc
bts: coz afq
yhp: ygj ymi lpc gdm gev dnb dtb
hyo: hse
bev: bpw cij idn iub hpf
gfz: wgx ddk
bgt: clm ixu hef
rnd: bce bva bej cwb cte ann ign inb
cem: ioa hbb hcy
rxh: rtz ain alu ajb icu hcc
czp: ilk ifi hcs hno
khk: clo cme cnp czc hax hey
yio: yln yvt wrd whw wps duj
boa: cig igi
koa: cpm aah azn
imc: hrh hpk hfx
rhu: rqv bre clt aws afj
wps: wfz
dxs: jbx
ygq: gla ggs gvh gsq gzz
ift: hzo
rbq: bns cyg cyq cub aet azr inj
gtx: wly wvr dat
ipf: hvo
gyq: gwr dak dwj
lah: dxo dfz
yyc: lrc lan lwb gep
wlw: dsg dnh
llu: lmc gwu gfc whx who dak din dnu
bgs: clb clv cwd cdi arc amp aus ibu
khl: kgi kzh rzu bdp bqe
bnf: aii hlk
yxp: yqx ljy gew dyl
ysi: ysy yfr yzs yux gew gfi dew
afv: hpq
hdy: hpx hmi
wvx: wei dbv
imn: hvk
apr: iwi hkd hlj
yjg: lsb wbp wih wzi
ayt: ipc
cwk: ajs izz iqn
ysu: yzo gpl wqz dyn
rbt: rna rzl rux iit hrf hsl
axu: ata isr ifu
rwm: bqe cgj cwo aav
yfk: llq ljz gsr dwf
lwg: lna gkt gcu glq gtk
byw: bwq cyp cxj ajd
iqv: hcu hxj hqk
kze: rar bwi acl hhq hjq hev
cmk: isy hev
ggx: gsd gee wei
bgn: bvf bfs cdm hfc
lts: wue wun dby day
rhs: rhq crw asw izp
buu: iad ijc hmm
hyr: hjo
rqn: crg csg iek hqb hqi
dkq: jkm
asy: apu ana hhf hjk hpm
rmx: bob box aya isg iup
ysj: yxe lin lov wcb wxk dwp dqt
ymn: lov gkg gak gvb wdg due
woa: dua
lti: gaq ggx gmg wyv dra
lxx: lqd lul gwi wpg
wre: dwz djr jbd
rhd: rgh crk csz hrj
lro: lfd gbs gyz gte dat
wai: wgm wex
kuw: rhb bbg bbw awy iyp ide
gwt: wsl dah
bzy: cko iex itc
lns: wkt wyb wpi
yuz: lmb gpa wfq wzg jky
wtx: dxt
kdo: rez ruu bwi bdt cfu czh ice inr
deh: dnn
gbj: gjz gmp dyx dxn
bws: bew ays iel
wen: dgl
cdh: ilv
lei: lfb wla
bdk: csl arz ilb hfd hzq
lsp: wac dyi
aic: iap ime hfu
rmf: bbz bli cqw cte hfg
gup: wzh dhx
kss: rxf rnn bcc aid afi its hhk
hrt: hdu
kvo: rbf rae rjs bta any ibm ixg
ajg: iwv hve
cxi: abr acz asn auj ivu hdc
kbv: kae kqs ryu bvv
htf: yrj yal ypt lqb loa woy dhx
bym: bml cwa afw iuo
ruf: cmd aba izz iqh hzw
kcv: kqw kqe bmc any hhm
dkj: ddk
bam: ciw ale anu iwi
aym: ikw itz
yec: lkx gpx wrt wtk
kqd: rol awq
but: cnw iyu hnp
lkp: ljg lpi gpi dmh
gdv: wpk
chi: abk awi ith hwq
lth: gpx gud wsq
kcq: klv kmz ads afv hpx
gun: wxd wqr woi dqh
biq: boy cyv azx ily hkw
abj: awf ifw
iye: iuw hzq
htc: yyb yyq lva gsm ges dms dmq
rpt: byp bdv aph har
akz: arb aqz
gik: gyg gmi wiz wxa wpq dpq
cxv: aip
bni: alt iwm hqd
afs: ifp
rjt: rpd rne roa bio hzx
rly: bng bty idh
rkm: rji boa crb aqd hwy
arx: ads had hje hsk
yey: lpd gcd wov
rcy: riy crc ccw
azs: irl hgb
lft: gsk wia wse dar
htx: hod lvd lfk glk wur dyu
gxv: gol drb dch
wem: wfy
dmv: dqk
who: wne
cjf: coe aav ajh hja
kpr: cnm cfl czv ard aaa ika iwh
lyf: gwk gxd
azc: iin ink hal
axg: afu ilx hrt hci hln
bhp: bnx and iuk
rpy: bln cax aqk auj hkl
inv: hbl hpk
krp: cjs ctl cun inw hcx
kwb: rky ryf rza cip cvx
wgi: dgi
lub: gvp wkg dba dvb dst dey
gij: wsd dvz
kdq: rkn rgq rse irr
bqv: ipn hsh
let: ghv wro wpt wup wow doe
gxm: wja web wxn dcy
lgn: gxg wha wjb dkw
agl: api iwv
wte: dzo
wuz: djn dts jri
crw: aky aju hkt
lci: lyo ljm gab ghg wtx dkw deh
lxf: gwl gvm gfa wfm wft deb
bhx: bui cbz cxc aua hsn
wwo: wpa
hpn: hnw hzr
ktn: brq bht csd cok irz isl
khq: knz brm ccz avh
rbk: rue cwe axg aow imx hmy
ccr: aan hcx
leu: wrh wwz wtg dxc jkj
cmy: czj avu axs
rdt: bla ahj aeq amf iwz hda
caf: avl iqm hhz hdi
lju: lvu lfs gfd wfc dpw
wmp: dvz
bfh: ccg asl
dxf: dfw
iit: ifd hmq hfn
bak: bja bnw asn hco
iyt: ilu ijp ium hid
lii: lhe gpp gmz whr
giy: gqd whb wwg dju
crj: ccq cgz czq ako
yrg: yrd ysm lqa gne wrn wbe wwg wvu
azh: ixl ioq
kyn: kfe rjo rsg brj buy ckx hhc
lbp: lhp lwq lem wzo jrd
rbe: bvf bxm cbk amp
rec: ruk ruv akr aat iwv iut
wmf: dvi duy doz
ada: hid
dda: dnf dtn jkg
bqx: cuu aly aee ibt iic isc
yqp: gek gmd wdx dbm dyj dex
hyg: hym hsg
lfx: ghs gjz gms wbq wnk dsa
dcl: dgu
cbo: ism hsg hxj
iwj: izq
bcs: aff iph iod
bnn: cvq ivg iuu
yjc: lgi gwz gop wdc wui dka dsz dez jkl
dqn: jbl
iix: iuf
rlc: bqa cyt aqn iru ina
cxm: ari iuz
crd: caj cvf hkr hkc
lhf: gts dcq dxj
wyl: wdg dox dom jrk
cjk: cev aha isw
wnd: dne
ygc: yxy lng ggl gtf waz wst wtp
cwh: are inx hkk hah
ine: hro hdv heq
ymp: ymf ynz yub lij lxn wpc drw dco
ivk: ioo
kgl: rmm bkr bec crn cww aqo
abz: alq axr ici
chs: adx iwx
ypu: lyk ldh wbi wcx wvn wsj dbr jbr
byp: iqh hiv hjf hfl
djj: jrd
yhf: ynv lpl gqf wty ddm
hcp: hya hzl
gfp: gom wlg
iee: iqd hlj
irh: isa
brz: bxd akg apg iyg ieb
bkk: bzh ank ime hcs hlu
wll: wqk
kyp: kqo rya rwk rsg cwj cqj iqo hrm hsl
ypx: gdh gvt wqu
hhn: hxw hnm
bhm: bpm cdf czs atj ich ilm hhk
wau: wme wug dcv djn dxs
wfm: woi dhw dvs
htl: ymn gar gif gyj
ioj: hak
rqg: bvr bsz aah aax idh hin
cbv: cad cam cuy awo ixa ipa ioa hel
ccd: aue
lkv: lyo grz gxb wvi dmf
gnw: dsy dfm dqj dqp
dwq: dqd
rhy: bvs ikk iue hed
cii: cyt
kvb: bys ber iwk ivy
kzr: kzt ktg bkg clk cng hdb hfw
lov: gnu wfn wfo
guv: gun dvc dnm
rna: bnm crn cxx asq amz hiy
rcr: rsl bvd cdz cva iua hri hsc
lxt: gux wbr wou dwb jkf
lem: lxr gxf gqi wyv wfg wqr dwk
ren: rpe bnu cxf hzc
lzd: gxm whv dbt dhv djc
rcf: cgi cjb czy ipb
cns: irp ils
kks: khz rcp rjw bfv iam
azg: iby hlw hww
kai: ksp bib cis cmf hzc
rcp: rlt beu csd ijb
hyi: hxk
azo: imk hlq
rdn: rfv roi bzx cjh
cxe: iim izu hna
cws: azu hrs hav hvy
ref: rzs bcl cch amx aqt aof inm hgn
rwq: acj ahg aqf auv igr hpk
rps: rmg bcx blp cmr hep
goo: dwn dmj
kst: bbe clk cvn awd iak ido hyi
arn: amk igu
ctf: aoj hgt hna hnw
gpb: gqv wbk wxb wff
ait: ieq hfp
ybw: yag lqj wzh wop dwz jrn
dnl: dtt
bag: cwj hjg
ksg: keh cak idu hvq
rsy: bym cdr aia aub hep
kig: kzc bip czl ajl asb iwh
iqy: hhi hwo hmx
hgt: hwy
blp: bos abp ihs ioo
gfm: gty dpj
wef: dey
rcc: bkt bum cvl aeq anx aod iiq ige idv iqs iux hdl
cgw: ahw irz ijg
cyr: aqx
wvl: wts dlv
ihs: hcp
cjr: agl asd iyw hsn
gus: dvq dov
hta: ldc ggw gzr wni dgw dvz
abo: ilv
rmw: csg ctc acw awe ajn ano hba
iwm: hwm hso hnh hfs
ggv: wlf wpt diq
bdi: ckw cfu aos iem ixg ind itw hwe hpq
kfe: afz ibe hrh hno
krf: riv rvd bzu cto axi
lqx: gnf wkd wwx dbg
cqs: abm ahl irs hws hzf
wti: dkn
dsx: dtn
dnv: dzh
wjl: ddw dze
rrf: ayh iyp ily ivn
idr: iqx hca
lea: gyi wio wdf wtg jbj
kij: knp bch bhb bvf cmq avr
yqm: lkl laf lsl drn drq dls
rbm: cvd coy ann azu
yra: ygl lhm wgn dbe dgu
yna: gam wjw weu wfp
yjo: yno lio lpt gst geh
irn: iik ifo
buj: cdk avc ipj hmv
lib: lel wyj wvl dwe dsb
gic: gpg dmb
yxw: yua grb gea wzn ddw duc jbc
bit: bpl bfw crx cqp apk
cue: aen iih hxf
yaz: lnx gbz dct dly dtu
hqz: hux gcb glx gmw wwe
wtp: dwn dsg
yrh: lud gwz gpi jkv jbf
cpo: abq atf hmd hfw
ycf: yln lcx gdx wmr dvq jbs
ykp: lki gyn gsq gpk gzp
lfo: gnm guw wck dog
agt: hca hgb hmr
lun: wvd wpc wuz dks dbu dum
bfk: bfa ckm aau
lly: ldv gzv wye
bbh: bbu cfx awb
imf: ifv iqc ita hfl
kkz: rkd bzp ila iwa hza
ilg: ipe hgx
lra: lcd lpc gwf gfp wmv
wzv: woo dwu dpq dzs
rne: rzb csp ill
huo: ylf ypp ytw lhz glq gwl dul
wqr: jkq
cji: cnp ajk iwx hlp hgm
glk: gnr wiq dmp
gwp: gfi
dod: jbw
gxj: gur dze dtn
wka: wtz dft
rrs: rao rfl bgx bpf cec avq hlz
wus: dvr dzi
cmn: avc ipz hcq hjy hpx
rph: ivl hxa
yhi: lba gbl www dyu
ymc: gjm wvn dwv
gsc: wwz
gqh: gug wmo wop
all: afg hme hzt
agh: ipc izi hdj hsz
kde: cfl cqb agt ikb ikf hcv
cmb: imz hbv
rtw: bzv cfg cub ile hiv hyv
wlj: wpa
kwh: rbj rca buc crp cgq aqj hpw
rll: bal bzc ipo
gbd: gxt wcx dyp dpc
ier: hku
whc: wys wok
hhm: hnm
bgd: bja imb iow
rug: rox bip bus anv hcy hap
wec: dbx dww dwj djk dvs
ccv: cjq ajb ies
wgj: wse
rpn: bie cwq cjz ajd ipt
jrs: jbn
gcu: gsf wyv wxt
gef: gnc gzt wbz wpf ddp dvt
blr: bzt cqk adg
gvs: gpn gmz
cvu: ars adf asx ira iig inm
grl: dhp dzz
kou: rhn byz bfo ces cxs cug amm har
iku: hvh
ykq: yko yfy lag lgq lwq lne wqq dze
kza: rvj rnk asr axe ibw ixd hex
dln: dpq
ykg: yce lwz gtd wwn wpf wfp wuh dcg dwu jbw
rdl: ayg asm ibe ijk
wuy: dbi dpb
rxz: bfo iws ifl hgm
kjc: kpo bys bmd cyy alx iff
wwn: wdz dby dvk dey
wkh: woz
rby: rvp blk bxi afz ioe hrz
dlc: dvs dfe
dqp: jbo
clb: irv
raq: rqr boi abd imu
cfe: iyr ilq imp
rvb: rna bec bee cvh cfp
rvq: rev rzf rog cad cta hyu
yvq: ysq yez gew wyv dps due
lok: wga dcq
bnv: cge csc hzf
bmk: ckj cxe ata iza hkm hfw
cbf: cjw azd inu hye
dmz: dqa
civ: inc
iiq: ihk hcj hvb hea
acn: aag ipb iul hko hsk
lje: gft dix dfc
cyt: ihg ihp ili han hdk
ays: ixm hvh
gvk: gfr god
ddl: dut
wbc: jrs
rym: crr cdi hnn hza
aed: axl ibd
ced: arr ayu iue
lpr: gya gwv wea woi dak
ikw: hje
aac: ikg iad ihh ijn iut
cim: cfr ahm hjp
kzg: bsa crq idg hrf
cwd: csv ahi
lbq: gez whz dhl dhq dyl
dgx: jkg
ysr: ymd lcr lln lxl gxq gmo waw wit wjw weo
kfi: rvl bpd cny hni
iek: iel
gmu: den
wab: jbv
isz: hhi hya hli
gsf: gxo dph dnw
ghq: ggf wcs wuq
wom: daw dgj
lmk: dqb jkv
ima: izw hfb
whe: wxg wni diu dyw dwa dzq
lhb: lmi gyh dgq
hhc: hjx
bog: cua agf ijm
roa: ahc ivm isi
arv: aol izl
lon: wdr wsf dhd djo dvc
rys: aak ash ame haf hgr hpw
agc: avi aeo img
bir: cwh cxv cuq hji
krg: kct rxj bpa hkb hip
lif: lop ggi gju gny wav wnu
lga: lnw lfn gjk gmc
lko: lcf gys gzx gzu gqx dpn jro
gst: gps gpx wek jkc
ynn: loh gst gmi wcp wnj
gkp: dnr dns dth
ivx: iut
kdf: kdu kzc bsi bsp ilb hby
log: goj wpy deo
kmq: bsv bma ico iua
bgl: bez iup hbn hia hvf
gbp: wua dic jrb jbw
bxy: cly azx aut
bwk: ckq cpk agd hbu hvk het
lms: gdk gxq wyt dit
gou: dhm dno dfe
rht: aet ihk imo izd
cmt: cqf ayz aju atb ibz hdj
rcu: rif reo cvz hky
rjs: boe cbc abn azi imm hvn
lyk: gez geo dii dew dmu jrl jbr
hko: hby hhv hyn
lhi: lfw lff ggy gdc
yoh: ldq wba wtr wov dbm
awr: ihr hwb
wzh: djk
ihb: iuq hnw hfs
lhp: ljy gkq gfr wku wcb diu
rmy: cyf cnm ibs iez iur
rdu: rsp hhw hgy
ank: iwf ixy ifz
ypi: yuj llo ljy gru gte jck
gls: gff dhx
rkg: rwi rnz bgm bxi ala hmb hmj hzn
wxp: wnm dcv dgg
yay: yob lhr lfo gfr wap dmp
ghy: whs wtu dqs jkd
kom: rpq rfa rqs bho bsn cep cxo amk ibw heb
lfq: gwz gsf
grg: geh gzh wev dji dqq
cne: afn hid
btz: cbv ctg iyz iej inz hhu
ari: ars iso
rwk: bzr avl hfo
kzs: bjw aaj iew hzu
avo: apz ivf hjj
gvn: gsx gqx wxs wfy dli
cnr: ana icu iao hbo
hyy: heo
ktr: rdv btt iar hev
lpt: dif
gma: gfb wgc wfj dtm
guf: wyw ddv
bpi: cdl afu hra hrs hem
aon: ibe ixt hxz
gqr: wzo dis
cqp: cun hkr
kya: kjm kfh bvp axg ift hgh
rlo: rvt bch bzj asl
akn: aio aum
glo: gvz gek gtx wsu dsy dmq
cay: cxz aua iwo
cka: cvu amv
gar: wbb whi wup dwy
htw: lgp lqm duz
lce: llz lfh grz gax wtw wog
dlo: dtp
bcf: czm asl isg hyj
bha: boi cxc abr ate ibo hrd
gvd: goi
bjp: ckp awl ioa
bbr: bws cdl akx ibe hst
wvi: wfq dxu
yeq: lro ljp lnl dkt dmh
bfz: aur iwg isa
yht: lqm gbk wxx dex
hiq: heb
ybt: lrr ljo lsa lft
gnu: wxo
wsp: wtn wob dio
rhv: bon afm iky iiz
kcg: bul cwa agx ibe ini hsp
cqh: akx ieo izo hdi
wmn: dyc dlu
yps: lhy loa grm gab ght daq dzc
agw: aeh aqm ibr iwq inr
kaw: clb cwp aeo iat ihe
lvo: wed wfk wua dcn dik
agd: aqx aok hva
gwu: wnm
wji: dgs
gvm: gea wmh
ylh: ymq lqw lon gdu dut
cwo: coj isi hnj
krh: rgb rzk cck hik
buz: cnz
bwz: cpo ann iaw isq ipz
hlf: heo
ccs: cea iqi itw
dkr: dgl jkz
ric: ryd bnp cvh aey ing hvv
cpb: ipb itg
ird: hha
wmo: wos
ksv: kmt rkp rds bob hft
ahs: ioz hvi
cdm: agy ixj hac hpl
yww: lrk gdg wkt dpz
kte: rzw bqm ame hsk hzp
wao: dss dnv dty
dwb: dxm
gss: guf dzj
cjw: auj ikx hbg hmh
yvu: yti gve wxh wxq
cyx: cxa ayu agw hbx hpf
izk: hdx
kty: rrc ryl rjm cel cuz hji hna
gmb: gzm gtf goy
dhu: dlh dxf jkt
avz: inu iqm
ymi: ggx gjb gqs wyr wyt dcm
bok: cia azs hwr hdz
bno: chg ass ien imo
lcn: lyu ltg gih glz dgi
geh: goc dcl
bzs: cej cmw izq
ysa: yqv lzd gvs wms dxd
waq: wvo wez jbu
lej: gqd guh wgi wvu
rxg: arx ijl
cnv: cor ant inu
ldj: wkd dkg
crr: aug
wcl: wmv wne dza
bof: cne ajw iin iyu
bxk: cyb cxx ihn
aaq: iav hjs
yds: yxw ynd lyz wsn dze
bwf: bux cex akb aie apb
chu: abl aav atg ibu ihk iqa hkg hbl
aav: adb avo aqp hzh
hos: ylu yxy wkq wqn woj dza
grx: gfq gtw wqo diu dnv
wek: dec dpu
wzj: dxt
dcn: dpm dow
kxi: koo bsj chr aag aph ixe
kar: rlp bmv czg ikp icn
kng: ryl ccv cpm apr afb isz iqc iqm hfq
css: iwn ijo hdo
yyh: yuw gkz ghj gsz wku
rts: bln bjq ace azg iyu hwm
ahr: azv hve
ckf: cne coa anl hfx
bbp: aef ihk ilz iqv
cwr: cvx izt
yor: gtl wra wgc wep
yed: lkj lbm dyr
ybz: yxr lku loa gpj dng
cku: iyl hdj
aew: idl iet iff
gwk: wxa jru
lrx: ltp ggn gmr gmz wqs drp dsk dzk jrk
dkx: dam dvj
dpy: jbp
gtu: wvh dbu daf dwy dfh dtv
kph: rvp rqy bfs csh
dwv: dpq dqs
cte: alu idl ivh iqp
kma: koa bss
ihe: ioi
ylv: ynm lsz wrp wbf
aiw: aot iyd igc hae hjy
lrl: gtm wru wzt duy doy
cjl: cvl afs
cjg: ajn igd ixa
kth: bov cmx apc apt hqg
ydt: ysr gba gtq jri
ljk: lps gnq dwc dxo
ykz: ysd lam lyd luu ggt wir wll wls
rxt: coz ilf hsd
ruq: iks ind hki
ahz: ato
hkb: hsh
wnw: dmt
knz: rnf cuj itn
bwh: chq cqz ijg
wqg: wqx jrn
lbx: lca lur wav wib wlm wuv def
kdk: rcb box abm iwb
lrs: lvv gdd dll der
agn: ivs izs hrc hme
bjx: bfh cgu cpk cfq
lbo: loc gkc wcf djf
ahg: hgh hmw
drg: dez dqk
czj: cqq ctw awz hvi
aqx: irx igx
bhe: cjy cmd aoq hyq hqx
kkv: bbv boz cag ahw amg ihn hgx
ctj: aoi itn
hwp: hnn
kzy: rwo rmc bhl cel aem imo hrm hsx
biz: blf ilh hws
ihh: hny
loh: grx gwb gvt
hyx: hwx
gad: dro dxj
aps: igy ifd
gwz: gmj wgu dnu
bpc: hei hzp
gey: dci
bvj: bps cxc afk ifg hyr hgi
gne: diy
hov: yhc yzj ggn wgt dym
ile: igb ivn izj hst hza
lvj: gcd wvj wen
lyn: lno ghr wkw jbx
inw: hpa hff
cyb: aar azz hkf hcz hsx
adb: ikl ijp
ciw: ixa iqf iuy hkj hyu
ldp: dgw dzg
rjo: rtg bkn ajh
ctm: ihb izm hvh
lsb: lmq gra wex
gdz: wls wga wpn wnt dvr dzq dot
yuy: lbb lga gtw wvm
gtm: dbu
yin: yhv ypg lwt gzx wvj
lky: gdf dmt dtu
kfd: rcz bbl bmk cod amq idj ixk iph
lfu: lou gqp wik
has: hxv
giq: wvt dtp
ipx: hil
abc: aat itx
iqg: hab
wjz: wzs dts
hpe: hqj
lmc: lqi luz gww gth
cdf: ahv aln hly
dgp: dpg
ibt: iah hjb
ape: ivz hvh hvt hew
cnl: ctc aaw aqs igq hwn
cti: atp isq hbf
dop: jrt
wia: wlg wug
lop: wat whe wqg
ksi: bps cgz csw iyk
agf: att hrl
kmb: knd bby crn ctn aiq aom ivd hnu
agp: ina
azi: ili
bnd: ieq
ifr: hmm
kzx: kqz rzm cxl cqv aaa izm hyg
iah: ins hfx
gfl: gup dal dto doz
bmt: cth ctz azp ibr
kfb: rkx ria bwp bnu cjp coi
cjo: cxu aal imf hyh
bms: cyc cwi cpi ctp coa ako hnx
cyq: cdn
rqo: bjf bfp axs irg
lug: wkz dyc
yau: dan dic dnm duh dol
ran: bto ces cez agq hjf
cxq: anx hna
rch: rgv rqs bcm akb irl ina
wwm: dyq jky
hhd: hny hzk
aey: ipx iux
wig: dbf jbk
cew: ivl
gfq: wjw dcx
bab: bay btj cpu apr iql hio
crt: aqa
alo: hzb
kjq: baj bgo btu clj cwr
kam: kyl rpf rmn cwi ald apo iij izk
kne: rlj brx cpd hxh hpa
ycd: lde lmc gvc wld dzd duc dum
ipp: hrn hls hns
rrr: bgz ccw hgj hnr
kvg: bgf cpt aky anj hcs hwp hzi hzp
lmo: gcy gmb gtd wvy dgp dny
hrf: hwl
asp: ats idy hnr
avx: hlz
agk: ivq hyo
gwo: wbm wlf dnn
kvu: kmo rlo bnt cac aaz ahn awq ihw ile hyk
lus: gii dtz duk
how: lbb llc lli lvz lsf wum dti
csk: als irt ivo ipw hiq hvt
iiz: ief
yxr: yfq lkh ldk dhj dpd jks
byg: bnj caq czw iau
lqe: loa gpz wpz dho dfj
yho: lpx gvt gzj wkd wza jra
kiq: kgr kfb bmu cmp ikc iwi hlt
daz: dxh dfi
bkz: adr atb idq hmh
dlm: dwh
bsn: czk idt ifb hyr hms
rfo: bgg ctx axd ifr
ict: hgd hph
wbg: wez wux deo dpc
dtg: jka
ivu: hhz
ywo: lhj lgo lzr gcr gyd dyz dxt
bbv: ckc ivf
iec: hbc
lpv: lmo wxp
ahy: aef
dpi: dmm
dsw: dnf dzz jry
aqw: hlu hwy
hbd: hwf
wcj: jbx
yvi: ypg lto gtc wbs wze
ivt: ipe imu
yoa: gxv gzi wkz wrh jbl
gso: gma wzn wur dpp jrq
dsg: dst
bqt: crp adc aeu ihd hky hlv
col: aba asu amm ict igf hzd
bcq: byb bdh cjj cxv iwb ifx
lex: gcv gsc goc wne dzt
gds: gee gfj wyg wyq ddj
ahx: age ics iuy
bjv: bmv cac cun hcu hda
kdd: bdd ayz ipr iqa hch
ivp: hjx hqv
dlp: jrk jrs
kyq: kdr kew clj cvw hez hxf hqv
wlk: wmj dqc dtq
wsj: dig dvi
bwc: bei cnc cnu czk alm afr
hht: hvo hzp
bhj: blz bqt clr acf irj
cip: cup acs
ctk: hgi
kcn: kjj cjm hfr
ggm: gse gel gmh jrs
dbz: dnr dql
adj: axj ijs
ajy: iwn
aia: iga hby hhb
wgo: wdx
ykb: yik ydx ynl yzv lcf wyg daw djj dnz
gra: wbj dct dan dvo
lto: gbo gvf dhl jkp
ywr: yni gjr wos dsz dqk
ljx: lek gpw wee dru dgw ddz
gug: waj dao dnc
rxr: bde cso cpp awl ixd
atq: igz ijl imj iod
lak: lvc gek wds wpm wnd
lho: gvt wzl
reh: bvq cpg ayl axo auh ihc ipj hel
azz: hka
yag: yzn lok gpq wli
gtz: wcu dbs
cpi: ijb izj hbm hwb
kis: ceu aar ikd idi hie hqy
lrt: lbi loz glg ggs gzn
ksh: abq itr hjk hfr
gpy: gfn gqx wme dhb
dku: dws jrt
wyf: wlw dlm jkx
wqp: wuo dnl
coy: azg imv iuq hrt hzt
cyn: cvw afn ipx
akb: ihm ipl hnx
kzb: bje bzy cus akc iug
iqa: hwf
ckp: anu iiv
lny: wke wwr
rvp: bxc ary agr aou ibr hdz hzx
wdq: dre dis dze duo
lhv: lyu wrj dlf
gbz: gvf gta wyx wwx
kxm: rtt aue ikk
amr: irc iab iho ije ifi itl
bge: bti izh hie hqa
lup: gof wqx dvl dps
rlj: byb agj imb iop
izs: hfv
bmd: bom cxr cxn col aih hhe
krn: rly rmi bwr ilu ign ixh
acx: iig ixm
yqx: yte lse gcp gdi gut wqf dyj dlx
wke: wfs jbs
rsg: cch clg cxm ajd auh ivu hlc
wvs: drb dgk jrr
hot: yba ysg yed lpx gdm gji
aye: iwz ifg hkh hkw
rzt: bla cas ajq hxg
ikb: ijn hnt
ygz: ywa ypl wgw dbm dip
ctx: adc
kue: bjn bxq aev hyk hyw
kjb: bym cxf isc hrz
kfa: bai bgw awo
whq: wmf dae
aub: ivf iqf hkb hpy
kym: kua rmv bhi bwm crh ald iin igo ivd hcx hen
iuh: hgf hss
luh: gww wxe dxt
gpd: gom wck wpo
ccb: cds ilj hvm
woe: dki dpc dzr
dgo: dvi
dzf: dup
adh: izq hpm
bvv: axz iyx ivt hwo
wxx: dba dxv dnq
lyx: ldg gwh gso woi dfe
lji: lme drn dfj
aph: afq iig iey
bim: bgn aja axt iih
bmh: cly cfo
alf: auw iph
ixs: hdt hme
aty: iez
hop: yiu yfj lab gsv gng guh wgm
gmi: gmm wbf dvg dze
yhv: yxk yxc yfa yos dvm
bmv: cqx amt hja
aol: ieo hsn
lwc: lxs lff gas gjk wye wws wqs drz
kkd: kgy bie coh iic iej hbd hmt
yop: ghz gnm wjr wvv wzu daf
htm: yhs yey gtr wsv wqf woj dvs
wto: diu
cmm: hlg hvs
wcf: dsh
lbh: gut wbt wln wgk
gio: dro
gob: whl wgz dak
gqt: diz dpt
wfg: dkf
aky: iel hrt hjv
cph: amv
cjp: aoa
gsd: gmb gne wgq wdo dxd
rxp: rza cyl atr
ycj: yac ymk lfw lfs gzt dpr
ytb: lld gje wei dji dec dqu jbn
alp: iuh hep
ghs: gni gzw wfv dnk
bgi: beb cvj acj ays atc iax
ajr: ish
lcl: die dip dwp
lut: gax wpw wnf dnl
cjx: cmz art ain imv haa
bic: bur abh apa hsu
ygp: yni yun llq gfr gqt wsp
dzv: jrv
yjs: ljl wco wvf dyo dmo
gen: wsg
lbe: gpu wny deh dej
gud: dqn
cmi: auj iet
bcj: bak bse cyx
rvr: byk bph csq ady ikb iws
yon: lky lkq gnc wbr wwn wdt
kbb: kio kwb rki isa
bhs: bez aem hyd
yko: lsd
lul: ggh wtj dxx
rxc: bvs bth ivr het
gjg: gnh gur
avi: irl ijh hmo hfw
lec: wlm wvv wvp wsz web wej
lja: ghf gdw gpz wmp wna dvx dsm dun
dyt: dqv dtt
bpe: crn ase amz hir hya
gnn: dah dda jbz
cqc: iao hbi hfj
ygk: lta gkk gql wxq wnh dwm dzj dqv
yie: yph lzu wjr wjf
yqg: gry gzj gtb wlq wwb jkn
ywu: laa lhn luy gii glv
lor: wro wtb djj dnp
yov: lnj lqt lue wpt wfm
yqy: llh lxt dgv djt
iic: iof hlh hvf
wjx: wvm
hgg: hsi
izb: het
crq: cwy aod
brc: ikq hpt
yom: lrc ltn glt wxa wmf wut dvt dxm
aoa: iir hjn
cvw: ihq
rqb: rtb avs axa icu iht hjz
ryb: cqu apr ily
rgj: rqx cra cdr azy
cnx: izo hnu
rrn: rwc ccx cdl hqc
atx: ifs
aby: atc ica
drp: doi
llo: gij glp geh wmh dqu duv
lma: wno dja des dxi dqx jry
leo: lfz gnb wiw
dlf: jrc
cyp: ctu axu inc hyh
wag: wxk wms dbg dls
aog: hnr
bdv: cpm
cwz: aca iql
baq: cdp cjn ceh ctj hsx
cjt: cfv cqs ias hbu hat
yrv: lkf leo gdg wnc dbs dyx dxp jkt
jbe: jbz
rhz: rvz blh cwn ahd iag ihu ixs
clr: hcn
dbs: dxx
gnd: dgs dtv
lyj: lmh ltp whc
cuo: alw awv afl imb iqe
boc: cdd cxo ctj ahr itu
yde: yug wjb wfc drr
ico: iya
cei: att iws
cvm: irn ict ilw
cah: cpp cpm aib ief ios hcq hjo
cla: awe aox ise haw hhz hxt
kkh: rsj bir bto cdx cvi avu ife
cry: aag ilz hhq
wrw: wir dhk dud
bqo: but ajx apj ivl isp hrz
afw: ato
bcn: bep cut hhi hvk
cqe: aak avo azb hlk
wle: wgu dcn
inn: hbc
ayn: awt ass iqo hbk hdr hmg
lln: lnn gdw gtm dkl
rxm: cen hgy
lpj: wwf wwq dln dgb dom
wzc: djv
rel: bkt bou acf api hwi hwh
dse: dmm
beo: cii clg ify hmm
kaa: kvk ror bht bgf ckg cfl cub abo
ley: leu ghm gmv dzj
iga: hyy hsk
kbk: bca cqc avm asu hbp
cmq: cno inz hdf
kmj: ktk rvb rns
agm: aws
lrz: ldj wnh ddc dzm
ggl: wjj
yud: lxi gln gmh wuj
ace: age aed iqi hzc
rme: ruk blc bnd cka cks crd
rot: bpx bmu ixv hvq
kyv: rfh bri cyf csh inl hiu hso
yku: lbs ldd lvz lek gkd gbb gan ghy dmq
yss: lzj gyp gtu gob wby wmv
llz: geo wqj dvp
hgo: hfb
lbb: leh guq dhw jry
gxl: wjg
ryi: cck cpt cts ara
ltg: gvj dsj
lfg: glo gqw wzy dlb dlf
yas: ysc yqm gtp gok gou wep
cfr: aci hhs
lcz: gzg gqb wws dlw
wkt: dpy
ybm: yqc lht lve gbd gwm
wut: dnm
cqf: cuy icj
bbz: bhp bxb apv izx
acf: azr
lfj: gkr gbg gie gqw guv wnm dhl dlg
yhq: yqs lnj gtz wuh dir
ikt: irw icw hhh hsm hqi
ylj: ywt lfy gqy dba dzc
yrw: yfq lpw goi wqh
cwm: isi hra haw hqc
azf: ipq
yzy: wgx wnt dhv dui
iem: hgn hvq
lip: ljt lxc loe wkm dld
goj: wym
blf: hph
lxz: lpx gxr gxv wya wst dxu dzx
hrq: hip hyk hdv
dzm: dqm jkm
rqy: ajt axa ial hzn
rgd: rmr cku clc aur idy hsh
bxp: cex ctd avr ihc iwl
yrz: lvd luo lok wlc wfo dxd
kfc: reg rfz bcs bfg btw abt alq icy
lgx: gyz gzd gqq wgf dxn
hdj: hnf
kdv: kdm rgt rsd rxw bfr cvc aru icw hhi
wiu: dog
rni: cfo hpf
chr: adp avp aoi aoe hnv
blx: ajf ikw ies hxq
gsx: dww dsk
aff: azn hkw
rjc: cco aix ajk hry
rzz: bul ilh hsn
aox: hed
cff: cqh avy icf hyv
kbr: kaq rjd rmt chr csh axb iaa itz hcs
rfz: iks idg hnb
cpj: ayv iyc hsm
wbw: wyr dqg
rbz: bwa bur ckw agg anq ikp
dab: dph
klh: klj rhu bpf cjv inr
ydw: ggk guz wld dps
bqq: amx ihv ino hmm
klc: kll kgw rje cie abj imp hal
rfr: ask ikf irr igz
icz: iyo hid hfq
bxc: aqb iui
cxa: aop ijz ims iqb hvd
ylc: yxa lpl gtl ddi jkd
djy: dep
kpf: kzc bfw cab
kgf: cne adz ikk ilj
ctd: inb iuz hbi
dgu: ddd
kyi: riv rqi cll hqd
dhm: dyk dtk jbp
yvs: lby lsd wke weo wuf
yuq: lqm ggw gsr gpm wiw wub dbt dau dis
ktl: rrg byg bws bmr afo hac
afb: ixa ifg hli hxw
rjk: bnk cjd aad aqx
yhz: llw lgs lxg lmj gpn gfr gze
ykw: ylt lcz wai dcr
iwf: izz
yne: lda ghm gtp dhg
aga: iho isw hsv
khn: rfa buv cfu hdw
ksl: kfx kfu rin rif cii itd hkp
kkx: klb rhm rhn bek bpj cpe ive
wcw: dgc
yee: llp ged dir ddf
htd: ywj yse lcg wdv
iqw: ion
khy: kll bsq cds amv itq
ynj: gpn wkh wjn dyd dew dzz
bja: bee can
acz: agn ads hwg
rex: bfy imz iqo hkq
klt: kwx bum cxp hfy
ykx: yrf lwi ldh gcw
ykn: yus lpt wat dkp deh
lwv: luu glx gvg gvq gmb wvx dlh dmi
yjz: lmg glp whn wfp dsn
age: ame ion hzt
rpp: cwz ifr
ddz: dmc
dev: jrr
aaf: agd iba igr
lvq: lsp lue gen
kfx: ckh aer iwt
wnr: dya dpr dte
lhw: lwf lxd gmt dip
ayx: hwt
god: dil jrw
cok: aad iva hry
gtf: wct
awj: ihw
bxe: aqm ihm iuw
cny: afc isi hsq
chz: csk axd hiq hpb
bjf: crm ctx ahj irf hck hcc
ldu: lss wnp drp dss
wya: dxt
cbh: ajh ajt ave
rfd: bjy bel col ilw hbt hdh
wwy: woz dcc diu dyj dgp
cye: ctg hrv hpb
dbg: dbf dle
wkz: wim wlf
huf: yxa wrp whf wsu
gsj: gnp gzl wtr dfb dqe jbs
cjb: izv
gav: wvm dfj
lfs: gwy gde wjv dmd
ifo: hkl
kgo: kul rad cfz agx imp hix
amg: azn hhu hgz
kiv: ksp bxv chh aas ibb iwq iqq
car: cav ctg arc axz ati hwh hfq
khs: rlb csl apo aqh iki hlw
kec: kxo kqz bbh alw aoe
aih: ald iev imv
lae: gaw gzs wkn wsz dgm dqv
hho: hes hml
wip: wgr wsu wnq dir jbe
wah: wyw dkw dtl
ybn: lkx gyc wws wuw wuq
biv: bvm bmb bqc axt aqp iwx
lso: lnz wqb drl
lgh: lpw gly gnu dkr
wxq: dlk dwf
kvh: rww rew hho
gsk: wek wpu
wvn: dlv
lkc: lvy gse gof wmj djw
aqn: iqp hfr
lau: gqa gql win wys wfe dzq
ctw: hib
yza: lhc ldf lel lof gpu gol
yfw: gzc wbe dlq
hti: lbt lvk gjo gee gnc wbn dzj
rgk: brn iqz hak hzc
bfv: hdl hjc hnd
arz: asf iop hwk
djn: djz dna
aul: hbt
hbm: hvo hnw
rwt: cya hhm hsv
ixy: hai heg
rgt: rez agj hgm
adm: axn ikk hgv hxr
gxb: whs dii djx dza
khw: rjs bla cir ctj apa aqy
cmp: aiv hbl
lvl: lqt ltj guw jrh
chd: alv hft
wdk: wve dry dan dyw dsm dza
aii: hsg
rpr: ben acx ajk hrx
bom: cxy azu
yyx: ydw lif lss gkg wch dju dfg
loa: dri dau dqr
yqf: gkq gee wld wpu wuv dwa dfv
dhn: dwo dsv dxg dnb
bji: chm aoo ieb
kfu: buq csg hvo
lgp: log wvg dbh dam diu
ctq: ivu ixs hlf
ato: ium iop
cgy: heu
lys: wjk wsu wso
cxh: aeh igq idi hmz
bru: bdg bpt bfm ccb cmb amf
yul: lyn ggd gex wqd dym djq
lxa: grv dil
atu: iaq iwz
rgw: bji ahl hvt hxq
hvc: heb
kmf: rkd bvq ipe her hfx
bkt: bpq
iqs: hly hpv
ycu: lhc lpd lzl luc whz dge dfx
bkl: bre bia cav asv ame azt imh
ivc: hvr
bry: cbw chm cfc aze
hjv: hss
rsi: ara hcm
kwp: rpi brb cit cqd hcj hvh
gfs: dag dly dfp
lya: wac whf wnk dbk dck dql
cux: akv auh aox
kaz: khj rch rnx bjv cmi atg icn idr idc
ypy: yut lyj gkm wii wso dvm dmq
ixi: hyv hqv
kzp: rpb bud cmc ajd iqg
yos: lzo dph
drm: dlp
yfe: lch gti wwf wpc
icl: hnd
bje: aas anz ian
whl: wnm wtg dzg
hcc: hmg
lmd: lfd gkv gye gwc wmk dxa dmu
duu: jrb
huw: yve lge ldr glw
kfw: rhy rtp czr cqx anh
way: wne wft dve
yti: whk dme dqb jkz
lzt: wcx wdf dno
gpi: wal whh dbv
ypn: wkt wgu dmz dzy jbl
yxa: lkr ltp gbs gng wlq dar
ahi: adf idu iel
hgb: hzg
kzc: blx ckb crh aik afg ats hlt
idb: ixg ifu hjo
akc: aod
cnz: arl ajp ied
kfp: ryg bvu bxv caq cuk
drh: dyy
wtk: dcg dfn dqi
wwi: dcc
rke: cdb aby aon iyt hdp hef
lcm: gas gxy dbg dsy dsf jrl
buf: ahz iqg
bkd: bfd btd aku agt
dix: dfq jka jbp
hri: hgk
yam: yvj lmx wjb dxz
aex: ips
hcm: hds
lpm: gfz wcw wfb wzk dax
rao: cdu cpw cne
kvi: rlx rma bkx bfm akl apy
ccl: cvi cpa aws ivv isa ham hfx
cdk: cpx
khf: klx rha rnl byr atb ich idk
rsn: bct bvk bnb cav ayk aez ing hec
kil: kqx bjk clu ctw hne
cse: avk iil
wwl: wfe dbw
rrk: cnl agh awt ihg hah
rpu: avb atu hhd
lmw: gjr dif dpo dnx jkr
icc: hji hjv hfv
kcu: kqs bcm avg hzi
cvt: abx aiv hmk
yzq: lid ldg lpw drb
bqu: btk cgf axm apg ixq ios
kwy: kfd czp cqg aru abs ivn
bcw: bge cro ayy aut hss hmp
hwu: hdo
wjr: wnd wue doo
kno: bbn bmu bzl cik cjw iez
kwc: rax cco ata iiv igf ioo
bar: btt csw axi
rho: rjj bjt bst cya cgi azr azl hdk hnb hfq
kzw: rbs rzc chr hgr hwn
gbv: gyb gdj duk
aql: hry hnt
lsr: lul ghk wnw dkt dbs jbq
rmt: bqw ivr hqj
ayo: iem ifg hvr
aqi: itz hrj
rou: ckn awu ijz ixh
ipn: hqr
kvy: rre aks anm idu hwr
wyi: wvc dbj dhz des
kzl: cda ayh afh ins
abl: iun hmp
rzd: bxj czk irh iyg
gqd: dbr dgp
ghn: wvu wuk wov dpm jre
gnf: wve
ysn: yez yqc gyh wyq
bgg: cai aqm isu
gqx: dvo
lby: lmk lzu wlo wsu dnc dfo dzc doc
gmm: dsp dxb jri
cmu: iax ind
kbh: kfe ktn rdq byu ble hzj
ani: irb ipi
kop: rie cvd azr iwj imh
wqc: dfm
rvc: bpm apz igl izh hmu
kui: acf anw
glx: ggo gtc gur dav jkk
wik: det dou
beu: cqp apf aqq iht hls
hru: hvw
rgb: bol cmo agf afo ies hcu
lwk: ggi gmy gna gun wni ddi
ktk: ruv blj cai arh anw ief
lss: grg gsh dxx
iog: het
hbh: hhu
gkq: wde wxc
kuy: cuz adv ijw hzt
ych: lny wru whj dra dmm
btm: cbj cih ibi ima hxl
gbg: wda dke
yrb: yje ytl lom gdz gjh wrw whx wjx wqx dae
ikx: ipt
bch: bwz bvg atn hpo
lvm: ghn gvp gsn gnl wju wqk
yso: lqb gji wgv dag dhz dva
ibd: hdc
kwm: knq bre bdw cwb czk ajt
wfb: deu
krr: kbu kme rfe cqn aqe imw hmi
lzw: glx gsw wkj jbw
dcp: jkl
brd: cdb amt inx iqr hhr
rwc: bwp bsf bmc aix iri ibj hvp
rhi: rqu cso aiq ajj aqi hrg
gfh: dvw dxt
lgr: gvs gzc goj wnc
rxd: bnb cdv ajm ikg
lqr: ltj gij gpa wle wdc
wuq: dzi
ivr: isp
ihr: iwy ijx
cky: cmv hrh hwe
wad: dhz dfo
gix: wjb wnv drb dll
igf: iss
yvd: yzs liw lxi gro wmc wfn
blv: chj cqb acz ahv ivj
ldq: gvw wps wte djt dey
rtg: ruw bhu
yem: ymg lkk lop dwj
yuf: lez wdy dhl dwk
kyx: klu byp cmx avh axo ias
gqy: wsp web
azw: hlp
brq: bas ccn cay agp hax
gtr: wgn wqe dmw
cfm: aqa aue hvb
rls: ckk adp ino iuq
cdj: ipp hig
byy: byu bvg bez czy
gmo: dci dpk
gwc: gjr wvo dva
rvt: buz ccw aen ibx igb iwr iwq
ljv: gyw wzc
knh: byq bxi cxx apo iml
cai: cfn cqu iib
weg: dyz dwh jki
duw: jko
cmd: iwd ixh itb
dub: jkn
ktq: rtu bko cwy azz
iwi: hqv
iae: hre hno hqe
atd: hhh
arj: aas apq inc hdf
cck: avk hvl
hoh: ylu yjd lan ljf leh grk wmm
awl: hij
wqy: drb dno
kkl: kub acx awy irw iim
gcm: gua gok wjg wfy wqr dqi
rgq: rvd igv ism hhl hlo
iht: hgw hmz
blm: bfi cif arr hal
csv: ani ial iyi
wrl: wli day ddq
rwz: bgl apr iqh hiq hvb
rng: rzv aos aop iei
lat: lfc ggw gji whb dik
atk: aun icv hzv
dgw: dwz dzb dzv
kjk: kzx rdh bca bpv aiy iac ior hbr
cbw: hap hjv
yib: ysv yqi leq wkf
iqu: itw hmg
kiz: rwv rdk rso byh byf cko ahj hru hwj
ibn: ixl inr
cfl: arb
wpf: dho
cvp: awi
ydd: lyb lqt gfx jrz
dhc: dof
gmp: wej
dkb: dlm dpa dfl
rkt: rfj btw cbh ahj hbw
kct: klt kzo rpf rns aav hpu hfw
rzj: ahc als axp imb hne
iri: hff
ymw: lyh ghm gnm wrn
wxr: dmt
gky: gcr ggs wox
rsp: rmc bbo chq acv aek iid
ijt: hhb
bum: chi axe iji
hah: hpi
cef: czn czf awe ihf hxo
rdg: rnh bsm cbt ifv
rwh: crm chp amg ick hee
luw: gbn wkd wqo dte jko
bsh: cql apb idp
apj: icx hii
ldg: lpa gwt gzr
gig: wih dnd
crb: cpx cuv imf hjv
gze: wyg wtw dkc
brm: cfx czt hio hlk
ykm: yro ycg yek lwb lmv lfs lzd gbe gcl gll wxg drm
coe: awh ihf
ipy: hrf
lie: gbw gvx gpy wak wdk wmo diu dyh
wdl: wsw
wmi: daq dsl jkm
lyc: lqd wen wns drn
rae: bal bhf bqg cgu cpl ivk hjh
bek: bmy aay hcx hpt
ynu: lah gkc gka gho gss whd wzf dar
cui: cuv adl asa ioy hch hsc
wcm: dby dsq dqz
yat: yth lfh lzd lze gkx day
kzq: cam cev cta hdk
kry: koo bmb cxb cfm akq iqj hwj
iev: hcd
irl: ivv
hsj: hzn
hve: hxb
wun: dry drz dyi dls
kqb: bar bvw ays agj
cxs: cou ajc iyx
rfe: rqa roj crz acq hrv
aee: hlc hxy hqi
aaj: apr hyd
iby: hli hwa
knc: bhi bft cvi adn aoa ida
iap: hxd
ksn: rtv rtq ceg cfd
ywf: yqm lkc lwv wox
yjy: yzu lkh lic lxs dii dmg dum
bll: cva cms ieb
cpw: aak ajb anf iiu
acs: hdy
rvl: biq cyz ard
rge: rts bsr cwo cqq app iof hea
rqv: bzw cfr hxu
wdz: wnu
dcf: ddv dsn doz
rla: bla ivy
aya: ihc igi
cvh: cqh hla hwg hvq
arf: adb ibw
aok: icm iqc
asr: ihd idw hns
ime: inf hmo
yxo: lhe wav dae
wcn: wdw wpa
dim: jrh
ryu: rxm cbp axn imj
kjw: rfv bbv bub auz hik hnq
gew: guk wdo wus dgw jrs
bxd: bzf cbp cit
ysp: lln gwb wzd wtm dcl dir
wdm: dtm
axz: ivj ixf hhj
ddh: dza jbj
ljp: lzm gxk wkr weo wok dsy
ghz: dfz
wmt: dxk
wxu: wzz
kgk: kja ryq bio bux img
cdv: aqm iaa hmq
lco: wmz deo dmx
wtj: dfh
iwu: hrd hyo
hjp: hsg
gsm: wwq wfs wum
lab: wej dij
gzf: wmc djr
gnx: whr doy
yer: gqb dvi dma dmp
rmk: cyd iby ibq hgi hnt
rio: iii hcv hdy
gda: gsi whf dll
dxl: dqe jks
gvj: wbm
rle: bzx cie asi iov hvw hef
biy: bhp aco aet
kfs: bsq bxy cbn iay ito hxp hnr
drv: djp
bal: hvl
brb: cdt csl ape
ldd: gdd wvq woo dpw dfr
wdf: wsc wup
guu: dkh dcx
hrj: hiu hyz
iai: hci
bdx: cjv cfu iik
ath: irs inw hlq hpi
kmn: kqt blg bvz arw ags iid ihi
btc: cim aby ice hjv
gop: wtn
wyu: wmj wfe dqg
ijx: iqq hjt
ctb: aco ich iep
lsf: glk gsg gpg gmm dfg
rzx: bwa bee hzr
wws: dbd
cey: cfl akg ahn agx awq iyk hyh
gln: wil jkg
dkh: dck jbi
gyf: whs wyb wzt dls ddm jkf
kky: rdu rjs brd chv cfj aef idm iou
ijw: itt hgq hed hxg
wju: dzs
ypv: lcz lsx lmy gsy wzv dme
atf: ifh hsi
lmt: wwo wsi wpl dcz
iad: hco hmi
wrc: dqo dtr duo
gyo: way dnk dog
cbn: ciy clt iqk
brs: cdv ceb aia ava
adn: igp
rum: byc cgd cfu
ysw: yqn yup llw giz gpp jkl
dhf: dex
lwd: lxo gnf wbf wwt dpe dqt jrp
wlt: dua
yez: yum lwy gij wnj dzw
rgp: bvv cmv axx idm ite
csg: awt azu
kbt: kqi bbe bxx ags aue iwh hzg
kbf: kxl kmh kqm ryx rtw car apw ikr
cgn: cxj cns afr iyi hxm
igb: hcn
wca: dyy dzc
lvr: lqz gkb gbc gch dvb
brj: bgi aho ayg auk iap
rue: ads hxn hfl
aln: ipz iqx
dok: jbo
igr: iwp hrd
lht: lsb wbx ddk
kyf: ryr rjs rxl rfh ckd ahy iqf hjy hee
btf: ccl cit igs
gzv: gub wbv
wwk: dsq
gbr: ggq gvf dzb
rdx: btx cpe acn axp ank ivd hdk
gjv: wep dgx dds
lic: lnf wbk wpr wqp wov dup
cvr: ctf
yjm: gvr gpg wgc dcf
ahf: ikm irr hzp
gez: deu jrz
kon: byf bge bdk cim iip ifj
cop: aip her hqe
lsk: gnl wqp dgi dfr jrc
apg: ire iub hjq hsi
adi: ibt iyh
gxh: gfg wnd
lsi: gst
gyz: wee dxd
bjb: cxq ctu hnm
wlv: wgo wta dyq dfs jbm
gul: wmp
axa: azt
bxu: czt cqx
cdq: ard ayr adz
ypb: yuh lho dhg
ryr: bjl cii cen cfq avj avv axb ihx hrc hih
aab: ayq ane ife
bko: bda atp auv iyi hed
rfl: csm ihy hzt
bjl: cuq ahy izw
rwb: rze btb aod hje
auf: iam hlk
lrw: lcw lez wgy wdn dgy
goc: dus jbg
aqr: isv hco hyg
roe: auj ivy
yvp: gyr gyy wvk djq
lwe: wvl dwh dmj
yol: gsn wlo jbr
kmy: rgm rts bvp bml ibx ijf
wrb: www dzx
