ksd: rgm rvr
kbc: ktv riz rva bap blm
cca: cvp cup ayg
bse: beg bxh cwb cpi ain ahg ahx
crl: crw caf cat cyp cem
bjl: cko cid cwm cwf cov coo abk
bpo: bqw cae cig ceq cmg ahn
kqv: rel rzk rti bbp
rxj: rfe biv byg bwl
cud: ahh
rcj: rdd rmr rto rum bai
kmi: ray rap reb
bol: cye cdy cvg cxh ayy
crg: cvq cef akd
rbh: rcf rij rls rgb rgl rjq rps
kxn: ktl ryq rjl rpw rzw ruz
kog: rhv bkl bks
kze: kta bwk
krz: rir rgh rxy rxw rof
rek: rxp bis bwc
kqz: rbr rgf
rgq: rsa rqr rql
czq: arv abx
bnd: bfw buu cwi ceu cob
bnu: bzd bun
kaw: kwc kwe rke rip ryc bhe
kjx: ker knb rju bbi
aia: aiu
cft: arn aro aig aiq
rdt: rso rub ruy roq bix bga
cbc: cgo aci aae
kgk: rri rif rjt rme rzg
rpz: rqs roa brt
bjb: bxb bmv bnk boo cry cbf clj cqt acs
kyq: kxw kur rin rhh rwa
cmm: czp cqr
bst: bmw cgd cpb czv
bzf: buz cwi cwh ceo cqo
bxo: bfh cia cwr cmp cor
rtm: ruc byd
rvf: rfa rqp
crb: caj cvy ceh cmc akj
rfo: rza brh
cpx: ahh
crf: cjg cxt akt
koc: rcl ruu
bqr: cka cnl czj cov ayr
aau: aht
cbe: cvf cna aiw ahd
rlm: rvy bab bap
kcu: kdp kjx rwt rvp rzb
rlk: rge rwk rub
rih: rgu rjh rmt bab bgm
bbr: bah blc
akd: aao
rlw: rum bhn bym bws
krh: kyw kez rcv res rfk bro bay bwg
cbq: cyz cnh ctk aba abf
rrw: bkk
bdi: bvl cyo cev cfx aki abq
rjf: bgl
knt: kuu rrj rph row blb
kmz: rkx rjq rnf
bjo: bmf bzl but cxb
bvk: ckl crd ccf cxm acn
kvr: kev rrw ryj bbv
rgt: rfl rqy bap byp bgx
abt: aio
bkq: bwb
kln: knr ktc kue rrr rhc rmr rnl bku
rxn: rmk rnq rov
rwf: rxi
knp: rus bkb bru
aik: ahy
csi: cfp czg abn ack
rss: bre
bdt: bei cjd coq aad aip
bvp: bsm bep bqj cch ciq cda ctt aci
rel: bbj
ryj: bcv
akl: abf ahi
kip: kvv kef ktb ktc ruc
kjz: kep kxk kub rjm rtj rod
chw: aho
kdt: ked rbp rgx rxr byf
cse: cpe
ccl: cph cno czk czw czp acr
bxi: bfc cca cgh cnx ayb
rwu: rnl rng
bto: cil cyc cye cjt
bqz: ccj aha
rtv: ron bio
rvr: rzd rzz bko
kbd: klj kvg kfq rrn rit rgg brc brh
cnx: aci
rzb: ruj
bfl: boc boj cka chv cvk cpp arc aip
kjg: kmx kub rpn rto
kyi: rer rtw roq
kxp: kmc rbz bia bid bgy bwl
btr: ccf cwn cdo ctc
kvj: kew rid rlr red rny
red: rou blf bgb
ckn: ckz cig chx cdm cxg cfz cqc cub
bop: cbq chn cyj cls ces cmz ars
kkq: kxa kof rqt rtq
cml: cfm czr czz acj
cqf: ctm ahx
bcx: blg
kwu: kja kqd kqj
arf: abb
rcs: rsh rxq
rxv: rnz roc
rfz: rtg
kyd: kjj kej
rev: rxr rpj ruq
clw: csr acr
kqk: ktt rbr
rna: rop bbi ban bgs bgq bwr
cnd: cno cuj
ara: acx
rif: rvz rti
bfj: cjg cet cfy
cdn: cff cuk abl ahn
chm: czv czf acc
kbx: kht kxx kfn rla bcc byn
rat: rlj rwa bkt biw bim
ric: blo
cua: akn acj
kgm: rrx rzg
bfv: bzw chi cdy csk cph cfk cte abs aai
cgg: cjo czj czo cqg cqu are aat ahm
rdn: bkr baa
bmm: bta crs cgh cvj coy aau
ryb: rly rsj rss rps rnc rqh rtv bhl
rrr: rci rah rqz bru bbg
khm: kht kpj kpo knh kfp riw rhf rsb ruc
cnb: cna
bbj: bye
ccf: cde aac aiy
kva: kxr kox rck rdz rmy bbk
kki: kim kfn kqe rbf
bmo: btg cby chr akk abu
cze: cos akc acn
cdx: cto
cco: cdy cfu akw
roe: bbb
ceg: cxa cmi acn ain
rcp: rln rsv rpk bie bgh
rbw: rck rxz
brl: bge bwz
czk: cox abo
bxa: crn cip cjk cjz ake
rfw: bcj bix bhf
bzw: ccp cha cht cek cel acd
rye: rtk rop bbi
rvd: rfn bkf byl
kvu: kxt kmo bha bht
ksf: knt rrz rcf rgu rwx rfp bif bld
biz: bls
cev: aik
cvu: cxw cnt czb czy aiv
kna: kun ryk rwh rjd rsj rze bia bhs
rrs: rlx rsy rum baq bge
klt: kgc kfe rjb rsd ret
koa: rnf
cmj: cuc arl
rpj: bkw bcp bao
kvt: kfr rcg rzn
cfx: aao
rti: byu
ccy: cin cgh csh czx aaa
che: cgy cwu cjf cvk
klp: kdr kjv rru bbr
kkp: kxp rqb rod brj bcp bar
ckv: cdo cjh cvz ayl
bee: bef bpd clg cxi cxz cfa arq aiv
bjg: bjz bxk bph cyg clk cse
bel: bmd bzl chk chw
kqx: ktz rlw rvp bbj
bug: ckh cbx ctd aax ayl
cwc: cfp acz aav
kxz: rrd rao bcg
bzl: bzw cio chp cvl cfg arp acy aya
bxl: bxo btr ckp cnp cze
rnz: rzw
kkc: kbk kjk kjc kft ren rmz rzi
bzj: ckr cbz cjd
cne: akd
rsr: rfc rtw roy bkr
kqy: rjl rnw rtb
rik: rgn rvn rmt rff bci
bnk: bny btt cax cms czn cuo
bre: bgj
ckz: cnr abd ayh
rbt: bky bke
bmy: ccm cqu arb
cbo: clp cgb cxu cmb
cnr: ahf ayl
ceo: cxs cnh czk coa
rfx: rzi rth roc bbz bcd
bic: bwp bdc
kaa: kyd kde keu ruq brg brj
rjo: bru big blv
ryg: rpp brs
cdw: cpc cfv abn
bmn: cke cyi cye akl
kbl: kgm kzn rjl rer blk
rsh: req
cae: cwf ctm
chx: cjv cer cnd cfb cfz aik
kfj: kzm kot rye rse rpj bkm
cwv: cjn cvd cuz aiw
kan: kzy rkp rpp rne rqm bbn
cgp: aku abb aht
bov: clr clb cms ahn
rhb: rgj rzo bbj
bdn: bfb cdr cej cev ayc
kji: kqr kuk rkv rmj rzi rqz bgt
kpf: kmd rjh rfs rqx bao byh
bhb: bhp bln
bmp: cbk chk abm acz
ckx: clv cql akp ahj
bxh: bpi cwi cvt cex cxr cze akg abt
rkj: rry ryn biy
cmg: aag ahk
cqz: abp ahd ayr
abn: ahr
kcb: kau rim rjj rmv rta
bfy: bzz cgw cej cfr aab ayi
brp: bya
bri: bau
kif: kmt rbh rgo bcw
kom: rip rwf rzj rqw bkv bin bhv bhu
bsg: btz ckj cha cfk arr ahz
bey: cgq cwg czk cqj ayh
civ: cqe akw acv ail
cdm: cve
bjs: bvw bmu cyx cvh aam
cpw: cnv
kms: kqh rkn ryw rfn rqe
bsf: beg bft chg czk
akf: abr
rcz: rxj
cgv: cmt akg aij
cgd: cvv csa akk arq aai ahi ayr
cgt: cql cqw cty
kcw: kif klo rli rwe
cvc: coa abu aii
kwv: rif rmr rog bae bip
kou: rip bcu bhk
kks: khr rhx rwb rxi bka
rgl: bky bys
cfu: acn
rdh: rqo bhi byu
kim: klc kqh rpe rqx bhl
rac: raf rlv rey bro byg
chf: cli ayi
bzq: btw cwt cvt cqr cti cox ace
kua: rax rhc rha rly rlu rgb rsb bcq bhv bhf
koi: rrb rrc rav
krx: kgs kwm kny rcb bch bwy
kmk: kni kzm kok rbi rjx bip
rgw: rsj bad bgz
biq: bht
kug: rdx rjm rms rfa rtv
cwz: cjn cmh
acb: acp
rom: bbw
rey: rpy
cqt: ctx
kkj: kaj kyb ksm rgs
ktl: koi rkm rrq byx
kul: koz rcy rvp rev rme rqd rus bha
cqr: ahx
bko: bgf bwv
cfq: cur aiu
cxv: cma cfb cus
kdp: kec ktv koc rsj rno bwy
cfl: coi
rij: rls rjb rff
cdy: akn arv aau
bxb: bux cms cow aba aci
bmt: ckx cbo ccu csx
rdc: rvg rox
rsn: rqt
rke: rrd ryj bcd
cnw: ahg ayg
cjk: cjb csz czt ahm
bpr: bnu bod crk cqw col abl
bqk: btc cwh ctv akx
akn: arh acw
chz: cvx cps cfh ahc ahj
rgd: bkk brv
bcq: bao bhz bwz bwq
bpa: buf ckz crg cru cud cut
rwb: rdo ret rui bih
bjn: cgb cgv cjt czn
bxw: cic cng czh cuq cot abc aab ahl
kcr: khb kva kfa rkh rgn rqf rts bkr
kdc: knw rfk rts rtn biu
cyp: cjz akh
rwd: rdi rdw rsc rfg rok
cfp: cuf arg abh
cha: csx cnx ahu
cav: cvi cfl cqh coy arl
kvs: ksy kmt kuy rir rje rqz
khd: kvt kpl rlb rwh rdu
kng: rwb
czm: cql cuo
kzw: rax rtu bbc
brm: bww
rpx: rzp bbn bgg
kjw: kmt rfs rul bak bhf bli
bob: cgz akf air
cvw: cnz cfi ari aig
kuu: rse rus
abq: ahc
rug: brd bio
cxh: cqj akr
kov: rbm rax rwc roe bwv
khi: ktn rwy brd baa
kmm: kuj rbz riy rzi
rvk: rvy rmv
kby: kat kog brt
cvy: aak aii
kjy: kpu rzk bid byl
chd: ceo cfr cqi
kxj: rjd rmf rny brz bbi bcp
rmv: bgm
brh: bif
boa: chk cji ctp cud
bkv: bio
rky: rgm rwq rnb bca
bor: cce cik cjj cvz ahg
rnk: bwn
blz: bwb
rkv: rrm rev
bza: ceb cud acf
bnx: bfl bzb clf cdx cfc
rfh: rzi bii
cky: ccf cee cxw cxd cmm cfl cux coy
kid: kyq rpr rmt
rql: roi
blg: blm
rls: rps bkz bae bgq bwl
brv: bcu bhe
klw: klz kvb kzn kqe ktf rtk
cxe: cuk cuc
kvk: kft rga rdt ree rem bcd byn
rem: baj
khw: ksb rbt rln rjs bkm bhp
rlv: bgl
cjy: cvu cpb ctp
cvx: cfh
rvo: bke bry
rxx: rpo
bfw: bfp cce cdn czs cur aac
kbi: kqa rei rpc bix bhc bgg
cfa: czc
kfm: kfn rdd roc bhw
cpg: czr
kgq: kvh kfn rzc
aiv: ahe
bvj: bzr boc cdz cmi cui cuf
kir: kia rhu rsh rmx bah
riq: rpr rza rtk
rvj: rxs rmv
acx: aco aaf
chj: cwa cwd
bun: boe ciw cvm acc
cgl: cqn akz
kpm: kfo rip rvs rog bye
krw: kif khu rce rtt
kxr: rap rfb bdc
kdn: rbz bck blb bgk
aky: ako ayk
kll: kdz keu kmn kfs kux rxe ruv
cry: cxa cpl
ksk: rbu rwv rjs
reg: rns bkp bwz
cib: cyz cjf cvn art
cwm: cuz abi ahs
bpg: bpe bqu bun bob cio cht
klg: kja ram rjl rsd rpr rqb bcl blh bgv
bmx: cae cei arq
rgk: rgx rph
krr: ksx knp rzl blv
caj: chw arn
rxk: bay bhh bhg bdk
kzt: kqy rzh bat byb
cfi: cuy aik
kpv: kfc rtj bhd bwu
rts: byp
bzu: cam cgj csw cun
crc: cdf cjq akp
rax: ruj
khs: kyl kzf rvj rxw rme bao biv
cgq: cwl cft abb
rcd: rnh
ktw: rhk rlm rer rxd big bhg bwa
kwe: kpt rww rno ruv bct
kau: rra bhn bla ble
ckm: cry cyf cpe arg
bda: beh crj cbl cjh czw aid
bsu: bmi cds cev cmd
cwx: cjs arw abs acy
cik: chf clm cmy cte
chv: cog
rec: rpq rnv rtg rog
bvv: bsk clm ctt cum coh aib
rqd: bkp
raq: rzh rqt rqo ruh bcg
rri: bil
bmr: bui cfm ahl
cyr: cvo csk abw ahs
bzy: bzj clz cjx coa
kzz: rda rvm rfi rzi rtx bco byz
rnr: rtv
bxx: bnf cbt ccr cdq cuc
ccm: cyx
kjl: rbw rvu rmg rqh byy byp blz
kww: kwq kmc ria roq
kiq: kyj kto rwh rwe rzm bkz biq
clp: cja csv cmc cqa ctw akm
bng: boi cyf aht
kyh: rfp bis
rze: rql bkk
kok: koj ryo
rsm: bin
ran: rjb rvq bwt
bqa: crs caj cid acn
akc: aii ayl
rjq: rtt bdr
kxm: kmq knz rba rlj rdv
kga: kge keh rwb brr baz
bxe: cjw csc cxp
kvg: koq rwu rfs rzf
rnj: rob blo
ckg: cle cdz cmy ctn cuh aaw
kcs: kau khs kdh kxy rbu rmt bkt brh biu
kur: kok brs brz bym
kle: klf roa bav bwl
ckw: cyp ctg cou
cyz: cgk cvv cpn
rvq: rml
bjr: beq ccm cia cgv ari
rvc: rxf rnf rzm bcn
rqv: byz
ruq: bbj bit
ckf: cra ccr cyh cla cpb cqj cuz
buw: buf cpz cnq cqk
kbs: kbz kes rim rpd bwa
cdg: acd
rxa: rfb rzh
rwk: rfs
akh: ayi
cci: cvj cvs cnj ctj aie
bup: ckm cbf ccr civ cwv ahf
caw: cvg cqf akt acp aad
bfx: bqs cbi ccp cai cgd ctg
cvt: cfh coj
kvf: kfi kqc rse rmd ruq bkf
kma: rro rid rek bks brw bln
cqe: cug acv
cex: abd
rgs: rvm rvo ret rnn rom
bau: bhx
rmd: rfy rte
aao: ayk
ctn: acz
kfl: rkf rik bct
rix: bcm
bea: cjh cqy ctb ahn
bzt: cbd clk clj cja
bql: ckx crl ctp
kta: rbo rjx rzu bhb byn
rnu: blk
rhr: rvn rvq biu
csd: aap ayi
kep: ras rgv rda rnv
aac: aav
bfu: bqg cih cvq cqi
khu: kyh kgt kwz ksn knw rcv rap rdd
rfr: rfl
abd: aan aip
byj: blw
rxo: rnp roj brx bwp
bpz: bob cks cis cvl cmm
cuh: abc ain
bfi: cav cdd cfw cts aai
kph: rka rdy rxl rnr
cgi: cuu akh ack aaz
cwn: cjc cjt cvh cqv
kgb: kwm kpi rad rjb ren rqc
rhd: ryi rdf rmy rom
kuc: rhv rgm bbc
kgx: rlh rxd bie bqm
rsv: rzx bcf
ksb: kxt rkm riq
rei: rzq rtn blf bwx bwp
krk: kcj khr kep ryd rvw rul bby
rbp: bks bbv
kcl: khx kex kox rsa bkl bkw
crs: che cls cwp
cxu: aim
kof: rck rpm bby
crp: cly cfa cza czo abv
kdm: keq rdr rdh rvh
rga: rjr ruk bit
buu: cbg cvn csn cmh cne
bqx: crh ctm
rfc: bkk bcn bix bwl
kgj: kmm kog rkf rys rdd rjc bka
bsr: bnh bzb clz czx
bji: ber boj cav cax cxe ahe
clt: cww
bii: bgt
kue: rly rld rsk bal bgu
ctq: ach ahs
kqr: rre rby rsc rfo bwi
cnp: aci aal
kei: kml rjo rti bbb bgl
ari: ahr
klk: kez rar raz rnr rni rnn bgz
bvb: bxv bmk btj cmy cze cqd cte
klj: kwg kuv rch bby bhf byr
kwi: kvz knp rpx
byc: bya
reu: ruo bbl biq
rbn: rhy rsk bkp
rkr: rkj rak rsk rfv rtb
bmg: bti cly cmd cne
kus: rkd rhf rlz rlt rzj byj
kpp: knk kzm rar rha rzf bbx bbn bci bab bgc
kut: rry rui ron
kqg: rpt rtt baa bae
ktc: kog rcz ryb bbf
cwf: ars abo
cbw: cwi cju abz ail
cyn: cnw acu aiq ahz
cqu: arb
kuz: rxj rnq rzi brt bbt
rcm: ral rvx rtf blw bgs
rod: bai bdr
cdb: cmx cum
cdk: csy cqr cue
byp: byt
bfk: bfe crm clf
bfp: btx cyt cja cvb czn
bbc: bai byh
bqd: cro cdv abz aah ahn
csb: ces cez cui cot
krm: kcv kai ksc kxu kpd kmi rpr bwr
cqd: coq aro aav
ruf: bbd bip
kpc: kpn kmh rgn ruu
cma: ctx
rxu: rtq
kbn: kcz kwa kja kze rbo rvq rnp bhm
cyu: cdo ced cme cmf cqe aii ahn
kwn: rzp brn bbj
rzn: bbi
cre: clp cmm cfl cfs cuh coh
rbs: rmd rfd bra bcp
bsp: bsn bxy bze bqx boh cpb cos cou
cgo: cmc ars
baq: byg
rwj: rep
cij: clw cdh czq abt aij
kmw: kte rrt brn
kvz: rbx rce rlc rzg roe
cja: cfh czs czo abj
kjd: kne rda rql bwq
cmo: cfi cuf
bni: ccd clx cok ahh
bnr: cag cie cdn cfn arm abl acl
rdd: rdz rve rem byi
bnl: buj crc cwk cqw cqf
bcs: bim
boh: ciz
kef: kqq rka rew bwx
kff: ryq rlb rgs rev rpv bkf bym
koy: koe rcf riz
ach: acg aay
bxu: bty chw cel con aks
kvq: kqt rlx rsx bhj
kdr: kdw rbh rcd ryz bau
kda: kmg rbu rob brk
chh: cum
rxf: rms rfw rqy bie bgk
rae: rvr byj
cty: arz aaj
rpq: rzi bla
ktm: kul rrx rwz rec rep rmk
rkt: rvk rov bka
rck: raw raz rsz
rxp: bcn
ccb: cgg cdw ayr
bix: bdr
blq: bgp
aak: aih
bci: bwu
boo: cbv cga cdk cvp cph
rkw: rjt rfp bcp
rjp: byh bwq
klq: kwk kmh koq rct rln rds rjn bre bby
cvs: cpw cnc
buc: cga cgt cqg aal
kla: ksp key kud rcc rdg
bpp: bfl bzs buj cje cpw cno czu cqg coc col aat ahk
ccw: ccm cgm cen cxu akt arm
rtk: rum
bes: bxv bou cyz cge ahc
bal: bgn bwz
ryk: rwn rsg biy
ctc: acl
csg: aky
kkz: rko ryr rdy rsy bwh
cxk: cpn arm ayc
rgo: rsf rxo rul bbh
cgf: csg cta abs
bpb: bfk bze crl cbx cwu aro
rsc: rsz rpj
rbf: req rms
bfr: cab cdq cxi cnk cnn acl
bhh: bge
kpy: ryk rxx bie
chk: czu cqb ahz ayy
kag: ktr rlq rde bbj
ctd: aiw
cmx: cnj
rmx: baf bws
aka: arz
kyp: kea knb kfw kut rjy bbo
bcp: bgq
rrd: rco ryi bwi
kwa: kds rah rnj rqp rty
cwg: cvf arl
cam: chr cya ctj
cfr: cux arj
knx: rab rsn
bod: crv aaw
cmn: czx com aar
kfw: kom rpc rqt bkl bbz bgw
kuq: rbo rci bhv bwg
rpc: rmr bwt
bdm: bpy bmo boq cbm ccu cgg ced ctl
ceu: cuv aad
rch: rgn rmf bam
klo: kvq kzp rys
csx: cxk cph akg
cyy: cgn ctr cuh coq abj
bbq: byw byo
rge: rev rtd
rtc: rtu
chi: chq cel abs ais
cgz: cdt cpa cpz cme
kkk: kjc kxn rjz rxq bka bbf blq
rgn: rjl rxi ban
cpp: ctu
kui: rmo rzy bcd
cla: ctj ahk
rhs: ryj bhl byi blh bga
kcn: kyh kes kml koq rkj rdk bwx
cgb: cjb cqa ahe
rig: rze bbh bhm bys
bax: bwk
cps: cqq ctn arn ahp
kbb: kai kqz rje red rmi brq bbj bcm baq
ral: ris rge rex rqx bhz
bmd: bzy clr cla cgh aas
kqn: rre rsl roj bcs
kmj: rke rww rvb rsn rmb rfd byx
bdv: bud cag cdc cny ary abv
cgu: cpt aif
kxh: knf rgk rmv rza
rdx: rns baw byu
cgx: cgo coy akt
cqs: cuo akx
bjd: ccv clo cpr cor akz ack
rcr: ryx rdi rqq bku blt
rly: rda rem rmy bcq bhc
kxo: rwg rmu bku
bph: buo bom crt cur ack
rvy: rzc rtp
kyu: kvp kvz kxk bks bbf
rtp: baz
cbf: cwc cwd cjd cvj czn aca
rmw: rmm rfl
ktb: kto rnr rqy
bej: cko ceo cuw ahp
rqx: bra
bom: cgn cxe akn aat
rfu: bbj bas bik
rwl: rnh rza ruz
cjd: cpd aap aic
cjt: akj
bnw: bzq aka aki ahp
rkc: rbc rpw rtc
kyn: kgw rbh bcp
clz: cso czt ars arf aiw
bcf: bal
bvg: bxk bzo ctn cov
rrt: rsc bkp
cct: cls clf csa cmy
cjn: akw
kzd: rav biy bgq bdr
kod: rse bwk
bqi: ckk clo cvr cui aih ahq
bva: bvl bnv bfa buf bok cbm ara aid
ctk: are
btd: cax clu cug abz aio
knf: rsg req rzs rod brh
box: crf cfs czl cqa aat
rty: bkz bgp
rwi: rdr rtk
cau: chl clz cwb cwq cvn cpz
ciw: clp cjm cpo cug
kgc: kob rwk rdg rja
cwr: ceo cpc
ktu: kod rkl rhe rhm rlq rwo rni rua bgy
bvx: bpw cbl clp cgd cmd
ket: rim rlw rok
kyl: roe byu
rwt: bcy bya
kdh: kjw kvr kts rsx
kvh: kpd kqb rrd ril
clq: cxd cob aax
kht: klc kzc kzp rkh
rml: brp byo
kob: rcx ric bbh bbn
csj: cek ctr abl air
cbj: cwu aaz aiv ahw
rit: rgv rvv rxc rfr rqb bra bgb
kmc: ryg rqh rtz byc
bqv: boj cic chh coy ahh ayy
ryi: rld rdy rfp
bsm: cyc cek cfd abs air
rfb: rqe rol brd bax
kgp: kds kjr kny rqw bbm
cuf: ahv
crw: cih cix cpv con ais aiq
ksh: raj rec rpt bka
cjr: cja cnj cof abb
kss: kxr kfn byr
rfp: rzc rzd brf bam
ros: bbu bhg
cri: cll cey cpx aby acn aip
rua: roq
rru: raf rqw ruo brp
kwz: ksh rkc rdj rvy rxf baa
kqq: kuw rkp ree bgc
res: ruj bwl
kih: kyq kdp rru rnm bba bii
bbd: biu
bmf: bof cra cbf cle cwc cxe cot arx
btb: bul cka cre cxn cql abg
rvp: ruy
buq: chm cpk cnl
rkl: rdx bak
rgg: rgp rpy rtb bhx
roa: roy bad
bnz: buc cln cpi cnp cza cul cok akz aaa
cwp: cvy cvf cfk cop aid
koh: rii rwr roh brf
rgx: rws rfa brc
cxj: cog cow
kac: knk rdj rmr bgc
rnq: rtp ruo bhs
bfc: cai cyz cyo cwj csw cmj com ari
rvi: bdk
kdj: kpz riw rfr bim bgf
cfw: cud arm
abu: ayi
bcr: big bhp
kdo: kfk kfc kzz rbd blm
cyo: ain
kzj: rjr rqx bai
crq: cbr cxv cqr akr acs
ril: rwf rfh
bmc: bmx bzh bzx bta cyd clk cxy
cye: csm
aaz: aht
koe: rri rrn rxx rmc bbd byt bln
kec: kqs rbl rjy bcc
rnd: baf
cbb: cae cmx cnr ctk cta aar
cwi: cey cmf aho
czl: cty aka
kik: ktk rrl ril rwe rvh rxu rpk rfg rqu bya
bzb: bty buc csh
bex: ccr cjp cnk cfl
cum: air
kbj: kac kgx kdo kfo bhs bww
rja: rur
bpd: bng bnu cch cwk
cji: cxu aab
cgr: cwa cng cfh cqu aby
bho: bwb
rli: rgn rxp rzu rtp ror bgw
rph: rts
kjf: kmb knf kfn rwg rvh bae bat byh blw
ksr: kuu rck raa rgr rnc rqc bgi
rwq: rdv rzb rux bks bgd
rki: rbj rep
bna: boc ccr cae cig cdr csh cpo
rbv: ryq rjs rvx rpy
bir: blk
bnn: bur chu cxo ctw akl
bzk: can cyk csi czw aya
kty: kub rdy row brf
bxk: bmr cit clp cje ake aiw
bdh: bmz bns bta clg cdg cpw aiu
kky: kzy rdi rei rns
bft: caf chj chm cjv czt
kcq: kwk kmf kuf rhe rlx rwi rtr
cks: cvv csp cfe
kxu: kqc rkf rdi rpy bcf bcq bco
bju: bpo bop cam czb cul aiu
cwd: ctl ctv
rce: rvg brz
bku: bhr
ksm: key kes kum rbz rld rgq rwf rdw rdj rvj roz
kiv: kzk rwu rxe blh
bsd: bxy boj chc cjj cel ces cqo
cwj: cfk cfo cqd ahf
beq: bno boy cca csp cmh
acw: aie
bfd: bux crk cfc acc aao
cas: cik chv cjh css cfb
cmh: ctx cui akh
khy: khx ksn keb rkx
kkl: kbt kyd kfh koj rbx rya rwd
cet: aia
kce: khe kjo keg kmb reu rzn rqp rtz
rdw: rzq bbk byk
cvg: csa akf ayc
kro: kwn kow rky rrt rly bim
rcf: rjy rml brk
cwl: cvr cnv
rag: rhr rjd rmh
cgw: cwj cvz ceb cmd akq aiv ais
cew: cpe ahf
bru: bgv
rhf: rft bbt
bpw: ckr chb cgu cwb cdl aho
rvg: bkz bgh
rux: brq bio
crj: cil cen cmf ctx abk
cyq: cde cms ctq akm aca
bbz: byk blj
cyx: cjc cji cui abe aal aho
kfk: rcx rzn bcm
cip: cgw cfe abs
kct: kye kli kfb rhv rla rzx bip
kly: kdy kzp kuf rlw rzt
kwq: knu ryc ryh rmn rzp brw
kqw: rcs rvf baf bhd
bue: bov ayr
rtx: bho blp bgm
bns: bnp boj car cwy csd cmb
rie: rdg rfm run bcb baq
cea: cnn cfg arm
rdo: bao
kuy: koo rba bhq
ked: kxo kfo kqi ren bwc
rzh: baa biy
rzt: bhj bwd
kwt: kji rck rlf bih
cmu: cns ayr
kvd: kzg rma bwn
kkw: khu kxb rkq bri
kuh: koa koy rio rup
kps: koc kot rbc bwd
kfc: rir rmx
rkh: rdf rfz roo bcp bys bwb
rud: bho
bpu: bft cbl cdb cxl cqp ars aaj
kmo: kng rkv raj rwq rnd rfb
cxt: czb acj ahu
con: akf
rne: rtr
bjc: bta cvh csi csn ceb
cuo: cov cof coz
kdf: keh rag rzz rqp rof bcs bcu
kzq: koy rad roh
ccn: cga cxi cov aka abx ach
kad: kls rhu rdn rfi bwt
run: roz
kny: kzp rem rnn rta rtl
rzq: bhs bgm
kwo: ryo rxe rtv bkj
rre: ryb rvc rnk
bei: clv cjp acy
kko: kra kbh kzm rkw ral ryv rgp rdk rxt roj bbc bai
ruo: bcv
bvw: bfp bzk buf cpy ctg cup ack
kew: kth rvm rte
act: aaf
rds: rzy bgu
bfm: ciq cjq cmq cni cff abu aia
cho: cpa cmr cnn
cin: cwc cus arl aao
bnt: chw cej ahb
beu: bfe bfz bzb chn cvk cow acm
rln: rmk brl bax
kst: kqc kqa rym rft bya
cdz: cnk
kak: khb kyr knk rbx rwr rfo bye
beg: bfn ckv cas cyj acj acq
krd: knr kuc kom rrg rlz rsh bye
kar: kfd rhe rsf rfq rue rov blo
rgz: rxv rmr
kpo: rab rip bhf
bdz: bjs cie cen cub ahd
kae: kjx kun raj bgv
cig: cxd
buh: cxe cmk abh aaw
ksi: rlo rwg bht
rhu: rqn bau blb
bif: byj
cqp: cov
kgz: ksi kny rvz rsm rfk bhu
rlx: rqm
bub: cxb cpo cno abe
kfv: kzw raa rwp rdr rop
czs: cul aco ayb
cfo: acr
cee: aka
caa: cwz cpg czw abs ahn
kiy: ksw kfw rxg bbc
kft: kzn rvh rec bhj blc
kjs: rla rws rjn baj
kye: kdl kxa kfl ryh byh
cis: cwg cnm
cyd: cjc cnt cfn ain
ruh: byw
bcu: bid
kzg: kod rrs rcd rvq bai
cix: cyz
clj: cqm
aco: aic
bxy: bts csb cof
bbv: bht
buo: cmr cqp coo ahi
boi: cbs cyb cyl clt are
ciu: cqq cuq ahs
bma: cie chq cxu arn
akq: aan
bxc: bxo bnf crw ccb acx aao
cqa: coa
cjl: cex cqu
ctu: ack
cng: arg
kcm: kde ksk kny kzk rra rpc rfw
knu: rok rot brc
bzz: btw cix chy cgt cpg aiz
bow: cgu cji cxy ctv
rzo: bbq
bpv: ccl cxj cqg ctq akm
bjv: bje bxi bmz bue cks cjn abo aix
kem: knh kff rme
rkm: rru rya rwl rzv
btu: crk csu czz aau
kao: kwi kqk rnj rqo bck biu
aal: ahl
kmf: roi
kor: ryl rmy bhj bht
rkn: rjs rsk rti bil
rpg: bkt bgr
rve: bkv bro
bfz: btu bui abc abo acm
kwp: kvp ksw kqr rpv rpz bci bap
rmf: rtw bkf
rhn: rdb ruv bae bgp
bss: bph btp crc cpw
kum: rwc rxr bkg bhx
rzj: byh
cay: cez cmw akp abm
cda: cet ctc arx ahk
bez: bet bpr cho cyq cld cjq abf
kmu: rsc rnn bif
ryy: rdt rvk rqu bcb
cjb: cem acx ahq
cwo: cdg cji abp aaj
rdm: rjs rqh ron bbu
cwy: cdt cje
cbz: cdm cma cnj cqk aid ahh
cmd: czo cqw
bfa: crl crj cii cfj
kux: rmu rnu rfj rzq bbb
bsz: bzr cba cis clr cmb acc
rys: rsa bba blz blo bws
ccu: cpv cfq
raj: rqt bwp
cpt: ctf aba
kxw: kxd rav riz
brk: bbg
cqj: cub cul ahx
krf: kee rku rrh rtf bao
rab: ryn rxv rti
kxx: kub rin bcs
cvb: acd aay
buz: boc caw cao cnk ctl aik
cvr: cno arh
kjk: rkn rmv rqk ruo bbn
ktt: rhc rvz brr
bpc: bps cin cyt cvu cov
kzv: rhi ryi rqg rtt brh
kjm: rhf rse rxf rpo
rpk: rtl rtz
bvu: bpb bfa ckb cat ahv
rsd: rni
cju: cvm cxh
kti: kte run bbi bgv bws
kuk: rwj
akv: aah
kqh: kql rmc rft rot
cjg: cje cor acr air
rsu: bgj
kal: kap kwh rhi rjq
roi: bgl
bpe: ckv cwr cji cve cxh cpm aiu
cor: abu
kon: rrc rbo rde rvn rni rnv rzp bhr byk
cso: cxc act aih
kws: kvm kfr kfm rbx bbc
krb: kby khs kpg rhn bcj byf bly
bqy: cgj cng abe ahm
kls: klo kns rrm rdt
cpz: cnc cnt coa
cys: cem ctw ctm
cxs: cmr acy
bka: bdb
czv: cua cud
kvv: koo rbs rmz bac bgy
bew: czk ctn aki ahv
cxy: cnf abl acp
rea: rpn
but: cjy cvn cnf coa aae
kqs: rbi rvz rmg rnt bck bll
akj: aim ain
bxs: bul crw cwu cdu
cax: chi cmz col aag
ccv: abz aiz ayy
bat: bil
rvu: rmr ron bhf bwk
rxb: rpx rmf rqr brn
ryz: rjw rsc rnq rtp bbe bih bgf
rib: rps rmh rop bwp
ceq: cxu cfx abu
keb: kmy rbv rwn
keo: kxb kxl kqt rru rcg rlq rwh rss rmh bla
kwx: kzj kzu rma rts brd baz byd
kud: ryl rjr
rvx: rmh rnt rqj bbh byq
bta: cqp ctl akd
bqh: buh csm csz cfi ark abk aco
csa: cob acv
cwq: cqs ctf acm
cxf: cmx akw arm aal ayr
kee: rso bht
rmh: rfx
bfg: bzg cti cth aii
rgu: rjc bkv
knk: kql rhq rvd rmh rnp bgo
rlj: rgk rgm rwv reh bgu bwf
cbm: cav cdi
bcl: bau
bhw: blv blf
byi: bgf
bqf: bux chx csc acv
rnf: rzq rtl ror bih
kjo: kps rcb rch rnx
bvd: bxc bpv cko cgd cpk ctm
rfm: rzw bak
rhi: rym bgz
bpl: bpf bnc cri csw cem
rxt: rnq rqq
khb: kpl rhb rvo brk brl
riu: rej rpa ruy bgs
kxi: knu rbk rlw rqs
cim: chp csg
ark: aas aif ahz
cqy: cqe abb ahb
kgl: kvz kpd rcl rwc bkt
khr: kqa bbd baq bgq
bjm: bnx cwu cxv cmw ayg
cez: con ahh
kdq: keu kuv rls rvh rvd rnz bag byl
rbe: reb ban
kez: bcf
csk: cmp akm ahw
bzo: boe ckz
cpj: cnl cou abl
abk: aii
bzg: chq cjw cni cnv czx ctl aba
reo: rfv rok bre
ble: bwq
knz: rbc rfq rzv bkg bgp
kaq: kwy kpy rgr rjw rvm rmx
rid: rsw rzf rus
btg: cku cbq cal cyj cuu
kzl: rce rdq rzt bco blc
cqn: coi arr ars aah ahv
btl: btu ccw cdb cmc aby
kfx: rbn rjx rqw baq
rku: rha rle rer rqo
cfv: ahg
kfh: rkt ryy rqk bal
bqb: cyt clu cws cdq cpt czs
chn: aap aan
kxb: knq kzd ryf rnv
kfn: kqh rtg bcb
cce: chr chh cuu coo acz
bhc: byd bgg
key: bya bwi
csv: czb
bmu: bnr cyy cyf csw czp ctv acb
rol: bcg
arl: are acz
czc: cqd cqz aiq
cww: cjf csw cft cut ahe
aro: ahk
rfq: baq blo
reh: rqo bbz
kkv: kke kxd kfx kul koy rrj bhv
kuo: koz rbp rmk rty ble
cnt: czs
bdf: cko cci ccd ctu cov acq
khh: kgf rrf ryb rgy rvi rfn bgx
rtd: bcn
kfs: kqc rcp rsn rmb byr
ckp: cru cnm czc
kfu: rhe rvx rzq
rsq: ref bkk
rho: rdy rvm bkh
rin: rjh req rfx
kyj: kxr rbg riy rtu bka
cjc: ceb aau
cdr: cui
kfe: raz rsz
cht: cuz cod
czn: ark ayh
rkz: rwu rsm rxn
rcu: rla rwk rdz
cnm: cqq
rcv: rpl rzu
kvp: keh bat bij
rso: rta bkh brn bch
rbo: rze bhp
cmi: czq cua
cuy: cuf arp ace
rtt: bhr
chg: cvz ard ain
rtz: bit bww
rqk: ruy blz
kve: kun rbs rjt rsz rmz
cbr: cho cva akv aku
rdi: rnv
ryh: rsv rup bwf
kgu: key kzx rld rga rdx bku
kxd: rsa rty brp
kpr: rdn rsp rmu rqp bky brm
rrb: rau rvc rxh bir bwj
kld: kls kgd riu rvs
klb: rrd rtp rux bkc
rdy: rqz bbj bwt
kvy: kun rbk rfd bgs
kwd: ksz kej roz bwj
kzr: rhj rxo rpa rnj bgq
kvm: brd blg bgq bwn
bvi: bmz cly cpw abq
keq: knm rhn rei rxb bbu
rpu: rmo blm bwm bwu
cxo: abu
crr: crm cco chv cus aar
cdt: cmc cqq abo
ryf: rvt rqs bbf bgd
ktd: rso rty roh
ryq: rsd
cmk: ais
kqd: kqq rar bym
bzi: cgq cwl cxq cpe cft ctz
cdf: cjj cxl ais
kqe: kuc rdb rnl rno brb bar
bqq: cht cjb cji cvb cej cmn aac aix
abm: acg
cxb: arr
bxr: cck clq cwf csn cex cxi
kin: kya rvq reg bdk
cit: cxq cnr ake aih
beo: bpm bmd cyo ctr are
rft: blq
cka: cyn acy acz acu
bnv: bom cdd csp cps cnf czi
bvm: bmx ckm cco cxo cfg cuv akj abk
bjz: bed bzu cwt cdx cua cup
rai: raw res rqp bcx byo
rlu: rek rqo ruw blx
ksq: kpz ktd rbt rze byy
cai: cgv cmn cqa
clc: cwe cqq ary
rsw: rol bkd
rhj: rjd rpl rpp rnq rzk biw
ram: rva rsq rqe
bgq: bws
bxm: cyi cfq cqa aah
brn: byb bwn
kbu: kol rby rhx ryr rgk rfn bbq blp
rte: ron brz byq
rot: bkk bgg
cxq: akh
cgs: cgn cze coo abj
bek: bfu cwb cpw cny cql aaf
ryr: rlt rjf rpr bbe bbp bhk byr bwa
cxc: aij ayc
rlg: rwx reb rtj
bby: byw byd
rnm: bwp
rci: rfw rzp
bhz: bwn
bqt: cjs czy cop ach
cqh: acp aaj
ksn: rjn rpn bkx ban bld
bbx: bgl
kds: kvt kej rlo rup baj
rst: rmw rmj bym
cya: cda cfl acg
bdx: bff buc cys cxj arb
rqo: bdc
cza: arp aby
rdj: ruj bki bgs bwm
kkh: rjg rxk rfd rzb bcy
rjs: rpk bri
rpa: rzf rqf byc bgn
rrp: rsf rfu bwh
bos: bof cfq cta ahv
buf: cbc cyi cgy cvz cuc coj
cno: arq
kje: ktv rkd rbv rbs rfa
kkf: kri ken kfp rkj rae brd bhb
kdw: kjf rbq rsn rxo bau bhw
chr: cxd czl coh aat
rbr: rtd ruq
kij: kji kub rvk rmt bcy
cia: chz cwj cvk
bvr: bna ckc cgd cwl
klv: kwq bbk bba bil
rgm: res
kxt: kqa kov rji
koz: rqe
cuk: abt
rju: rpx rfk rto
kpj: kzg rbd rel
clo: abm aca
cmt: cfr cug abr
cyt: cjk cmo czk cuh
ryw: rge rwh
rkf: rrg rjo blh
rcy: ras rjt rnr
bpy: bpf bzv ctl
cnz: cuj
bje: bnf buu cju
rje: rea rnz baj
rpd: rfy rql bcg bhl bwk bwd
rrq: rmm ruy brl bwt
bze: cad cwz cxw cpn cfn coh aiy
kah: kyd kwu rak rny rzk rub brs bbw blm
bba: bal bdb
cur: aiw
brw: blh bwf
bfh: bfe bun ciy
cpl: cnh col
rle: rng bbn bgo
kbg: kvu kza rbj ryf rsb rqy bco bgx
kmr: kuo rio rgr rpe rfu bij bin
buv: chb cxj cxp cui aap
kgw: kxw knx rgj rtk bwu
bet: bqa cku cig cvx cvp cxk cxc cxn abr aan
bzv: btf ccl cdo cxh acg aat
kys: kem kzn rxx rue byn bga bgt
bpk: cee cmf ctj ctz ahr ahp
rgb: rxl
kth: rky rbz rgv bly
csp: acr
ctp: abo
bui: can cyq clj cuj akr abg abe
kql: rbw bax bhe blz
kay: kqi rcv rak bby bgu
rcl: rnz rum
rwx: rpo rqp bhw
kpt: rps bym bwc bwd
cej: acq
rwm: rep rxq rul bkx
bbt: baw bys bli
cer: cxz cxq ctp aiv
bbi: biq
kuv: rki rwe rqt
bty: ckd cid cwk cwb cjj cej czu cof aki
krs: kef rkq rit rgy rgl rwx rtd bwo
rsb: brb bdb
kba: kij kdm kuy rde rpd rzv
ryl: rlu ruz roy
rzy: roz
bqs: bod chz cwl cjo akt arb abj
bvc: bsh bpa bfl bfq ccx
rjv: rez bwl
kpb: rsx bcg
rdb: rmj bkc bib
ktq: rec rxg rfh rtr brf
clb: cew akj aru
cro: cde cxf aky
kil: rwn ruk bkl blc
bkx: blv
brs: bcz bha bdk
kvb: kss kuz rud bys
brr: blo
rpt: bru
czg: czq cug aaq
rko: byr
kho: kgy rxr rpm bam bhb bhv
kpq: kzh kzq kon rbg rwt rvp bbb byx blx
rmn: rzc ruw bkj bls
ryd: rwa ruo bhy blw
abh: abd aae aau
cgh: cof ace
cjm: cmr cnw cqk cue
crx: cbq cim cgc cdg cfq
kyy: kge kfn rsu rpu brz bba bbo
rzw: bbl bhr
rtg: byz
ruc: bbk bgz
ctz: coy
cqq: arw
rco: rgl rjp bkw blk
rnp: rzy ruf
rkg: rai rwz bcw
rlf: rnc rnq roh bwr
rfj: bht
bsy: bpz bnt bzv bqg cve cpc cps cnz czl
bev: bqe buo cah cva cxw cmv abt aao aiv
aib: ayy
kcd: kal kyh rhs bai bye
kat: kgp ktr ktp rjr rtb ruu bcu
ciy: clm cvq cmy ctu
byd: byq ble bgv
rnt: roy
knv: ras rhi rxh bli
ksj: rlv rsk rsl rox bcv
rjj: rsi rzr bhe
ctl: ait
kne: kqt rio rxa
bzn: cbh cig chz cgq
kso: rhs rvv rmy rur rug bga
cak: ctj ahs
cpy: cns
roy: bij bgz
bsw: bzc cbg ctq aaq
bvt: bxp cdq cst ahb
rub: brz
cra: cgp cnb ctd aba abx
cfm: coi ako aax
kpg: rjj rvr rsd rna rfa bah
kyb: kjp kpb ria rsn brg bwo
rkb: rbn rdx rea rxz bcf
ckk: cif cet abc
rrm: rza rzx
bkt: bws
kxg: kqy rsb rqz rui bgg
arj: ahf
rfi: brh
bxj: bni cwb cev
btv: bov ccv cab cjg cjs
ray: riv
bkf: blx
kaf: kls keq kpp rhn
kxf: rap rau red ruv bib
czf: arg acm
rqh: rov blq
rrl: rds rew bki
cfe: art act
kfo: rar rgz bcz
rld: rsu bkj bcg
ksg: kez rgf rjx rsc
bjx: bmj clt cjn cqt arw abk abj
acj: acp
kes: kmn riv ruz bbp
kbt: kcw kdu kqj koy rry
ces: cpq aif
biw: byv bge bwp
cli: cld cpk cfo
knq: reg bbw
kge: kon rcy
cbv: csa cxt cue arf
rbg: rit rgk rfq bie
bkd: bhj byz
csn: cts akc
cac: cjq cvw cxa cpf cnr czm cun
cpf: cqc akz
cxg: cma akg
rhz: rlk rta bwp
rbu: rdu rva rzv
cqc: coc ake ayk
khv: knd kuf rcu rop bbw byg
rvz: rou bha blj bdr
ktf: rgk rjb cqa
kwb: kpm kpz rxv
cad: clt cpr cop akt arp aiw ahn
akb: abk
cpn: czf
rdl: rvy rpl bhl
akm: acp
rmq: rut bro
rjz: ruk
rym: bca
ail: ait
cof: aix ahw
klf: kdw kzb kqp rci blm
kiw: koc rkn rwx ruw
kgs: kea rew rpe
bjt: bow clr cvm cms cuw
bur: cha cyk cgi cgp cnw cug
air: aiy
rde: rfh
arg: abb
rbz: rgc byf
buk: cti abf ahx
kiu: kmd rcr ric bgh
kzc: kqz rhr rqw bgo
rrx: rnw ruv
kas: klf rbi rew rep rqc byn
bvo: bsl bqq boa cyh clb cjy aae
cal: cym cyq cqp ahw
keh: kne kuu rcz bgi
ryt: baq bdb
btf: cbv cia aax aim
rzg: bge
cui: ahv
kai: ksq rai ref
kgv: kxt rxk roq bkd bic bhv bhs
kfb: rhf ryl bku byr
kto: bie
ccd: cfg cfv czr czg ako
bno: bts cdp csv acu
cms: cqo
kjq: kmq ryl rwu rtf bbe
cfy: akh akm
ccs: cio clg cjq cxx ake akx
bnj: buk cbe chw chj cjl cqj
rqi: bwj
rll: rdx bru bgp
kis: rhl rhp rvm bkp byz
rcx: raa rqj
bua: ccj cje cni cnh cfp czz ahb
bnp: boe ciu cyf cgf akp
clv: cod
cnl: cnx abn
kvc: kmc kfe byz
kev: rct rjk rzw rqh bwk
rka: rwp brz bcj byn
abz: aht
rwe: rmx rtm bco blz bgr bwg
btw: ccy cfv aaq
cmq: cte
kej: kqc bic
ctf: aii
rra: ryf rvb rzh bgi
kwm: rej rfd rtm bhh bls blm bwb bwj
cah: cpg cmp czh cqr cou aay
rvt: brs bbo blz
rnw: bha
kyf: kvd kmd kze rhx rwp rxe bwq
ccj: ciw cdm cjq cpd cnc cuw aca
kco: kvj kek rkm rwf rvf rod
bag: blt
rvv: rew rfz bbj
byg: bwk
cnc: cqe aaz
bem: bxn boa boz cpu cnk
czd: ari aaj
cub: aac
kdv: keg kxl rbj red rxl byf
rkp: rwt rdp rzp
kgh: kxo kue rch rer rxg rtj roq bhn blx bwz
kka: kbh klf ryh rqt
kjt: rrj rar rlx rlt bbh bwa
ree: rnq rzw rzz ros
rrz: ryc rlf rdf rjn rsk
kca: kxz kfg koa rkj rck rcg rmy
bkz: bgv
rha: rsq bdc
kgg: kdc kpq rga rqh bkw bhh
cwe: cqx cof
klh: kjb kxt rsu rqn bgl
krq: kiu kyb kyl ria rvu rpf rmd
ckt: cir chl cyp cfs cfq
rxc: brw bwb
cst: cfr cte
rdr: rjn rzp rua rox
kzi: ktj rbm rbu rpw roc bij
kit: kge kwg kvx kmm ryq rzp bro
rza: rut bli blw blj
kjr: ktc rwb
rda: rny bcz bwj
cqw: abn aas
kbz: kxt kpd kff rkj rgq rpz rqu
khp: kwp kek bbi bcd
rip: rxt byt
cbp: chc cdl cdv cuv akz
rim: rwv rwq bcd
kdl: rbg ric rnu
rgc: rpg rmv rzx
rby: rei bki bcy byl
kpe: knb rio roe blu bwh
rad: rwf rsr bra
cvo: czh ayg
ary: ail ahj
rhy: run roo bcj bgx
czo: abw
kwf: kxq rls byg byt
rwg: rup
kkn: kaz kwl rvv rsv rmq rtc rtp bro
rzm: bbv bhy byy bll bgn bwm
boe: cft arq
crv: crp clv cgc cgt cnl cqs arx abc
koo: rry rde bcp bwv
khk: kfq kzm rlg rev byb
cut: akr
kvi: rqw rum bwq
rgh: rtw rts
cpv: cni czr ctc aby
kuw: rbe rio rzw bbg bcr bap
cfd: czw ctm arg aam ahj ahm
bsi: bpo cah cdc cvh csq cno cfj
cqm: coa aca
btt: cct cim cgb cjo csd cqg aio
kyt: kee keo koe ryn
rfy: rue
kvw: kmr kzw rej rpi rfa rzx bgd
cef: cqo abr ait
ken: kth rkb rfv bwa
cjj: czy cut ail
kmt: rsz rpf blq
khe: rkr rlo rja rqq
rhp: rpk rme rfs bck bli
bok: chy chq csx cef cts abu ahc
ceb: czq akq
bpt: bum cma cfh aig aha
kcv: kpa ruc bkj
kcz: khd ksd ksx rif rvs rey rpe
crd: cab cid cgt cjl ctu cuz
bxf: bfj bqb ckk cck cag arr
klz: kdj rkl rbv ray rdc rve rfh bcr
byq: bwh
bnh: bnq ckq cwl cpf cfs cum
rjc: rjs rxs brj
kfg: kuc rky bcp bik
rrj: rwy roj bch
ckd: cih cgu cwt cnv cnn
kaz: kyf kdk rwo rpv rmz
cec: ceu
kdg: ksy keh kmw kze rca riv
knc: kfp rbj rym rmm ros bwh
rhk: rys byd
csu: cph cqm cta cto
ckh: clc ahj
caq: chh cye cwh cwq
bon: ccb cez cmr arq
rww: rzw rtc bbw
bfq: bqj crg cgl cvr cvq cea cfr
ciz: clg cmn cmo czz aky
bzx: cdr cjs aky arj aab
rxs: rfq
cep: cnc cfn ctq acp
bjh: bsr bpr bzt bqn crp cwh cun aan ayk
bus: crt caf coz akr arj
kkd: ktr kol rjj bil
rkk: ryv rwj rmu bkl
kqo: kuf rcx rsx rmb rmj rte bya
kfa: kzg rmw rzi rtm bgt bgo
rzl: rtm ruj
cwk: cva cqx cog aro
bbm: bhv
rvb: rnx bku bra
bhv: ble
btm: cwr cmj cqy coo
bsn: bxe btn caj cax cnn aby
kmn: rlr rvj rme
caz: cvg cvf csd cmy cth cop ars aau
rof: bkk bak bax
kcf: kfd kqz ktt kuy rcc rml brt
rhw: rji bis
bpx: bzx cfu akn ayb
reb: bcv bgm
bjw: bxg crk clm csq cxj ahl
bms: bfg ckp cvs cxo cne ctu aha
bth: btl can cok
coc: arg acm
coj: ahy
bzp: cgn cvd czj aaa aiw
rhg: rgr rmx bit
cek: cew ces cok
kie: kqm rib rhc rsb rne rqn bkn bce
kch: rkv rrf rsq brj biv
kqu: rrp rcl bcm
bts: ckc cat cgx csf ctz cod acv
rbq: rfi rzc rzx bce
cgc: cow abh
com: arp ayk
cxx: cmx cup coe
kab: kem kqb ral rnx bgy
buj: cyc coh
kmb: rif rdm bcl
kyk: kwg kni ryk rog
bte: chp cdw cdj aag
bbe: bwn
ksx: kta bbh cok
kek: ken kfi ktc rbx bbd bca bcs
kgd: kgf kwx kqf
cen: cxo cfu ctg
raf: bcq blg
cmv: cfx ahg
kxq: kzb rle rqt bli bgp
rqz: ruh bbg bdb
cpi: abo aas
cey: cuo
rbi: rdc bkt
kmx: kof rii rih rsj rod
kdd: kdt kvm rko rhw rwi
rqq: byu blq
kzo: kub rij
bks: byy
cns: cze czn
ced: cpu cow
rfs: bbq
rbb: rii reu rze rzt
bxg: boj cbh cak cpn cnp cfv
bmw: bqf cey cok aad
cki: cao cwr cdc ary
chl: csh
cto: cuk coz
art: aht
kpd: rjb
kib: kmu kqi kox rct rwz rjt rss rex brt blv bge bgp
bnc: cho cgx cut
csy: czc con arh arf
kck: khv kjr bho
cbl: cxs cus coi
cge: cev cnu czw ctk ctw akg
bsc: boh crq cdp csx cto cog aku acz
cos: aru ahw
rwa: rvq rsi rzs rqm bwm
cel: cuy
kap: kng rko ria riv rof
rcc: bkt bbm bac bwz
acd: aaq
ctb: act
bnm: buq cty ako aru aam
boy: cau clv cgl cvw
kbw: kls rbb rba rlf rvk rem blk bgc
bxn: bpf box ckb ciw cuv
ksp: kup rdl rsj rfl
kpu: kmt kqy rwn
cws: cvx cmi
klx: kdv kjw ktn rao rgv rja rti
cti: arz ahy ahw
rgf: rdq rss
bmz: boj cgy aay
cao: cqh aca aay
rwo: rsq rem rxc rtq biz bwb
kzf: kuv rdr rmb bas
btp: crf ccv cjh ceu
bvf: buo cll csh cty akb
bqp: cvi cxa cxz cob abf
kmy: kzt kqg rrg rxz
ruw: bkq bce bhx
kwg: kts rib rjz bkx
brc: bwp
cvd: aai
kox: rht roo
bnb: bne bow ckl ctp akv
ctg: arv
bvl: bub ckx ayb
rpn: bbo
rar: rhb rsf bij byt
rmk: blv
rmy: rqb bwh
bdp: bvx cbe cyb clh czc cqa
cln: csq csu cea ctn
kam: kis kgk kfm rvm bdk
cif: coo ark
ksw: kfz kuh rrf rhn rjg
bxd: bpd bmg cjk cxl cmd art aho
kos: rki rgq ruc rop
ktp: rcy rcg rwp rqd bkh bcx byf
kxv: koc rkr rsk bgy bwa
cmy: ahy
rqg: roh
acf: ahy
cte: acz ahh
kcg: kyj kvw kmf rrs rwv ros
ksu: ran rsw ban baz bhl
bjy: bsg bqz ckf cgt cwi cue
crz: ccn clo cvt ayk
kzn: rcv rig rlu rpo
kav: kgn rsi bhk byy byq
kbq: kgl kwk kum rad
bqw: crh cav cyi
rjn: bwz
ccz: cav cxo abd ahc
rcw: ria rgj rnt rfw bbr
bzs: cab cwh cqs cof
cot: aah
rtu: roy bru byk
kqf: rgf rjc rqc rqo
rro: rbd roe bwd
kyv: kzo ktl rji rez brx
rbk: bkn bbc
rah: rla rjd
bps: ckh chl cdv cxm cqk cqp
req: rxk rnv rqm
rer: bcd bgt
bny: bzx cod aka ark aax
cpr: ahv
bxq: box crw cvd cmt
knm: kth kuu rht rdr bhc bhq
riy: rdl
rrh: rdk bhh
raa: rvq
kwr: ksr kxm kqg rke rmv rng rqa rut
ckl: cnk aht
cxr: cpp cmt cog
bhj: bws
rhm: rsh reb roy
csr: csb cfj cqm coy
bry: bcp bly
cvv: csv act
ckb: cvw cxj aby aia
bys: bwq
bot: cix ced cmh cmq ard
khz: kvn rxd bbi bcw bgh
cie: ciz cjk csl cph
clg: cev cot aas
cbk: cpy cmu com aaw
rxz: rnu rqi bby
czj: abg acs
rqm: rux ron
cux: akq
rhe: rmi rqf bkv
rva: rnh blr
bjp: bpn bfs bzt bqh bou cis cwl cxx czc cuu abf aax
ckc: ciw cgd
ryp: rwf rxz rpi bkm blr
bxp: bxf bun cch cii clw cdi cjp
rno: bbe
cfh: akm aid
aaj: ahu
ksl: kml knz ktu rlo
byn: bwo
bqe: ccy clj cdq cmg czd ake
knw: kof rvi rxa rzx
riz: ruv
bsh: bfg bzn cfu cth cub cuh arr ahd
kci: kfl rxu bik byf
cmb: cmp abb abz aag
cvl: cxn acf
kdk: rbk rll rlw rlq rfv bay bis
kyo: kjw kvs kzs kqb rrh rws rpl
rqr: bke bwg
rpi: rzs bcm
kre: kgi ker rhq rgm rvk rvu
are: abe
rxi: bkh
cjh: cqv cuv
kmd: rjl rfg bad
clk: cja akp
cld: aks abo aak
kri: kzs kou ric rlk rlt rwc
cpu: aky arv ayc
cls: cff ctl
csf: ahe
cii: cpg aib
cve: akk ait
cfc: coo aaf
cdu: cpy cob aks akt
ctj: abx
rng: rth bhi
cdv: cpm czd
bin: bll
bjj: bmb cwh cws cer czh acb
rbx: rjc brh byc
kmq: koo rha rdf rnj
rzc: rzy byd
bpm: ckp cjw cso cfn
ryn: bwk
btc: cac clr cnx
ret: rts ruh blu
cfz: cfo cod
rtl: bky bbx
bzc: cid cxx ctd coh aaq
rxh: rni bae byb byl
kcx: kno rmo bah bag
rpp: rug
csl: abs aic
rjm: bco blr
cvz: cfa cfe aij
rob: brw bhp
rzr: roy bln
bum: cai cgd cxp cmk cmy
kym: kwb kez kzm rea roz baf
bve: bvu bun cqi arr aav ahh
cna: ard abh
rxg: rtj
kno: kqd rca res rpd ruk bri bld
bed: bfq cpz cfy ctx aya
rmm: row bgk
bcb: bgx
ksz: rlp rfd bbo bwi
kvo: kmu kqu kot rpz rth
kfd: kuk kob rap rat rzy
cpm: cos
kgr: kmz kti rck raq rja byl
bzm: bok cjz cuf ahk
btk: btj csf cqz ctw ctn aac
kxy: rak rng ros bkf
rmc: rmp rzd rqv rub roz
rnn: rtf
kha: kwg kjc kpw rcc rau rml roj
btx: boy cib ctc cus abf
bqu: cwe cjy csh cns ard
rsg: rmz rok bgp
kzu: rcj rho bre bbn bha blb
cwu: arq
rlc: blk bgq
kmg: rki rhj bbe
kjc: kvc rtd bkh
bdq: bea bfv but cxr cxp
rdv: rde rfj byy blj
crt: chf cdj csv aac
cde: cjy cfp abv ayg
cpa: cuf cow
rxw: roi bko
krg: kau rkz rrg rdp bkk
kol: rwj rog bhi
cnf: cth abk
rxe: bax bdk
cdo: cxh acf
kkb: rxo brp bww bwp
kfy: ral rey rpn brk
kfi: rua bwf
cyb: cdl cxv
ryc: rus bcm
ryu: rew rob bbg bcr
beh: bnm btc crn clw csr cfs czi
bpq: clb cwe cdw coe akl
czy: cul coe
rsi: roh bkm brq bcw byv
kiz: raw rdv rpk rom bre
aic: ain
bhk: bwr
bbl: bhq
kaj: kha rfi bkg bbw
chp: cde cuj
boj: chi cxb cne
brj: bhc
rlo: brc blv
keu: rcq ryf blp bwe
kzp: kqk ryn
rrf: rbg rbw reb rxl
rqa: bht bwh
kwl: kwx rri rrw rjp
cbt: cdv cmx cqe akm
bsb: bnj cwo cem abm acq
kop: rkh rgi rvb rfr bbz bll
cke: cgf cjg cpb
kea: kes rkb rzq bad
cym: cdo cse con abq
rto: rus bbb blw bld
cuq: ahu
kup: rli rgk bbs bld
kts: rio rdz
rwh: rue bcn
kyx: kqp rpm rnf roa rol bki
rpr: bhh
ccr: cat ctb cuj
rla: rfe bbs bcw byn bgv
ciq: cjw cnr cqt cqo
bdw: bxw bue bom ckj
cvn: cpy cnj cun
bti: caj cda cpj cfo czb czn ahm
raw: rji rsp rst biv byp bdr
rnb: rfg bks baz bao bys
kqb: kod rka rwh rff rtt
bqm: bul cbl cym
rut: byw
kya: kxs kuj rje rvg bhi
cjv: cjz czu
roh: blf
rcb: rat rdc
rjr: rss
kun: rfe rod
rma: rml bhy
rji: bkc
csz: cey cze ctx abb
bbb: bhe
crk: cyl cvi cfu
kzy: rek rqo
kub: rnt byp
caf: coe
btn: clv cfu aat
khl: kmc kqe raz rgd rpz roa bla
ris: rxk rna bay bir
rfe: bye
bkk: bhz bgb
krl: kgh kqd kui rjd rps rno bbs
bbh: bic
kyg: rgp rvi rfy rzq
cnq: aag
klr: kgw rej rzz bwj
rry: rix rjf bko bwk
clf: csg cql
bmk: bnz cqf aie ahq
rgp: bch
rpo: rtx
kpa: knv kuj rfk rfb byr bwx
ctv: aif ahi
khc: kpq kmu kzd kzu rca
kpx: kzc rpg rnd baq
cbh: cik chs cgi cet
rrc: rix brn byz bgk
buy: chr cga cqm ace aaa
bdu: bve bza crg cyl cgz cxl czz ctl abw ahj
cmc: ctk aag
aiy: ayy
ccq: cap cgk csg czr
clu: csi cuk
boz: crf cwl cjf ahs
rjh: rnp
kdz: kvp rcz bhg
csq: cmt cfv
kme: rrj rlw bra bcr bgw
rnh: rzr rzv bhw
cei: cpn cfa coj
rbj: rao ryu
rsf: rxp rxm bbl bdk
kmh: kfq kzv ktw rie rhj rgr roa roi
cmz: aho ayl
cyh: col aiz
bcg: blj
kde: kur rgf rey rff bcs
kcc: kps kot rto bkq
cts: cue
bkr: bas
rbc: rdw rnw rze brl
rwn: rdr rzo rtn bkc
bul: bob
cpd: ara
kic: rkm rfo rzl rtn ruw
knj: kqt rkq rhj rhp bbb baj
kdb: rco rac rwa rfr bwe
arx: aho
bxz: bmw bzt btf ckh cye cxs
akz: aib
kfr: rao rdm rfj bib
cob: abd abp
rhl: rgy rjx rsm rtq
byk: bwv
cle: cja cza
kbo: kiz kek kfz koz rbf ryr rtt byb
cdh: cnb cfm ctg
akp: aha
csm: cqa abu
kbm: kse kxt rdl rjs rxp rnm bar
kdy: ksw kfc rva
byh: bge
bvn: cio cwy cqi abq aiv aix
cds: cdx cfq
bfo: ckw cau cya csc cnq cur
crh: cyr cgo cel cua
rur: big
bfb: ckr crx cdv cxt aba abi ahl
kuj: kon rku rof
rvs: rsk
kbr: kim kvi rfm rft bcc
bky: bkl bgs
rhv: rdo ror bib
bhg: bhu bgj
cmr: abw
rnl: blg
raz: rqz
cxn: cfb cta akw aca aak
cby: cli ayk
cir: cto abj ayr
kbh: klb rrh rmb bid bhq
rdf: byz
bmh: bno bzo bqt cah cpw cmu cna cnt ctt cuq aam
bsx: cgs cgt cpt cqg abq aau
cfs: are
cdq: cjd cum
bmb: cjv cef cxf ctx akz ahb
czp: cob akj
cyl: cdv cjv cvi czh
byl: blg
ceh: cem cpq cob abx
ben: boe cyt clw aap
rns: bhy bhw
rtn: bao
bmj: cak cgm cpd acx
kbp: kps rkq rhp roq blq
cpo: cna cfg
bcv: byc
bij: blc
akt: aak
bjf: bus boy cgb cml
kxc: kok kol ryg rgq rjv brb bal
kza: kqs ris rzo rto bgj
kvl: rkr riu rsw reb bkh
cvm: csl coe
bsv: bsq cks cbh cvp
bds: bvk bsz clx cxr cmd
kxa: rhq rqc bii biq
rjb: bat
kqp: ray rhv rnx
rtr: rti ruv
ksc: rce rez ruo bau bij bly
knb: knn ryy rwo bir biz
kke: rsg rnj bke bav bld
bxv: bql cgp akj abi
rau: rlz red bik
czu: abn aha
rta: rou
kxk: kuo ret
ktz: rsz bre byo
kqa: rrf rqs
kyw: kdy kei knq rkx ryx
kcy: keq kqw ryi rod
cru: ccb cht ahr
knr: kfu rol baq
kia: kyi knh kzk rkm ryp rgs
kpk: kfs rmg rnk bgm bwz
kjn: kvc kvg rhw rtb bbp bim
ria: rmd
ryo: rpp rmu rqy ruz
bpf: btm cly cpx arc
rnx: rfz rqe
can: akb arw
bae: bid
cgm: cnt
cio: abs ahc
chu: cwr cdh akt aci
khg: ral rlt reu bkg bay baz byv byt blb
beb: bpc bmz cdq cot ayl
bzd: cbp cyc cwi ctt
cbg: czg aas aiv ahv
cyg: cpn cqx ard
rnc: bby
cqv: aba aii
rlp: rvu rxj rqi bgg
cva: cvd
rpm: ruy
bmv: chq clk cve cev cqb cux ail
rtw: rop bld
rmg: brk baj biu
cgn: aal
bzr: cpp cfb
kkg: kwm koa rix rxe ror bce bav bwl
rvw: ref rxe rnz
kwj: koa kod rjj rxa rpq bgj bwe
rmi: bah
kdu: kxi kur rcd rgz rnt rfb bkc
css: cpc cmq
cat: cse
kmv: rjt rxi rzh bil bls
bam: bwg
bmq: cxx cns ahu
bff: can cjp aib
cly: cxi
kjb: kzo kqs kqo rec bkm
krj: krz kdf koh rzc bbt bim bhk
ckj: cls cdh cer czf cqc
bbp: ble
ccp: csf cxz cml arh arw
rkx: rbo rav rfx
cmw: cnz cfd coh
rse: rxo rnu brn bcl
kjp: rxt bky brf bdr
bog: cym cwb cwg cek arl ahd
bmi: cgt cjk ceo ais
bab: byb
rvn: roz
acs: ahq
cvp: cnc aci
rks: rci rub rux blp
bjq: bme cfr cfz cti ahn
rct: rjq rsp rpz bij
krn: kcy kay kxp rcr raq rhg rlt rgp rjv
ktx: rrq bbf bia
bep: bxd bmm cgn czl
rfl: ruh brm bhq
ksv: kmm rqt bhs byq
cbd: cah akz acb
rgi: bai bhx bgo
bsq: bxi bxe bqk cap cyu csv
rsj: reu rtg rui
ref: bhk
rht: rmi rmj bdc
kry: kby kbs kfu ryw rdq rqd bir bwk bwa
rrg: rok bki bwi
rbd: bht
kgo: kda kxc raq rdk rxy bro
kjv: ksc knw roy bho bgf
kwh: kqt rcs rdo rxd rxt
cap: cqs cor cow cot abt
cyi: cpn ars
bfe: boh cpk czm cuu aaw aaj
kwc: ksd kov rvl rza bbh bah bhn
roo: bbu
kqm: rre rcx rhk ryw rgb rjo byi
ryv: bkw bav
rth: roz bkr bim
rvm: rna bgb
roq: bcx
rsa: rzy rqk roa
kii: kgq kwo kjy knl rsb rsq rpb rng brx
cyw: cph ctt abc
cba: cnu abt air ahr ahp
krt: kel rlv rno ruj bhp
rop: bhm
ktg: kua rcs rar rai rjf reb
rqu: bih biv
cni: arz
rjt: rxe byg
rjg: rne rup bar bdr
rcg: rwj blk bwl
ker: kfl rim rsp bin byp
arn: ahl
kfz: riu ryt rwm byv
ccc: ccg clb cli ahr
kkx: kpb rpj rqj bkl bri
rjy: rew brz bba
rzs: ruc
bsl: bsp bnx cvk csa abu
cck: ccb cgi cpl akb
bud: ckn cch ccd cyq csa coy acu
brx: bac bav
rao: rib rjb bhc
rlb: rlf rmq brm bdb
kcj: kif rnu bit bhd
cnj: acw ahp
rlh: rvo rtv
boq: cab cmq cux
cjp: czt ctk
cvj: cxc cnk czc aku acr
rqt: byp bgk
kpi: kfe ktk rkm rws ruu
kgy: kmy kng kfg kzw ktx rrl rvr blx
rqw: brv
kxl: rrz rlt rnm rom brg biz
kzh: rba rae rwz rxb rpf rqi
rio: rym
rep: rnt bik biz
kdx: kqw koe rit ryt bkk bch blj
kqi: rkp rrb rgi rjw rvh
cuu: cor
chc: clr clx akf
rya: rfx
chy: cyw cyv cne
bpn: chu cdp czb cqv akn acx aig
kku: kbr kxi rbd brp bcs
cqk: cqf akq
ctr: ahi
bqj: chs cyd cye czd
bzh: btd btq ciw coh
kex: kxv kpl rws
cjo: csp cpq czo akx
bdd: bjc bvw ccx cix aav ayk
rpl: ruy
cic: cmp
cny: abu ahk
bdg: bvr bqz bux cdt cza ahb
cjq: cmf cob
kvn: kna rge byj byq
rgj: bgo
cll: csh aag
khj: kzw rod bku
cgj: csh cee ctf arr ahu
kuf: rwz
blf: bwy
rxl: bad bgr
koq: blj
rkd: rxb rmi rny bhm
aru: ahc ahs
rjl: rsr bhf
arh: abh
czt: cuz aaa
rpw: rzi
kli: rjj rxo bwm
bne: bfz boi cbo are aii
rlt: rpg rob
rqf: bgx
rhc: rwy
rdq: byv bgc bgi
rew: bbt
rpv: bgw
akg: ayc
rcn: raj rih rsf rpo
cpb: aaj
cdc: coi
ktr: ren rot bbx byn
cbs: cao cit cuz aai
cko: cro coh
rhh: rtx bkq bcx blt
abs: acp
bfs: cak cvb cnq cqz cov aao
kpn: rbu bcc bih blr
kfp: kqj rrw riy rmm rqi bia
rsl: rqw
knl: knw rny rud rup bgi bwc bwy
brt: bln
bme: bfk ccd cif cvd cvj cqu coe akv aag
aar: aya
kyr: kpn rkf rwk rww rel rfg bri
knd: ryj rgj rer bal
koj: rre rqv bkz
bvz: bmx bzo cfe cfo ack
rhx: rmh
cil: cyj cxr cpj aih
bnf: cca chb cei
rwy: rqv bym
ber: bqx cym col
rff: bbm
aaq: aau
bkn: bgc bwr
rdu: rxs rmx bye
rue: blu
kgn: kov rwz rzy
rbm: rcb blt
cyc: cvr cee cxh ayh
brg: bad
bvs: bxj cki cci cae css cmm akb aav
bpj: bpm bpf cbt ccl clr cpx cmk acz
bfn: bud cbk cjq acl
brq: bwe
kxe: knd kqn ktf rld roq bkt
bkb: bbw bcd bdk
kns: kqj bry bcw biz
brd: ban
kfq: rjc rsz
rms: bao
khn: kvc rwq rmn brk bhp
rzu: bym bgv
rgv: rsr rpa rfn
akk: aay
kcp: rre ray rxm rzg brx blc
rdp: rvr
kwk: rpd rnd bye
kqj: rvy reg
bou: cbw cnb arv
cxm: cty aio
kyc: rgp rfl brv bbb
cxi: ctz akp arm ayc
kow: rkj ryc rxj rmi rqp bgd
kju: kft rrk rcr rnv
bll: bgh
rmj: brl
kbk: koz rpf bku
btq: bul cnu cno
rca: raj rga rjz rvw rxu
ctx: akf acq
ccx: cli czy
aiq: ahi
cff: abv ayl
aiz: ahc
acl: aax
rcq: rxx rmk bkj
kxs: rky rij rfq
cgy: cgl cfk
bdl: chi cmh cml cuv coi ace
knn: knt rby rzn
kra: kld kde rlh rxz rtr rti bag
czh: cqb ctj
rou: bcv bwa
kpl: ris ryg bik
ras: rxb rqa rtz
kjj: rdl rpp byq
kwy: rbg rio rsl run bbf bap
cgk: cdz czk
kpw: kqj ktp rke rbe rjw rxx
cyk: cxy czg czf
kax: rge rem rux row
rpf: bib
rxy: rpp roe bkj
rbl: rlb rwm rpa
rjx: rny rtc bby bbs
cdj: aip ahi
cvq: cec ahm
rii: rde
bml: bqc cpr cmj arc
ktk: rgu rpm bwe
rez: rqi rqw baj
cem: ctm arj
cnu: acw aid
klu: kwy kef kpb kfl rll rwj bry
kyz: rwr rqj bkb brq
rgy: rsn rms
kbv: kji kpl rig rwd rjl bru bbv
rtj: bca
bra: bas
biv: bgn
arv: abw abv aij
klc: kew kor bar byo
arw: acw act aip
coh: ara
cbi: cbv cdq csr arq
cme: cnh cng cfe ark abi
bdj: bde bxw cpr cfu czv ahf
rba: rbi rln
cjs: cxm cfw cqn
rmu: rzi
rex: rxm bad
rzp: ruf bax
kgt: kwq ktt ray rlm rwz
car: cab cza aid
cpc: aht
bja: beo ckp cma are acx
bsa: bzg chd chv cyr
cul: abl ayi
crn: crz clg com coq
khf: kya ket kxu kmf bkr bad bwg
rjd: rfa ruo
czi: cux cuu aam ail aya
crm: cct cic ceo
akx: acg aiy
cwt: coa aam aid
rvl: rxc rte bge
chb: clb cjl cua aah aaj ahb
kgf: kpb knx kqt rkx rdp rjj bik
ksa: kpv knt rcc rgr bij
brb: bct
btj: buh cai chd cqw ctb
cjw: cex cmx czv cqy akr
cyf: cvg cnp cnm
kot: rhh rvt rem bgt
krp: kdm kqu rvy rff rzk rot
rdk: rzz biw bhc
bxt: bzu bqp cre cys cvc cve cmv ary abb aat ahu
col: coj
cqx: cta cok
clh: cec czx coi abp abz aad
kkr: kdg rip rly rzt bkf
khq: kda kjo kod rlz rdk rmt
rsp: rpk
bsk: bsv cag cir cgt csm
kkm: kao khn kyn kud rhf brr brb bhq
kzm: rad rio bhi bwf
clm: ctq arb
khx: kvu kti raf riy ryl bgj
rhq: rwc rew bwb
bqc: csj ceh cxa czc ahq
ktn: rrf ryl reo rxh
kzb: bkh bib blz
btz: crr cya clb cgg
bvq: bmv bzy ckv cdw csq
rxm: byq
cfj: acl
cmp: cno
kmp: rao rlf rnp rza
bvy: cwl cxq cpn cnt czx
ktj: rkm rgu rpx bbc bwl
bkp: bgh
cih: cwx cvm cnp ctl ctx abg
kio: rcr rnj bkp bko
rmt: bwu
rmb: bcz biy bhd bye
cou: arc air ais
keg: kte rmt rnn
riv: rhw rsl brb
bnq: cgm ceb cui
rav: rez rzq bhj
ckr: cby cjd aib
bsj: bsq bmq btg cmw aks
kjh: rka rrv rcj rtp bix
kml: rxe rua
cdp: cmr cfa cuz aie
bdo: bmy bfr bzu cgs cuy akb ayg
coq: aam
bde: bdn bvd cik cdu cjc cxm ahd
chs: cdx
cdl: ctl aci
bia: byx blt
knh: kud rpt rmb bbi bly
cbx: cvb cxj ars
cdi: cec cxb cxg aht
ckq: crt coa cox aip
kzs: koe ruk
rqb: bct byd bwu
rzv: bgt
baa: bgh
aby: abp
rmp: rzn rur
kja: kjg kvo knz rgd rop bbh bcf bio bhm
bec: bqt bqu cpj cpm akw aci
cvk: cvo
rpb: rzf bra
kpz: kts rbx rys rfs baw bgv
kel: kpe kmx ktq rht rwe rxb rph rud bau
ack: aiq
rrn: rit rma brh bch bhu
cuj: coc ain ayc
ryx: rmn brx
ktv: kto kof rgp rdk rxv rfz rzt bko
rir: baq
cch: cds cox
bbu: biy
klm: rfl rzo bln bge
bjk: bvc bqs cer abv
bqg: bqm bqo cem cpy coz aiw
cdd: cxn cod aau
cjx: cvf cfi akx aby
cxd: cuc acm
cje: cju cxk cml cnn akc
kqc: rcy rlc rgw rwo blf
rmo: rza rqg ron
cbn: cyr cwx cez cet cpq aca
rlr: rwm rug byz blo
rxd: rzs bip bgf bgz
kig: kjc rpb brf bcy bgx
kbe: kpw kuk rkf rgh rqi
kni: rrp rhz rgr bkl bhh
kvx: ktq rkg rfy bkw
rqn: bgo
blu: bgv
bux: cxm coz
kru: kck kgm kgt kmo kto rce rgb rvr rpn rzh bch
kkt: kid khh khj ktm ryb bld bwm
boc: arj
kbf: kvo kux rey reo rxu rne rfy bwu
cku: ccg cdf cei
cus: aan aht
bcn: bld
rjk: bke bbx bcy bwf
clx: cmi cul
coo: arn ahl
cwb: cfp
rsy: rpg bhp bgl
kzx: rsi reg bco
cyv: clo cgm cwh cwf cnw cqb cqc ahc
bso: bea cyd cjt aah aap ayl
bef: csc cpd akk ari
kse: knl kzj rma
aki: aar
kgi: kvx kqk rrs rqz bwo
bvh: bmd crs ciw cgx abe aap
kix: kec rcs rvz reh bgk
kdi: kvp rbb ryn rst bas
kqt: kts rya rja rvf rox
cbu: ccy cho cez ako aaf
ksy: kxa kou rak rmp
rrv: rxj rzk bam
bdy: bdz ben bpz bth bue ciy chj cyd arm
rrk: rej rxg rpo rzq bhi
rxq: bgr
cwa: csh acy
bof: cbq chs cnd czc aar aaa
rdg: rnk ruv
krv: klo kgf kqz rnl bch bgb
kte: rbw blc
cvi: cvh acd
bqn: cla ced cnq
bqo: cyi cly clu ahf
cow: ayy
kzk: bak
bpi: csp acc aax
rfv: rzd bah
riw: rna rzj bhs
ren: rxg roj bcy
bac: blq bwg
cag: aim aya
rfg: bbr blr
rkq: rxr rps
ccg: cyg cpu cub
cwh: cst ceb ceg
cuw: aii ahz
krc: kcn rhy rqy rqg bbo bho
cpq: cfg
baw: bla blp
czr: ctb
rwr: rzi bgj
cfb: czu cqi
