cc: cg ce cx cm cf ak ay al ag az
ad: am aq
ko: cd
kp: ra rf bk bb
ck: cb cy cl cj cx cm ct ac ay ad
by: be bx
kb: kc ka rz bv
cx: cz ax af az
cv: ac an az
bz: cc cs al af
cr: cs cx cm cn cz ay aq
cq: ai an
ku: rd re rp ba bl bd
bf: cy cl cj ak ar an af
bu: ch cl al ae
ry: rz ru br bn
ak: ae az
ar: as ae ap at
cn: cu ab ai
rl: re rp
kq: ku rr ri re bw
kk: kx kq ry rf
ro: bb ba by
bg: bd
cj: co aq
kz: ru br ba be bm
rv: rx rf bc ba bv
rz: bi by
am: af
ca: cd cs aw ax
bv: bx bp
cz: af
rj: rf by bj
km: kz ku rb rz rq bl bm
ks: kf rk rf bj
rg: bb bl bp
ky: kg kd kq rr ra
bx: bm
kj: kx ko rg bh
ap: an az
bp: bm
rp: bp
cw: cs al ag as
rx: rm bj be
kl: ko rr ro bc bi bw bd bj
rm: rf
cy: cv ab as
cp: cm cq ct ar ab ae
ce: cf ab as ae
al: az
rf: ru bj
av: az
kh: kp rn rt bb bh bj
ki: kd kf kt rl rg rd rn
kc: ke kz rb rn rt bk bp
ai: aj av
cf: av as
co: ak aa al ad
kf: rh rj ba
cb: ca an aq
kr: kb kl rg bi bd bj
ah: ag
bd: bs
kx: kq rk re rt
rk: rb rp ru ba bl
bh: bg bd bs be bm
rd: rz
ct: ar ac ah
rw: rj rm bk
kg: kj be bx
bb: bw
aw: at
ra: bk bc bg be
kv: kq ko rg rv ba
ba: bs bn
kd: kn rd bm
aj: av ax
bn: cm
cm: cf ct cu ab al
rs: rq bx bm
ae: ax
ac: aa ax af
cl: ar av ap am
kt: ku rk rh bb
bc: bl
af: aq
ri: rh rp ro br
re: rx rt bg
bj: bv
bo: cr cm ai ah ad az
bt: ac ah as am
ka: kl kd kx rh rw rm
ab: aw av
bq: cc ch cw cu ac as
rc: rm rz bc ba bp bn
cu: ah ad
aa: ah aj am aq at
bk: bd ar
ke: ku ko rr rh rl rn bw bm
kw: rh rn bp bn
as: at
rn: br ba
cg: cz ak am
bl: be
bi: bp
cs: cp al
cd: cs co ah aw ax ap am
ru: bw
rb: rv rm br bn
br: bv bs
ci: ab ay ax an
ch: cl cq co
ag: av
kn: kt rk bi
rq: rt br bx
rh: rs
