id: iv hy he
kg: kv rk rp br bq ci cd cx cf
ba: bj bz
as: ik ia iq hk hh hl hw
br: bx bq
kp: km bi cd ce
aj: az ig ij hk hx
ia: hi hl hg
ks: ko ba bn ce cn
az: iv hk
rq: bi bv bx bn ci cm
bn: cy cz cq
rc: ro bi cl cg
af: az iy it hn
bk: bc cg cj
ar: as aq hj hq
ie: ip if iq hk hc hx hm
bs: be bu ca
iv: iq he
ip: im hl hg hs hn
ih: it hb hh hu
bv: bm
aw: iw hl hj hu
bi: bf ch
ij: iz hl hd
il: iw is iz hn
au: ii it hh ht
rv: rn ro ck cv
ro: ca in
hp: hq
rf: rq bo cr cj
rj: rm rq ru by bw bm cc cd
at: ic ij hg hp hu
ab: an af ia hc hw hx hn
am: ix if hv ht
re: rz bx bm bf cc
hk: hr hv hx hq
bp: bt cf
kj: kt rn ru ck
ao: is iz hi
cm: aw
rd: rq bl be ca
ir: ih ig hi hg hw hd hn hf
km: kn kz rt bj cs
ka: kg rk bj ce
kh: ra rx rp rq ru be
ah: iy im it io hb hq ht
ax: ij ie iu hr
ap: au id is ip im hy hv hn
bf: bt cl cp
kn: kt rm bb by bf bz cs cf
ai: ah ic io hx
ad: aj ij ip ha hg hf
be: bf
ra: rx bi bv bq cd cv cs ic
hj: hx hf hu
if: io hg
ac: af ie ha hu
bh: bw bv cc
ay: ag an ic hx
kk: ka kf rs rx ru bb ba bi bh bn ce
cy: cn
ke: rr rw be ci cv
bg: bj bx cr cb ch cw
rs: bk br bs
kd: kv ku rg cb
ca: cj
rl: bl bd cw
al: ax ap aq hj
ru: bc bn ca
cv: cx
ci: ct
rx: bw ck cy
ae: an hb hg hq
io: hs
ib: iv ix ip if hh hv hp
kc: kd rd rj bv cb cw cn
ki: rb rc rw bk bf ck cl cd cs cf
ku: ra rl rm rn rt ro bd bf bu
rh: bi bj cm
hd: hx
iq: hf
ix: ip in hb hm hn hu
kw: kq rd bi bu
bt: cr ch cg
bx: cv
cj: cp
rt: bo cy
bc: cz
av: iy it iu hr hg
rm: bo
cl: cp
cc: ci
iu: io ha
kz: ri rz ru bu
hw: hx
rr: rn ck
by: cg cp
iw: ha hl
rb: rc ry bw bz
bb: bg bx
bl: bx ch cg ce
bj: ct
is: if he hp hf
kt: bc bd cz cq
it: iu hk hi hf hz hq
kl: rk rg rs rt bm bu cg cw
an: hu
kb: km rw rx ro bi bl cz
hi: he hm hz
iy: ix
bw: ca cn
aq: id io hm hz
cu: ab az at ao hr hb hc hh hy hn
hy: ht
ak: ag au ia id
ii: ij ip hr
aa: ay ad an az it hc
rw: rz bt ca cg cf
bq: cz
cw: cq
ko: br bc bz cb cq
kq: bd bt cc cm
ag: ic ig iw hb
rg: rv rs bz bo
ri: rh rw rz bd bj
in: iu hi hn
bd: cj
rz: bz
kr: kj ke kf cm
co: ab ad iw iv hy
rk: ro be bp bt cd
ik: hb hw hj hz
hr: hb hh hf
kx: kf rk rr rn bn cf
ce: cf
bo: cj
kf: ry rg bm
iz: iu hc hs
ic: iw is
im: ha hi hj hs he
ry: bm cw ct
ck: ca ch
cp: ct
rp: rf cm
ky: rh re bh bs cx
kv: kt ko rv ck
cx: cf
rn: rq bp ch
ig: hd hf
bm: cr
cb: cx cq
