byp: cle alf ibv haa ylb yqx
drz: dxi sbi evj xxi
ilz: yae liv
ygg: lnw lul
bzw: cxz aov yfm loa
ssx: edz ezu
hgl: lqu gla gjl
rtg: btd hcw ydv
kuj: rzr alz aqi huw
bji: cip cxp ydi ltj
rcg: aie yvs gcw
vgt: stc
dus: dow jol vhg xay xxr
gkt: gsb
vtp: vos ssm eha ehz xug
bem: cxd imz yhi
jhn: sbd shr sqz xjt xxa
xiz: xlo pkz
yfl: lkz lhc
byw: axd igs iof yuf ggb
ilx: ipv
bqm: cwb cth hjk gem
viv: vsa stz xwm xsx pkj
sgz: sns enf eze
erj: esf
iwv: hpi yxt lun
egn: euv
bpq: cmb azb hdq lkz laf gvu
iik: iys ify hjo ydd
dnd: jai jwd jda ewv
clv: asp hwt hzh yog
hhe: hfk yux
aer: hvi ybr
lxq: gjq
xtc: xuz
dlk: jhe vil vhf swx
rrz: ivr hcl hvw hmj hfg
hvg: ywl
bti: clf ixh hiy hjk
sid: eqd xsi xph
etm: xjf
atk: has yhl gga gvp
atq: yra llj gac git
yct: lag lyf
biz: bps axj hgc lfv
kan: kik ibd lxm gwr
yiw: ypy let
bao: bqj hsw yfy
vqh: szk sqa efe eqj xav
vzd: swt ees xam
kfk: rpq bgh iyj igx htt
wyi: dpq dtc she sup esg
jig: vqh eyu xap xyg
xbk: xxl
blc: adt ilw hcu hmi yhr
wnd: wqy dvp vkx vxt egf
yas: yqa
ikc: iku hcc hyz lkq
gqa: jki vxc vxq sea spx xuj
lad: lsh gbr
bwu: iqh hjp hmg lyj
exq: xhi xfc
vta: sgx epj xro
wmt: wqq jiq xpv pkl
eva: xwb
jvb: vew slb evj
yau: gss
bah: bgq adw hck lim
azr: igp hfd lhv ltu
ika: ycj yvh yqm ltq
vpq: equ xzd xqx
hnt: grs
jdb: eux xmy
vvt: syx ekb xhz xwa
elj: xkx
ygy: lco
brh: cdw inq
ykz: ydi yxw
ixd: hkx
eom: xek xos
jmz: vzm sjw eks ecl xry xfn
wpv: wfu erg evk xdt
wda: dis jng jqh ssi esp xxr
dtz: jdc vwy xpx xum
aan: ael lbi ljx lpa
cgx: cgf ifn hrv lxa
jou: vht eig
imo: hay lgh ltk
rps: bul cvv asw iok ycd
asa: lzk gcq gph
bps: cmw agn axm gsp
yge: lgy gyg gps
ibg: ynn
hko: hol ybu yct yjq lfj
kpc: btq cyu cqg anr lms
dtd: vle sus evb
esj: enf eul xai xyt xjk xta
ahi: ikx hwb yxc lch lxl
bzf: cvz agr ixg inf
iom: hby yqo lyf
rgn: cgi cdo ail imx hyg lgs
dbq: dty jjd jqx sqs
cww: cvo huv yum lsb gai gjx
jez: jxl vwp scf ssc stx epk xdg xjr pra
jsp: ewh xot
dqm: jbt jaa jfs xhe
vyf: eei
vsf: vte xxi xqf pra
ilh: ywl yxu lvu gbf
kfo: cdg cmy cnt iqv hua gbv
vsu: epg
rms: ane isi yus ged
wpt: dxp jlu vve vzl ste xzc pcl
kvx: kxd cvb cob aoa hnx lip lho
yqp: lic lsh gyj
rwh: bmn bqv cjs
hxl: lha
kyv: kon aoj huz yrf lpe
ynh: yqc gmy
sag: eaw xsq
ico: ykz lbk lbp
yhc: gjz
bgs: cyo ceu aay ine yno
wlq: jzf eko xsq
heo: lix luj gxz
her: lvk
rou: bwi amf ylg
vev: ewv
rbi: rpu bvj aip ijn iug hyn ggn
bnc: hbz hid hvp ytc lst
jbo: swt sou xxf
iof: hyo yff lxj
coz: iyd gpl
stl: eua
vnk: snn xxs xpp xnp pbi
kwb: kfj btz cct csr gwz gdw gdv gpj
cuh: ibp lzl
shr: elv eqj eoa xgy xns
gki: gpq
xui: xuv
ica: iwn hdb
whj: dyk jky jtu vkz vfr sys xxv
rqk: aka izw yqt laq
yio: yok grr
hfc: gpl
dhb: jvw evl exq eot xfw
rjt: rze bql bqv agc iww lmu
dcv: dph jsy jej eve
rqr: ccf irp lqa
bpy: cyo cnz atf lct lpt
ljj: gpz
htc: ycr lkb lxc
xgd: xuz pbv
imw: ine iuo hiz yqu
cjm: iqh ldo
wks: vrf vuy sjr spp sfb euf xid
dvt: vgc vvl xlc xec
rqq: cey awk ytn
efc: xjz
hti: ggx
sil: xju prg
dml: edl xit xep
ybw: llx lgv gyu
gnq: dan jll jqd szo xro xga xwf
wmb: jwt srh sec seo enb xoh
ijw: hqi
cuz: ift iob lrn ltb
lsk: gkd
xkn: xiv xzo xqc
btm: aic aef iyp hjf hfe llv lny
jmd: vkf suy xhm
lel: lpg lmc
cze: avu ieg hiu gke ggu
gau: gip
kpo: cqy aro aev isu ixr ler lql
veq: etu
wuo: dim dnp vtd
wjk: jgq jsh jft vbu var vao vhf vli vgs svt eht eos
hnn: lqo gaj
ahw: ibj hid yhe lmo
ksm: ins hrh yfj lvb gvq
lqy: lta gws
rvc: bml cam axu aqj
ady: aqq hfh yyr lij glj
kaw: bpm ckh adj ina yve loq
kis: kya bnp ccw cvb ihy hhf hzi lif
bcd: bho iqg hsl ypa lpg
hei: hfo lrg gjo
vdu: vzs
gzh: dgk dno dog jii sat xzn
wnt: djh deb sba eip ehp eyl epr
cnz: cos lnb grf gmp
hia: hwk lwk gjo
ath: iho iox yuo yoa glx gjc
esd: est xdl xzs
rdj: ccu cgz cgt abr adr iji hyh
klz: rjd akj hsl gkh gvg
irn: idl hgf gck
iok: yxa yty
iku: hlf ysm
ehg: esj
vcr: ern xer xnc
jvl: shk smi xmg
kvi: bya ior ymj yqq lpe
idk: hgu ymm lal gpb
erk: eae
gbn: gip
cly: abr hya
wkg: viy edy exl ems etx
kqs: rtm cfv aau yky lth
rcp: rzb bcq bld azt hhv
sgw: ekz xww
iww: ggm
hkr: hhl lqx gpy
jqm: ekm xkm
ldb: gjr
bbg: bhn cnn hhu ytm lcq ghk
crr: aqj iqw yps lag gkh
krc: bos cyx iah hkj yce gbu
ilj: hcq hya hds lrj
vet: soo
wyv: wow dck dzb dta jrw vxo vnk sor
vct: vpy sdm efl xzf
ruw: awj azx lyk
cfk: ypf lws ldj gcx gxl
bte: cwp cxt yil lwe
ltm: ghj
kjp: rek rqq cgn anj yqe
rxl: cwz aby avw aqb ili itd lkv
sje: xve xxo xno
dwn: vkw enp xvs
bko: bvn bnv iko iif ihv gjt gsn
ihd: itt lvw gcr
dqj: jho jyi siq ekt ejw
bsb: ayq hpe hmq lpt lui
spn: evg epi
jkg: jyf jqt ebg eza
jpo: vap vom ssf sxd efg
cpm: cpz itx laj
syj: sli slv sno xxs
gtz: dvp dse dfr duw joh eku eug xbj xew
gij: ggv
bmp: ipz
goj: wuw dxq jkk vkb sxg ewc eob xbt
ctn: his
leg: gsl gxt
ael: aqw hoo
bij: bts anv iko ivu hgu lbf
yqt: lpk ltl
vrl: xke
vuq: sdn sph exh
dfq: jvu vsi skp eca eqe
ccb: agb him hyd ykr lfg
cfd: atm yiz lnz
sbw: epk eze etn
rkv: bgt bqm idg hqb hov yfg lmo
bhp: ypq lyg lsm
icb: ler gwl
xhd: xyp
wuq: jxf jfb vpj xds xmc
coe: aod hrg yhg lvi
hfs: lri
xxm: xxn
bia: ckv iyf ivp
jqx: vnt vfe suc eij
whc: whq wof doa vik vlr vvb vep ely xgq
rlz: rlt rxb cox igh ytw gyj
jkq: jic jjl vcv xez
gzy: gzw vcg svb xaq xfy prp
vft: stx xyk xsi
kkw: bnw hjl lue lok loe gyk
kjj: rad cpu aqb lke
xvl: xqh
yxi: ger gpg
krt: aky ifd ycb ycz gir
ykp: ygx
dnl: vbu vjy swh xcq
wpz: jcl sgq spx xvv
bxn: yjy lro
syn: ekn edh eeo
khy: kna bds cba izd yyd glq
kbb: kdb kxh aif
spy: soq eyu xfe xqa
deh: vgd
rzs: hru ykm
gff: goo wwl dkf dxp spa elw ezn
jyc: vtr erq eix xhf xlg
bio: bng ibg yxx yqh
rjx: cha cmr ams hbc hzd yyl gbv
hhp: yog
kxq: rto crj cen cpl awy icy hvg
wjl: dkd ddq djb sbf smq eap
kbf: kig rhk rtr byf
eqc: xen xoi
wzl: vme szo soa xcw xac xja
ctv: ahn awg aqr ifk hst hud ysc lrz ldd ghu
cbn: axr ywn
eqd: xcr
khh: cnv iyw iss hym hoh
hbj: hhg lrc lbz lhu
eyz: efq xpn
dft: jzx vwi sjd eay xkz
iow: hbt hep yjq llb
ayu: ipm ipn izv
jtj: smd suk xmr
rdm: rpk bfb aeb yel gkj
dkd: jls jxe scr scj smn
cty: awm iwh lbh
rum: aqx htl yft yth yoi gsw
bmw: alk lso lns
wxg: dre dvb dtr vlv spb ewm eez efa xdn
jdd: jxh ehw xbg
jvo: jqg vap scl slg
wab: wep djg dtz jbo jpf ewo euv xyw
swh: ejt epm
bmm: atp iar inz iqf lhp
kfh: rnq roe hye hyu lte
cem: cnm ylm ymv gya
gqq: wkm wvf jef ejr exl xwr xef
axv: yzg lds gxu
rji: cbj civ adl ipr hpn yih ggj
bnj: cym cdp ceo hjm hsh hqn yea
cjy: awc ixj huf leg
hlk: yya gds
ycm: lcd
sao: etc xmc
xll: xlm xgs
kqw: rbz ryk cfo hqx yas gsr
lqm: gwu
iwh: hii
ayc: ilk hni
jnh: vhu vyc vxg
eco: emd eur
ets: xmb
hch: hqc yfw ytl gex
stz: esg xzi pcr
ble: btj hcr
gqw: dxw vvt vqj ewx evy epq xrx
rkt: rmx bqc cgg ijt ixd hwk hui yot
wzj: dxm sax sqc efb eoj xtu xoo
hqu: ghb
jif: jgv jsq vcy vpk xhv xok pko
yth: yom geu gxw
jks: juj jon sed xfg
cae: ayq agz
ais: ade ixy liy
bvh: bxg cuy hri hdx yas
bfx: ctx ikb iyk ypq lee
inn: yxf lwk lna
lwn: lnb gjs
edp: xwl
aqr: iys yvo
cku: axa ipm hsf ymv gpj
hto: hop lrk lth gbr gev
wvl: sgy ebv ehm xbu
wlx: wpi jkl jhx vlr sai ejm emi xun
goz: jtd vac vjs sys sjd edo
wck: wfh dxv dtt jcm vlg xdj xmj
rug: aad yct yed gcr
bab: lcr gkt gsz
kpr: boy hsj
rqp: bah cql ctf ika hfz ggx gpd
hnc: lbr
kzs: cun adf iwz
cqy: aar aej hdd
knf: bby beb bqx iep ylq lem ltk
jac: jqn vao etu
win: jcf jct eyj etj
wpk: dim dsq jtq sjw spj eld eeq xgw
xiw: xhk
hfa: gap gyp
lkc: lab
szs: ecx eht
jpq: vxa xvz
ypo: lkq lsd geq
shm: sve egu
htn: ydv yva
swc: svt edv emr eff xyt pch
xzp: pbd
yui: gbp gwz
ydm: gya gdb
ktp: ruy bxd isz yic lkt
kzt: rqg adk lgd luh
yvl: ltr
ics: iuq ysx gap
sot: egz edz enb
lrm: gsm
ayf: hts yjn yfr lgn gbn
bzr: cpb cnf aea lnf
eqi: xgw xxd
alg: aot izu
iuz: hcj ylb ytl
xxj: pky
ryy: rdi isa ltn grk
krk: kot ahe iax lqh
vjc: vsg xkv
hut: yru ymw lxs gcq
kuc: bvs all avq gcw
hzq: ytm gkj
cgj: ier hcd hhy hvn hvo hpk lfs
ccm: cyq aon yyf lzx
rlk: ckg awe ajr
vgy: vgs swi xdj
sxn: xgu
bxp: hcx hmg
jau: suz edn eva xus
bvx: ahl iej gpy
jyu: vlw vzz egz ezg
rxm: ash aop ibq ihc hqn
jkc: jdr slo sud eef xqb prh
itl: iof hio yry
rbp: rqr rox aqq igh
dpn: jyu jsj vpl swc xem xnp
vea: vtw eng ezd xuk
hlq: hnb yhu yge
gfr: gzi wmv vbo vxb vxq xkj xih
hhj: lhy
aka: axp hkq
yvr: gpm
hma: yyd lrk
vpt: vqb sjx emp xca xal xdm pku
rbo: isq ipj lsc gbv gda
cyk: asg itw hjr yxa ypf gmd
ypx: lsd
ybs: glu
vcy: vta sjh ezp
rnc: cqy akt ira iwb ivq lsr gib
vcc: voh efj eow
anb: ycg ycq
cbh: afz lan
had: hyd htu lzs gjc
rah: rul bss bej arv afk hgi ljn lfx ghh
kxh: beh bmt azd iwc lik
eoz: xql xoy
kpe: ipk iuh hiu yfd lue gpu
jgp: eel xsh xxw
hcd: hcv lub gdl
vub: sgl xhh xle
hyv: hvr yjo
cxz: aiv ibo ijb hkk hta gay
iyz: hcy htm
vvj: vpu vqt snw xjw
adm: hsq htv gwi
afa: irg ywt
var: vzx eor
bjj: bfz cin aao aoq ipb hrz hbi ggt
gvx: gxa
hbr: hie hth ywq lfy
ror: cin alk iap ykc
ajd: ytl gyk glz
rnd: cks abv hdh yql
ynu: lwh gcv
wns: wqt dgu vjj eha xsa xpn
kzu: ryz bvu cqk adt itf llw
arg: ida yjm git
iab: iir hrp ybd yfo lfy
ivn: ixz hdf
jqd: vlt vqw sig syf stg
jsq: erq eah eqa
rgy: csk cef isx hco hqi yrv ypj lrc
xqt: pky
abn: asr hap yrf yao yyo yuc
vrq: sbp sec eak
ksx: kon rvr rxi cqp aey grh
rin: afv lwh gki gbo
dvw: jne vxn sxm xwj
klt: rsy rsm bmi ywi lyl lmw
hat: lbf gxj
ltg: loo
kmm: bir cth las gch gac
vwx: vwu srb
ddp: dqh vgz vvn svy esy
dwh: dff jwo ssv szq ehu ejy
apl: yxs
aek: amw ame hqt yri ylt
hhr: hyu hdu ydb lep lft
hpn: hfv
sew: prw
bbr: iae iea hps yhv
vee: vxt eej xmg
bcs: bpb cel azf aqp hrp yyh liq gcs
iry: yjk lzq
rix: rgi bhl cwd ics hqw
dtl: vay evt eff eus xvf
dym: dzt vtt swp xdx
iby: hsg lml
wrw: wht dst dtg vrh vtb
vkw: ssm egz
ijj: hph yjb
csy: ieh yth loe
jgz: jji viw ekx
aui: yrf gae gvh
ipt: ghv
dea: dnt vko efq xde xvw xms pcs
ygw: yus giy gyb gwt
cfe: igz ipg glk
asz: amu ici gdu
wrv: dhx jau jyw xrq xfy
ajr: idp ivl lxg
rbw: cia imn hbc ynq
ywu: yze
wyt: wtg dcm jdm emy xlu xpg xti xtv
cjx: cfr adt hdv ynk
idu: yxb lwu
djp: vab swh xnu
wci: wtg dun vhi vym vxx stl
wun: dbh deh jmz vrm vqi srd slp eqw
yyr: gxk gpr
kxp: rdv ceq aah afy yal
isk: imm
rxs: bvo acx hbi hbq hov lkd
chb: akf axj atf igr
est: enb xcb xpa xmh
lqs: gja
rre: bfd cpm cqm aln ips hmr yia ywx los gwr
jog: vqc scq xrz xoj
lgd: lpb
vnh: egc ewf xve xxu pbc
siw: stx exs
czt: asz isb hmo yji
aks: ark izp hil
vyw: vgr shw ejb
cai: cfk cqb aet
cel: yal ljb
bkt: afm ylj lre lln
wfy: juy juv vmm ssa elt xcb xgh
wqf: dxy jbg jip xuq
jum: sgx ecn elb ees xgh xwn
ehz: xcg
jvk: sjw ssr sum xgv xug
vxm: vpo slc xvl xnt
dnu: dzb dum jji veq vxv ewo pkm pcv
let: lql
kcp: kcu kte koo ijn hno gxe
izm: lyd lwx gml
aee: aem hnm hto gdm
wif: wqk dti vtd xou
jnx: vyi vsp skf sbu szh emi
viw: vma
ltl: gyc
wcc: wqt jvr vud eyo xdt
vvk: stx xxs xqv
ixl: hnd gdw
amh: iuy hng lav
rrn: icl hjs ymq yqr lbn
wzg: jqo vyh vgl eig xar
exd: xkj
iis: ifm hqx lej lxz
inx: lbi
lso: luw loy
alp: atb iwr itv
ddk: jzs eiq esk xml xzl
arn: lce lel luw
vha: sbn sqq str
kht: kgw rag bup cpm asw axi lkc gkf
rab: hrw hya heh lfr
ejs: xch xdc
jko: jlh vqs smy xqq
kvl: kqx ckq iuq ioh hdk hur ywj
dmg: jjr syt epr
bhm: aoh ige ggl
rgw: ckv avl irj gir
csg: apg hae lma
rue: bzb iir ijj glk gsm
vir: shb snt suh esa
hom: yjz
jdn: jxp jxu jfd jzd vws son
luf: gdb
sex: elq xjp
srg: sfc
aey: iff hog
dxz: jvs vkv viw vdf vet sfi sop ena eon xvt
xdi: xxj xts
yxz: lmc
haz: lgo
juw: vwr
ejn: xzj
hwc: ljk
jzv: vxr sum emb
dbz: dza jms sny suz egl ewd
bvb: lgy
rsw: hgy hwe hqc yoa lwg
kab: kvb run iqe han
ajh: inm gco
whz: wgq wdo dcr jrw sns ecf eoj xwr xtd
huu: ywo lyl
guc: wtd sgz xdf xvm xel xut
ytx: lxe gsh
yss: lho
jei: jqu jtk vru xci
gnt: wdt vkb vts sfn
bey: ckr asv hsd ybz lfv ggu
siu: slu sje smn eed
yeh: lbu
bbi: bes iia hrd gyl gys gsv
lve: lxh
jpj: eod pkf pbu
wes: dsy jak jsm jxn sre ewc esq eqg
aib: ihn yll
gdz: gxd
gtc: wpq dpk jsz vqi xdv
bnb: hww hss gsq gxh
csn: asc lpr
jma: eol xlx xqz xoq
czk: czr alh iyt
byb: bsr ajj hiy yya
ide: huk lzv
ewv: epq
bzj: cbf cto auk ivz ifq hkv lzj
vrj: vzu
kxo: rdf ree arp amd
rnp: cmd arp ynj
ikd: hbl hls hdm
vmt: vfs eil xsj
jux: vwm vny xkh xuc
vap: vpt skx erb
kma: rrk rgu rmx cbn hyv htu
dwm: jql vgy vmv sgr snr enz
wmh: dgx dtv vcg vet shw sph
hdp: yys ywc
wjp: vzr vqt snk ebt emd
kod: bvz aht lvo gwt
wvw: wpf wth drl vqc sny xeu
kjy: aqf ihj hzx gbi gaf
kwk: blf bpx ifn yrl
jbx: vef ewl efe xmx xuy pbd
kdu: kei kpq bou hlq gdt
rsg: aci ayj api yhp yei gjw
vnt: epw
kak: rvp byu ckr yww lut
gfj: wao dfl jfv vnx sjn emw
cvx: huj
wyl: dgq sys sem
wbm: wgo jhg vmp sid eur eos
sch: soe xpq
auh: lbf lnb ghv
ahf: aws haz heg ywz
aeg: atu hzt
bvy: cie cuo lgv gha gxl
czi: ird
yol: gxo
lcj: lav
vid: slb etd xgb
kqk: rjl rfo bjv akh aqk ihm iec
doj: vay
dax: syo eih esw
cec: azj ilj yom
asy: hmm ybc gyx
sei: stq sus soa ecp eqt
vcz: vpp sja spb sth eqq
ito: hro lha ldn lpx
rde: bhk akx
bnt: ikw hco hpl ysi yfm ldg
vnq: smm snj std edg xgp xwz
ley: lxw
agy: yrz ywf
vzy: ssu ecn
atl: yif yxf gmc
cbm: ccm cyb cud aws hgv lrr
rho: bhx crs civ cwv icd ybe
bcl: bgt bve ckk chl cly hkh ylo
wbr: wba wcj duy jyb vcr xtc
vyp: ska xce
kkh: kbb rzj bbh but cei idz lwh
evz: evq exo
sxa: snc snn pkw
eov: xjo
cnu: ihp ixi yek gkz
yla: yzt lto
set: sfm eeu
rtf: brc ccm ard ygv ltz
kea: bic bmz ccd cvc
kgu: kty ryj hbq lgc gww gdo
yzk: giq
kqm: rnv cmz ifv haq hhr ydb grg
aza: aqi hxu yat
eko: xym pbk
ysm: lap
btn: aey aov lhz
dqn: dtn jfo vkc sma ebe
jsn: jqn vtg sal ekb eei xtk
vxa: vtf sez
dee: vfg erm eff
ack: amx azj hfi yxi
bzx: icl him gco
bri: bok ckb cjg hwa ype yzf glp
eej: exu
bvt: ale lea
dwu: vah svj eak ehd
cvn: apk amb idb inj gvj gsa
cfs: gwa
kkz: kqm bsd azk hmo
bvw: cmj aag azw atr hqb yvj
rsl: rum aez hvk yzt gdr
bho: cka hdx yib yhl
yfz: lig
vss: euj xil xuf
kox: rxs bzl iej lgo
imn: iua hrk hpr
hmi: ywv yjl
ssq: emq ezn
wtr: dbl vip vne snh
yqv: lvb gcq
slx: ezh
bfv: cdt cts coj hcc gka
vmr: sgc sup xih xfp
ehe: xtj
bya: auw hbn yjf lph lfu
vzr: xfu xqb
gnj: wqs dxg vhj vpf sxp evq efz xtc
wzs: jku jbg vam suy eyk xym
sge: spp smh ezj
vlb: sqo evm xpy
jyg: eww xhi xnz
yif: lew
jwn: sga eks xot
llr: lnk glu
sbm: slw sfn
cxy: aon hai hwc lqc
kvj: cnt awt hec heu hut ybs
vor: szt xeq
ydb: yek
ghf: gyn
ano: aqk hgw gvd geu
jxl: vtt sxj egq xjk xxu xom
lhl: gjv gst
stf: egp xea xze
hmk: yac grs
lit: gwm
dgo: jxi jfj sij edh eek xiz
row: cwu ask iav iau ykv gbc
arm: ivy izo hgx yhg ghn
agi: aoq hai gjk
vnz: skm egg ede xzi
wyp: dvx doo jpl jtv srw ery
ayo: aqp irl hln hjt hxv yfz lib lym ljy
bbh: cwc czx ivc hhc
cqu: aer amo izf ior lsc lok gio gwi
buy: hks hku lre lcb lib
vrm: sti eka egd xuv
jjo: joq vvg swd xfl prl
cks: clc abf iyv lgc gjr
vsm: ezj xqe
blq: ccq adr iir ioy
sif: ssl ekw esa xci prt
ccn: amq ivr
ayk: yes las
jbe: vdr vsm srx eil pbl
kyt: ksz ktw rzq bbo cxs cxt ayc ijz ygw gio
ivy: ixm hqn
vjj: sal
sye: szv sos
xyi: xsc
gzt: whx dls ddi jqj sfp stq ebi
hbq: hcz
bqw: aos ihg ywy lyb gik
evm: xdf
akl: ame iir hpl
bwd: ckq cym avr ien gkw
suo: xyr xwu
hsx: yku yvp
bbz: ige lvj geu
vvp: sio shi esm xah xie xnl pry
rzr: ibh imv htv huq yul lcp lyb lgp gcc
dox: eev xbw xma xfe
sad: siz xvh
jfk: xqy pkd
rhf: blx clw czv aio adp ajt hco hdy hmt yvy
jhg: svp egp
lul: gpq
yur: lci lcq
ycp: gcp
yyu: yfp lvu
lin: lfh ltp
esb: xaa
jem: srv srp sor xjn xpz
egy: enl xbu
ioi: gle
bre: bhm bja adp amj lpp
dsx: vfs xcs
rbr: adt iyp hvo yrj yzq lpv
rjm: bah iod lqu luy
wwk: weq djy ewg etv xzn
dqu: jfg xcy
imy: hdx yat yzr luk gba gxx
snj: ewz xki
rsq: ruw iwa huq yqz geo
dpp: jej vue sgx swa snk xos
kqp: riw rsr bgq lrs gil
lrs: lvt
rut: bkh csw hhz yqk
eym: ena xgy
dyf: jtq shx spw sqv xho xwx xqa
rzq: aaq iun iol hjc yhb
dlb: vri vcb vgq sxj
wva: jqu eal ehl xwd
xam: xzx
ryj: axf ies hhh hvz ygq
kha: iyb idw imp lnl
emj: eqd xfi
sgm: xaq xxw
clx: cpp alk hsz ydh lap leg gsb
rhd: rwt bnw cir ctp iyj yny
rlu: iaf lrw gag
bkj: iiv ile iwl inu hwb yol gva gse
wxb: dco dwz deq slz ejl eea
eme: pru pbn
lii: ldb
wyj: wqu vlx swr xjc xvj
cjs: aas amp ykk gvc
aqu: hwo hze ywu
bkv: bit ine ybl yew
wpb: wux vcg veb egi esr
vaq: vfh
cuf: hnv ylv yjn
ypg: ypz lkf lgk
ejz: enk eqy
sum: xlj xsj
drg: dbj jds jum vwj vxh pbh pcd
bnq: bzi btk cih cvd abq lol
dqr: jvr vxp sej eix exc efc pkr
atp: iyv ifk lsx
kns: rrj rvq acs hrp hio yyv
lcv: ldd loh
sgu: sjn exa
vrc: sgw stl emf
dff: dui
kdn: rcy cgi ykm lzs
gtg: wiy vfo siy xhv xjm
yqx: ljj
ybz: lxk gyf
vvg: sad shk sxz eap xfb
wke: wjx dfo vqd vui voa skm
rqe: agw ico ybh lsa
xur: prs prn
cja: csp alh ipp hvd yew gke
exy: epg xce
wpu: wtu dhm dso jrk jer euz xeb
xad: pcj
hpp: yuw lau lse
vdl: suj elj xca xxf
dij: dpt dfy doi ezu eqg etx
dyl: deh dnq dft jnm vpw vos epo xhp
dtb: jyl vpy evn xsp xxh
jff: vyg ezw xyg xfk prp
vjg: spw efv xhi xdi
wzz: jib vis vhz
xin: xjp
rcj: bng ibj hhy hwi lpl ggc
axn: ily hjt yid ljz ged
yqs: lmw gvn
kfj: bxq cwg ahm hgq gja
bhw: bxe ilb ivi ixm gmy
vtu: elm ezc eqk
juy: epa
swo: sqs egz
drr: ddw jsb jxe evy etw
ace: hpm ynm yzc
drj: jzr juw erm ezx
age: ing hvb hvo hfh hfx yhi
wuf: dso dmr dos vqs xrv
vex: sri suw ego etp
ycr: gio
auf: yhj lpc
iek: yqg gko gad
hpi: lay ltk lto
ems: eoh xiq
eoe: xau xwq xos
jrq: jdo ejd enn prg
czf: anu
vff: suz edy xgr
wju: job eep xgi
wvq: dif jcd vxf xas
yyj: yjf ysy yem gyl
dhk: ejm efz xbl xav xtm
azs: ibm hen ywu
ggg: gva
ela: xlv
krv: klv blg hvs hpl
klm: bdl ywm ywf lkt lph
rhi: bqt akx axl
sfg: sos ezq xsm
vmv: vfn scf
dcn: skj smy xon xou
iih: yiy yfr lvs lzm lqi
ahe: apk icg hlg hjp lfq
sjn: erp efs
btr: hnx hou yvq luo
bck: hxp hqi lie gso
sgn: sen ejd eqn
khw: kei kem kqg bvr cdx yrl yey
csc: awu azk ipm hct yyh gch
ant: ijs gxg
crl: cng aej azq ibf ifw gkk
lll: gcb
bii: afw ini gid ggb
ink: iql hmr hzl yhp lod
gin: gdj
jmx: jfv vux sup xmu
ebv: esn
abi: acf ire hvm hmp lwv gwo
aiy: avc ixo
ced: alg iko iwd itr
klh: kly kjs cxf hnq yhc yhi
cbp: cwq ipf hqo yei
kqx: rhi bqi col aqz lvb
rif: ryx rmt bno czx hum luy gsz
glt: gwq
ljx: lmp
als: hqc
hng: yux
egk: xzj
dly: jvc jts vhd vwd vzk sks swp etv xgc pbw
wxv: jbb jty vty xky
vum: ejp
jaw: vhs swc erb evv eqy xdj
you: lku gjk
kgc: rwo buk gjv gsd
hoh: gri
ywk: gju
cdq: cfm hro ymc yqn
gln: gpr
jfd: sgl stf eds eel
hph: hzy
kgh: rgt rtj afd ius hlx hor ybq yph
hix: ygs ypy gjz
vte: von ssh sxs snj eyh esv epd xhb xho
hyo: hsc ywy lya
jfp: jzj vaw xya xdc xek
ahv: hif hxl
rup: ykd lec lxb ghr
rob: ccr hpp lrt
lgs: gdo gxk
huq: yov lwc let
xiq: xek pki
wll: drq jic jeq smo
suu: ecu esh xkw xko xhw
dis: dhh sjs
hml: hnq yak lan lew gli
rnv: byf crz lbh gyk ggp
ydf: yzg lmw
vqp: sse eph
rpl: yyn yxw yxn gxl
aaw: ygd lnm grr gxp
suy: ebj ehi
brj: cdo hbz lri lyb
duj: ebl egh eva
jmb: ekl eve xhg xpn xfa
iqw: lgv
hzf: yre yes gag
hpw: hpz lel
brt: arn ihq
ept: eui xdc xxp
bsc: auf hgm huc gge
ihr: gsv
acb: hhu lhn lxl
aif: avw atr hfm ldw
vdz: eml
vbs: viw sww xyy
khm: kwi brt boh aph aql gjb
szg: sqt eem emz
xjx: xvb
cwi: awp ilm lcu
bpv: bzv yhp
jkl: vhw sxc
iqx: yow
skv: sev
adk: hms ypv
wjq: dxg jji jvc vqw syz xiz xdu
jqc: vpk ezz
kja: rii bws cir cel iup
gyu: gpn
sef: sni eiv xpz
euw: xhy
gku: gih
ggv: gsc
caw: ced cfs imn ghn glq
gvz: gvo
yre: yda yxe ypy
knq: knu chg lik
sln: epv
kaz: kgd bag cvk akl ape iku ilx hwu yyz
dmx: dfv vab
hwd: hpr yco gll
ydl: gxn
sqp: ezt xgk xjz pri
blh: bgq hxd ybr
ggj: gpy
hob: lia
wdh: wuf dul dor vgx vfh voe
svt: snt xzb
soj: efq xzy pkz
jxt: vri vjx soy eql
rwd: rxk rmd bch bwu cir coa ayy gsb
wuc: vpu ejl evr eme xbd xgl prh
bhu: czo yrq yau lyu lgm gsi
rib: cer ato gvc gei
vlg: vls vmr vnj
wtw: vrr eya efs eoi
abt: iyc yhk gxn
xkg: pcr
vzw: exx eqg
dya: dff vgz evr
kok: rgr res rps bmx cji arh ige hgu gko
gvo: gew
ytk: ltl gvr
esh: eqd
lcl: lht gec
vey: shi ssa emk
smy: edr enn efm
yez: gei
wpd: jbo vhw egi egt
lrw: lnv
vuh: szb suc eia ezk xrv xgs
lav: gbg gsy
jbg: xsg xza
awa: yyv ylt ywp
wgg: wdi wxx vrc vej xbb xtg
iwo: ywz lid lhi lhq ltd
hns: gag gyo gma
ewl: pbd
sto: eic eya ejq
jjk: vra vem scp
hkd: ymb lmg
bmx: ahx ijm yay yzt
hqv: yhd lvm
rbb: afo iyj ilm ljv
vpd: vtf ses eob eoh xbs
dwj: xnz xun
vml: sis smq
dxu: jvx vhf vzl shb xzq
bdz: beh cvr ida hmj
rsd: ctj inu hru hne ysv lll
rdo: bzq cfz irn hst hzf lir
rwr: rek bqr iaz iik yyh ydu
yji: ymg
khn: rha izq hhw lnd
kho: arc ihr ilk ivg lok
hzi: lbp ldm
apw: aua ica hxm
hwv: ylf gkq
yjq: ytv lmh ltf luv gsu
rxv: bun adb hsy
spv: suv euk xyu xto
apc: liu
jzl: vkt eai xhe
euy: xii
jnz: ecq eaz eyg enu
egj: xwp
bxw: bfz ipx hhz hzm lds lur gca gyn
ier: ykz
szo: xqi
ayi: aps ljb lvj
bse: cwp ilt hjy yte lry lzl gly
gqr: vfc eky esg xsv xpj
hrr: ylf gdh
adv: hkb ymz gkm
bki: cjm igz hch hau yfx yqb gal
cuq: amg lpc
jrp: saq sqg
sca: szt sop ecw esg
dkv: dqw sor xyd xss
drn: vaa vme slm ebg edp
yoc: lgk
bwl: bvk bqq yfq lgr ltq
saw: xba xyh xgi pke
rgu: bve hka hrw hyc hvq yiq lmn
hzr: yml gkb
kji: kss rcd buz ynd
hxi: yri gau gjp gxt
icn: hyj lri
bjw: bxh bfl cdd acl ibl ivc hyu yqf laj
rez: rxc rxf bbg bqj csd ivu hnh yxj
bfl: cvf apb atc yof lmn ltm gey
gqh: gth wmm emk ezu xrn xql
bib: ceq cme cqf amz hbr lcw gbc gbx
azb: iel ysn ypi
vjs: eil
los: ghs
llw: giy
kmt: rtw bhf cvc aep ynk
sby: eke eql xyz
iuq: laz lat lge
hrc: hih ywg lxe lor
vnv: sqh eag
ivj: yvj
llk: lzq gll
wdk: jql vtq swq elk eln xji
vpr: xol
kkg: kam bkv iyf iln lry lid lhm
sxi: egq
axu: ysv yqg
dpg: jop vyz vwi szv
bcn: cdk iit imm hrp yrj gvk
jth: vre ehx elr
bus: cau cuo aqw yid yix yzx
akc: acw aza iav
svm: sth
ccc: cvu aic afh gxc
duk: jcm vwu vxd srh sww eld xyq xod
ein: eys ewe ejg exs xyv
krb: rzl aoy ypr lgj
ioy: hhh yvh ypd
kny: kfl rix csf cxc ilj hkz hbo hit hwu ybq
yai: yhk lec
gzd: jbo jse sxh xgm xxy pbw
asl: ytv
djx: sro swz ekj eow prs
diw: dyv svx eix xto
kjl: csf ipp hya
vuk: swm xzb
bvk: ccx cqb aqj gwk gwv
sck: efi xof
jeq: vbq skj swo xcv xxh
jna: jnw
chd: ikz iic hez gkr gkm
ajx: hxp lqh gcz
wri: vbg vib spa xyg
jct: jlk vzv
vcm: saf ssd ezh
wrt: wch wxn jqr sje
jfv: vbr swb xmg
wvj: jbk jaf vph vmu ecd xkb
bcj: cid aow imr lgo
rba: anw iwq yen
ehw: xug
iqn: hdr yny gva
kqg: rmt bus abb hox lfb
iqc: ysn lzc
rpj: bdf adu irb ior hvq hxa hus glt
abk: ajk itu hbq hic lsz
gni: wsn dgt ead egv xyg
rag: hct hsw hek ljh lsv lex
yor: lnr gdx
kkp: kff bgc acl auv ldv gxc
jol: szu stl emf xdo xxr
cxd: irl ihd
sfl: xou
lbq: ggo
khg: ram rtq ckx iyq ilc ldz
axa: afa hli lid lmm gbu
eij: eph
iox: yaw yee
wgx: jli jfa sxf ewi xqy xog
kyd: rbs izx hpo ywd glz gwy
rrb: ciw ayj iwt ijg yst lqx
hax: hfi lfk
eyi: xsb
jye: snv esw xte
azi: hua ynh yth lkf lvw
rur: ccn cws yai ywo lco gdr
skf: sbx slb xzd
jip: jno vho vmk sgb xgj xus
ecr: eek
xzn: pbv
bzb: aqs aok lkf lgt gkp gvw
vva: srk snu
hvi: hzy gxx
son: esa
ytj: gcd gye geg
gmm: dgb dvg jpx var sgh xst
yzw: yui
hil: yxo
lou: gyt
kgt: kjm rvx bkp lmv
sjf: spb
ycs: yjq ync lfl gxy
bgf: hmj hub
vpk: ecc xcr xmu xoy
rev: rmi rzh cmz yqp
kcw: kly hnb ydb lbj lmx
yyw: yoq lef
bzd: cqn idm haf yjk ymi lcn lyt
cyz: csq hgt grg gbf
lci: lxj
cwh: iie yjt
sdo: szg
gbo: gjx
etg: xty
www: dkz div dhm dny jcy jdw vdi
wcw: wfq jvu vsj stf xlm xnr xzp
bxj: lgf gyv
sqv: xnw
rrk: rbs rmf bae bxj
ixf: yrr yab yiy llz
ekh: xrd xmo xnj
dwk: jit jjk jzl vvy eme xks xpy
xaa: xic
yna: lod
ctq: aac ahy hhn lmd gio
rky: rdh cri hcd yfv
hsp: ygt lxb
key: koo asq iay ihq lrg lep gei
hls: hge yqo lbz gww
etc: xln
bsz: apb ycx yeb lwf gph
ejp: eod xqu
rgs: rsq cum iit hzy ljc
bzu: ihu yuu lbt gdc
hjf: hna yzb
yfx: gxe
hak: hwr hjo hxo hfa yrp lrq
ipy: hwn hnn htx lti ltj
kwg: rvs bhd czx icy yqw
bmr: cxb cnd aji hnt yli yzc
rwq: czv hlu hvj yef
ybt: lxc
rru: rhw rzk ijx hgc yiq yxp
rqd: hbf hmd lkl lml
slk: slr
roq: cih cxt hhy yus
kqo: cqb cog icf ysf lru
rbe: bvo bsl iyp ifh ycy ljt gkn
azg: ykd lvg
stn: enk
rgp: bii cky ixy lke gly
sik: sde xlo pca
iqf: hhv hos ykh lnl
hvt: yac
kxw: rxf ccf yyb lda gvt
bpi: cfp iag yfa
wqw: sye eyk eeb xcy xpo
whg: jyn vym eww eff ezn xwz xsf
smd: xnd pcj
vhq: vlm scf epp
srp: suk
vds: xii
szv: pbs
jid: jor sch stz erm ece
ctw: adl hhd hwu
siy: spj
esm: xai
yuk: lsk gxb
bsy: ccq cqb
hqj: ybz ghy
hyj: lli gku
iul: hlm yaj yau yvw
vlo: sla egl xxe
hqw: yiq ywf ldo lpg
cpj: idb ivp yil
veu: spb eth xvn prk
kps: akj yvu lzd gbo
wte: jrx jbi vvg vun
vws: sok ecs xdf
goy: jlf jzv vti ssj szu xkh xxw
atv: gaj
ygu: yek lle lfp
beh: czo
hip: yaf yqg
dls: jgw vfh vur sfm esk
hvo: gjg
rdp: bty cyo ykw gkf
vim: sdc elv xpo
cex: imz yem yos lwv ggh
ceb: iwp hue lrq lvg
ark: anf izn hrk lmq gyk
ktr: rdi hzt ynk lft
ice: iss ixg ltk
dex: smt ejk eni
ako: gbu
ajc: asu iyp hjv lbe gcn
iak: hyi yse
dhn: jby vqv stv eda xpl pcw
rvv: bgd asb yqs gvf geo
jjd: jof vip sdx smc ebn eha exa epl xjr
clz: igi hva gix
roc: cyq avn aqc lew
guh: dix jcz skv smp xul
azo: idk
evu: esc xij
kst: ktl kub iij yhd gcf
sbj: sxd xro
sia: shj xls xnn
duh: vwj vey sog xgf xno
ykd: lxu
axy: itc hmp hfc
gnh: wkd dhk dzv dzt jqo stu xhu
jwp: vsi sfe evt xgv
iwu: lki lfl
rhw: rwc apc lvz gbf gxl
hsu: hnn
ckz: yjh lug gdl gsj
ivv: hly hzr grh gpo
ggh: gen
jxj: vky vwo vjl eik eno xht
eiz: ewj evx emo eqy xbd xoe
bgl: ies lix lqt
bga: cij ctv ieq yvv gij
enz: xcy xqp
jcz: ejy xgz xde xxi
vvu: vpf epb
bak: icu ild ybd gbt
goa: jge vuq swu sni emb eqx xlo
vaz: vna sbg eso pbs
hoj: ylw lld lev
axx: hwr gwi
yhs: lhd lsv
ybj: ltt gin gle
afg: ihy luy
ijn: lrt lwm
czb: ani ils isq hti
vci: slm evn xcz
ijo: hkd hxy hzy hqg lng
rdz: bgf cuj ysd gxh
vlp: esx eol prv
jkp: eoq xfk xtc
wlr: jjy shv sxf szw xpd xtz
wbt: dbq dho sdx ekz elc
aes: axo aft imc
riz: bzf lpl
kwm: kmp crh clm ipp hit ylj luf gat
arz: anl hof yox lij gxt
cav: iha yrv gxl
awq: ich ixu lno
vzt: sbi esz xms xok
vfc: sot etv xgo
sda: ebf eik epp
kde: rcg ijn imc izz ygo
whm: dcr syy sxr ebn xpa xua
deu: vzy erv eww edt esn epx xfg
hye: hja gkc gmv
gxt: gxo
wyh: vdr sai eoe xly
rnx: bcc bjo cly clt aho anz iak hwm lzo gwu gjm
vbb: shm sqo exr emh ena euy xis xqh
sxe: pbf
sgv: ehc eho
yua: gad
yho: yge yvx ynz
kyy: kqu cmm adw avg hux yrs ylr lto
yrk: yyo glb glt
yyk: ydz gwu
wyz: wpi jmi jmq jqz xvx
lrc: lav
vwj: sfi etu
vsy: sgk sqh eyq
ktm: rlr brz buo igs ifz
ati: yij lie
bvi: btm hwv htg lgz grq ggv
atn: iix ywh lss
cre: clq iyy lal llv
ygj: lho gar gek
kpy: iye haa lcg ltr
jdy: jvr vgp ewi xzp
czv: aph ivh ykq
vtr: snw ebq
wyn: jwz vkk vrd sai eec xdu
swe: evf xmz xng
wkp: vtl scr syw xyl
hiu: gve
bbx: bgp bjq ahj ayp iup hyp lez grm gid
dmd: jma sfu eig eiz xql
bdg: btc cdc ina xpj
iqp: hum lcr lfk
wix: wnf wzk wta smo ecg etg
ckp: asm ibr ija iej yfx lap
ihj: hmw hzk yxs
kwa: rsk rss bny cdx ctz cud heq
waq: wsd dsu jze vjf vey vfo soq xmw
gfi: wza djm vgk vnr sas snh eri
auv: huf
yid: yfz
rbh: rbd rls aho yyh
vjx: vsd spd ews xyc
lbk: gyk
hsw: ybe
heu: yhw
hbd: hxh yqw
gfv: dcq dyj jlr sfy
jev: vyb slu eha xut
kjq: bxw aep icd yyc lha lqs
iud: ykq lax
xcy: xfp
swa: evm xrv xfp
sfm: xlm
bud: cdg iwn ixc ixp lhj gas gmi
kjs: bca cla hky hpt lby lcv gew
ilb: yke ldw gei
kli: kgo rwe rph atp ize lkw lra lex ltg gyk
lln: gjm
wmr: wfy dlk jsm vil sra xrw
beb: adh hje yzu lgs
xwz: xpd
bcr: hvw lbw
jwe: vip edx eok xyo
wfm: jkz jvj esy xtw
gie: geb
hmo: lgz
xgw: xqk pkn
wqy: wur dpi ver xda xvx
ird: isd ind lny
bgk: btf ihg ivb
rtv: byd hzv ygh lrf
sjz: xym
vro: sfe ezz euz
efb: eux
iam: ifa ioa yyc yxp lpi
koc: rch aah lvo gct
vdk: ehh
xmr: pkj
jsd: svm sqn efo
lcw: gpd
jya: jgy jmd vot sng eej efr
drw: dir jgp vxa emm euk
idt: hiu ycs yic yeu lsk ltd
vyi: vyu scq sxc eki xyp
voy: skp sgj ewh eds xyx xlp
jwz: jpr xae
ilp: ykz
vql: sig sga enu
hhk: hjt hox ylb ggq
bxv: cap hzc
sus: xlu
rlb: cwm csd cpr ams iws yfc gma
xat: xnm
huh: lah gxp
xqa: pkx
hgk: hzb lui
vks: szm evs esu xlq
xpe: xuc
wdb: jdv jnm emn
cvh: cxz inf hhp hog
bal: agk atm ykw ycp ycm
dbk: daj dxr jof ecy emo xhn
cmf: apk hyi hsy
jnk: jzv jqg vdj skx
wdw: jrb jxh vsk sfn sou ejs xhk xnz xfe
raf: rsv bzc cuu amk iym lob gxr
hrx: lot gbz
aak: lwp lek lqd
jpz: sks smz xyj
xfw: xoy
kff: kzr igs ief hvs gct ggr
sjp: ebc emp xmg
kpp: rpf cvt hso ydf lin
ijq: heg ycu ywq ldg gkg
jdm: jpb vbl
wqd: dwb jrh jry vvm
bmk: czj ajd yib yqh lkz
rnt: aeg hqi lrn
bhy: cvl iea hbv ylq yez gye gxy
bqa: afe hlr hlo lad
dhq: jlh jdk jvy son xbv xpt
bww: bdy bqn ave lbg ltr ghi gdj gxc
say: sqi xqk
dch: jil slk ekl xma
wzt: jxc jnx vqx xjg pbd
alk: hqf lly
csb: itn gkc grd
ewr: evw
ymc: lkx
kki: kab rzw bzr ygo lsg
imv: hlv
sbz: ebp
ibz: hhz hqi lan ghz
yzr: gad
dke: shs slr swm suh enx xlz
vde: vmm sgu sfu emf
yvo: yfh lmy
xre: xbo xqu
wvt: jct vwm egg euw
cjw: alk axx isg
hbz: hlj yjh
rqb: aso hcf hjx
lhf: lxg
cgd: cjr icu isd
wje: wtx sfi eri exw
vag: egf eon
cob: aau ibb
wbc: dmt jjv sep sqi eyf
lbm: ltd
aig: ahx yvr llo gcq
sym: svi smh xar
coh: ajv iuw
wxe: des jeb vpu sry sam elr xij
yec: lhh
sui: eci ezg
kly: ryp yvc
sho: ega ewf
ewu: edd esv etp xso
ked: bun cks aso hdp lpf lms
van: vla vws smi exz
lgw: lqb lqc gcr
khp: rpr bva czi hke hrd
hdg: hqr lwv lup glq
jfa: vqb scb spu sqp
vac: eaz ehv
ymb: lsw gwo
bxg: cls cuy ajw
dsb: jjz vdv vod sow xfs
bsh: acz hnf yxi lwh lnt
wvy: jjx jqt vyk shm sdj
huv: gpl
hhs: lvc lxm gxs
rhr: rhf rjd bxr cdh ayl idn
lbz: gci
acf: awa yrt
lla: grr
yav: gbu gpt
yaf: ldt glt gsv
vlc: sgu sqn stu edp xeo
kvy: cbz cat chh cwy ian itw
dyu: dmw jsr val svo
lje: lev
aot: iol yll
lob: gah
vil: srt efu xbt
ivf: lbo gpa
lmk: ghk
arx: agg icw inl itg gsc
jwh: jee vgl ekc eyx eqr
aqe: ymq gim
jfh: vcq vqr vun vou ebk
sxv: sun
kmb: rek rfb bmq hps yyk
cmb: igd iqt hdc hzd ldt gad
vqy: xqm xot pkv
gou: wjc dkb dqf sny epl
sde: pko
wav: wlf ddo jgl stc exw xcv
ibv: isb hlf hde yoz
hzj: lin
hck: hgg ywi
dzy: jbz eaz efn
jix: jmq vey vqj eoc xqg
hpv: ymh lbd lzl gie ggg
dkg: dwj dsz jme jqa vcf shs xxd xff
ytq: lnl gpo
ske: ecn enm xpl
jcl: jsm sid era pbh
lep: lmu
gwt: gez
wle: jou vus sez xmg
dlx: dmk vwl sqo
auq: idr ivg imw
bnp: aim igg izq hwd lye
bdc: bxu cwz acn gcd
lna: lta gpv
stb: sob esh xbu xor
see: efi efe xgv
hvm: ymu gcm gve
vjq: sut xck
ehn: elg
wmi: wqh jru vko eph
wjx: drk vie skz sld xbh xyu xnr
cnc: hpb hor ydg yef lkr lvo
wen: dxp jer vcb xxe
cwz: awz ybs
ihi: hsg ykw llt
yxy: lfe
dkq: dos vke vct sfr
dck: eoo xop pby
csh: iqm ymk lpm lmf
bjp: ael amz aof hsi htq gby
iug: ygz lak gav
vkb: ewe xuz
dfs: jsp eza xug
kbp: anz hsi yjz ysw
dgh: dpi dtt jil exg
hdl: gbm gsb
hbk: yin yml yoj
csj: ibh ldi
szi: evb ezi xlh xnv xtq
xrz: pcr
wvi: sbp ssb exq eug xtn pri
kbz: klv ctm alv apb ane ikp hik gxm
ipk: ipo hdy ynd lyo glj
yrv: lvf
wjb: wmj dyy sgl egc xus
wkk: jhq sgy ece xlr xxt xuw
dbf: dfj vnu svl
dvd: jsa xrl xwh
bqi: cff akn irr iyl loq grv
rfs: aov hgz hec hti luh lov gde
crd: cin awf hjx heg loo glu
hgr: yho ygw
ifb: iuf hmi lbn loz
hcx: gkl
aeu: lmz gay
hao: gkm gvd gpv
bxm: bzo czf azl ivg hir hyi ycf yqy
bdn: cfw hsn hxr hmx ysh
vef: smz soc xgo
jck: vby vok shq szi elh
vtw: vuj
kqc: apf hrx lvo lsr
wjn: vip elr eut
izp: izf iuw gch gyt
kdv: kjw kop ceb itv
lch: lak ljv
sme: suq enn
knk: rkc ryo rgf rfg hmx yjp gke
stw: xtt
cmp: akj ayo amj igw hhg hzr ysd ync lhe lmd luu
cfu: ctn adg igd
gtu: wls wux dha dnx jid vbk sqg xpa
ymm: gvs
gti: dkd dyv vjj vxi sxp
rqn: hcg hdr lub
czg: hxv ykd yac lev
bln: ill iek ytt
lql: loo gpm
ivs: hui grf
jbk: sbu slj esb xjq
rxq: rzd cdn cpp hij ghn
atm: igv lci lhb gcd
wki: scj sji stn ekf ewi
gnb: wxm wmv dps juo shx ehq xxn
vtn: sin sdl etn xyg xdr xex
viu: vnb swp sxr
kxv: bzl afv aqp ijg iuj gcb
bms: cij chg yom
wzq: woo dda ved syq sqo
yvx: yxj
env: xiu
cbt: cxl axz iqy hcw yzf lwb
hzn: ysr lhx
srt: sfc ejf esp xmp
vre: vbo vwm
dfk: syi emp xaq xlb
kvb: rlj bat byu cpb cqi acv
kbh: kgk bwi aoj izd yqd gvv
dbd: dbm ekc ezc xwm
rmr: bcg ciw aly ijg hhi ynx
rje: rzy bdv cnt apk yfd ggf
amx: iwf hep ykr lmy lnt
ezt: xtn
rdf: bin hha lyy gan
ylc: lea luy
whn: wfn dnq vin vou enl xvy xnd
knw: kue ifi ygq ldd
sma: enp
cft: cup ifv
eeo: xxm
smx: elo xni xqh
eop: eoo xxe
wgh: wjz dnk dqu eyz xcp xmr xfd xzn
ygk: lmu glj gme
wdj: weh dke jkj jnm eck
yrf: yzd
srb: eqt xut pkp
wvk: wsj jfb eno xdz xzi
kpf: rgd rjh btp api yoo
dog: jpb van efm xna
efz: xpf
bwb: bxb arr afx lld
iij: yhu llz lwd ljf gwn
lsw: lpt
lao: lpx
jnu: vzt sas eyj xeq
hlp: lit lov
avz: ipj hvp hnc gsw
vfv: evw
gzm: wds wft dwv svu xmx xqr
wdd: wxd wxv vwc ekw xas xhp
yhg: yxz
ylm: yxv lhh
dbt: dux jku sgd swj snu xde prq
itk: hqj ygr
bhn: bsk car
daf: dqk vie vlh eki ecc
iva: gda
liz: lgl lmx
vus: snh xeo
kid: cux aer iah iur yll lny
syq: ero xmn xnl
icx: lcc lmv
ait: ibs iuh yfa
drx: dtx jhl jzf vkg vjh sre sjx
lsi: gdp
box: isq yux ghe
clo: afe hjx
erh: etx eoe xxh xfd
dhz: jyc ved sma eal epe
wno: jsy jmo syw elg esw xcg
ipd: ipq yzi lgi
jdr: jvn vvc
ktw: kui rxa awb iqa lsn gkq
chg: ivd yvt
sjv: edc xzr
wom: jbg jnh sos
lja: lsy grw
adh: isz hen yij ypp lkh ljc grf gbv gbe
ifs: hcb
vgm: ewy evp xmx
boz: cyd ako ixx
ivw: hvl gau ggu
atg: iwj ioa hrf
ril: rfk cpg huh yxx
jci: jhv jht jxz
vfw: slo est emj xci xnu
xah: pbi
iiq: hyj
xix: xws
kqe: rby rtz ixh ynf lts
yvd: yqj lvh gkx gdy
kio: iiz hkp hgi lry
ape: hcp ggp gxr
kog: rgg coh hbw hjg hvx ywl
bci: cdp aqy iky
vmy: ebt enp xao xgw
ssk: sua xbh prv
wai: dzn jve jvp xoh pka
kzb: cnl ijd ldk luh
won: jkb scv xzd pra
vyb: vuk
exe: xel
sgi: swo sur emh xzr pkk
dqd: jij vva xjy
hyc: yxp gak gsy
wbg: wel dbv jkz ecq pbw
cjc: ctx hnc
xki: xjp
brn: cor ali isp yml
wxj: wzp vvs emh xjh xmr
rcb: rsq yrb lkd
vwe: exd xdn
rzk: cgn cwh avr
hnq: glt
xup: pku
car: awj iex htk lom
lpw: gwh gpi
dai: jks jlv sgm
ava: ate
jtn: swy eti xkf
syr: efl
hmj: lot
dvf: say szn xkv pbe
xru: xga xou
itj: lvf gkw gea
ywr: lag gag
wdf: dom jxn exe xbu xoc
yac: yvs yok
vjy: sic slo ezj
kbg: abp iva iql hyu lxl
wec: wqi dkr dyc dmb vgt ecp xlk
wgz: wmt jlp shh exm prt
alf: iua ycc len
rzg: cre cmi afp hns ypd lhq gwj
egr: edg edf xoq
rrf: rpi ahr hiy hpt lui lun
eik: ehy xpg
hnj: ygq ltu
yed: ghz gva
woe: dhv jmv vzi
diz: vdc vqv evn
bfr: agw hrv yiu
bon: ier iqs hfw yaj ysk yzj law
vxw: epq xnr
hzy: lxk
rzj: axz huv huo ggd
ssd: eac eno ete xtz
kcn: kvf ktc rgf baa asn aeo lcg ggl
cmt: htz ghf gyh gvd
rwp: brw cnw awc anr hup hot gvk
sbh: esl xux
vuc: syb err ejx xmb
dqv: jdn vyd xwi xxk
lio: gbs
lfj: gwl
wqn: wqo dko vaj voe sfq szp soj elq edv
xrv: xdp xng prk
cxj: isg htm
byg: aqv ivk
ibp: lij luu
haj: ytc
acr: ire ign ytu ltc
dfi: jit jlv jsz vjt vnj vqq vte sof evo ext xve xov
kzy: rxd ays ayt aqq hkp lap
dlr: dqx vwv slb sll stk eqv
amv: iad lny
voc: sdg sma xbl xdw xqg
bfm: ctw aka ijz hhy ymo gcy gis
hmm: hos ggw
wha: wqw wud jbw xwc
rpp: bji bmu ild igq imz hvh gvo
vzm: sgq xyb
jqi: vfv enn xhe
kix: cjb aai ibw hci hwk ylw get
boh: hvi hxl gky
iqu: lxn ggi gpg
yeb: gys
wyx: jgr jzt vmq ssi sph
kiy: kpx cxp acl ayh yeq ypk
kse: rfg coo aia ima yvk yub
hoo: lqt gsz
cgl: cfi ixn yjx lbx gyr
rvq: boa cja ihv img hiv yxt gxs
cxh: lrp lro
kfa: bdl bvk cie ipm
vgh: sca sar xsy
ely: xcm xgt
ygh: lkz lir lqr
rlq: rez bkx biu akc ayh afe hxl lgk lpg gsb
rbq: iyg yls lqh gyq gef
wpe: dfz jee vtw eqx
hok: lbw lii
iwd: ybb lyh
cwt: igg idq htb
ddv: jpv vnr sjm ezo euk
kot: bce byd bgw cbr ikw idb hiq hfr lam
dnf: jkc jvc jzz soc
aww: ilv lrb
hwr: hzm lgk lqc
sjt: sop evx
jng: siv sjn sna xwj
jzp: vku vcj sje xyy xwn xzn
lpx: luy
dqs: elw xqp
ask: hio lwy gap
bqq: buz cfg czm aen ydi yxl yxq
ycf: lhi
iep: lvk gva
cwy: ivn yon
roh: ady ika igy ldd lje gmh
gzu: vyx sia esp eze
loc: gco
skm: eoi xoc
dhl: dgs dwd dmn dzy jbk jna xfi
lck: gcz
goc: dhe dvx dxi sbs prx
azm: ibr
dep: don jrc sne ehq exz enw
btp: cyy azr isy hly
wxt: dcf jax jgs ekk eqz
ver: sbu
kxe: rdc rfh bcb apw igk led
cbl: chk hyh lym
yck: yjw yvk ymj ghf ggo
akm: aod igh hca lkl lix
ran: rzs bwt adb
ify: glf gjq
wkx: wft jko jit sab efn xhn
jiq: jzj eve
vgz: vgt
skj: emu
kcu: cac cvi yfk gxm
xng: xnf pbk
yto: gjc
ibi: hwl lsy
ebl: ehj xrc xdt
hqi: ywr
rff: ikc iau yya lip lze
vpe: vff smi
gqm: wcz wve vrj saa xbq xig
yad: yaj
iec: yqw gbl
ccs: irm yhb gxx
eyn: evt xdb
ygr: ygb
imz: hlr
cbd: cns iiw lep luk
xuc: xoe
dwt: jyk jsr vxa ekp etc xpk
gnr: jfv vdy vdo eob xdx xnf xop
loy: ggv gdq gmp
gze: wcn dum syd xcv
koe: hiz hzf ysu ynt
gzj: wxl vic vgh vtj eio
hee: lhe
rgl: cdf cqs acf hmb ycq yxc lbw grk
vot: eih xur pku
ygl: ytv
vsq: saq sij spj
vmm: swf eye
rmn: cho cpd ans azd igs
yfc: yuj
kch: kac rdh ccx apd ilg idd
wnl: jzd jun vpg ecc eyf xkr
ssm: ejn esb prr
caa: cgi iwg hiw
rxt: cqn yem lka gii
cax: cmn iwd hxl lcv gcy
cbq: cxy ayp avn ixe lsx
smo: xww xpw pcb
hms: lqc gwb
dbo: jrw vef skl etj
anr: hgi yru ywl yws
jyp: jfw vnf eqb xnk
alm: imd ykm yfu
jiz: vka vax vmq egr xri
ifg: heq ymk lrn gbo
ckv: cbg ccd axk ama iba
eze: xjx xvn
dcs: vwn vop sac ees efu etp xnu
ryk: bln iyd yes
ymv: yqd
vzn: ewy xkj xej
bzm: ikb hne ywg gbs ggk
lpp: gwt
jdq: vch vgh vpb szg sqh eyf
cwa: hri ylb yxo gkc
bhc: cue hyd hpg hta ggp gdv
wsd: dbu jyh vma eeu
jkk: vdp eyp ejx
chl: ast aof hhl ldh
wod: xxv pkt
rge: bpt cyy ajw lly gdu
wof: dtm sjv ela
whi: wyd dbz jmd jfl vel sln sdc eah
lvd: lvv loc
stg: xys
xko: xzl
eor: xin
hai: hzx yhe yft lgm gpt
cuy: iti
cjz: czh hun gkq ght
vpp: vmo eix
eiy: xvc
bbn: cyh ayb iyk inh hhb hxd hxj hnb ybr yux lrm gyi gws
khj: amo ixq hku hcz lst lme
vnl: slz xwq
swy: efn
egb: xic xwk xwu
yde: yzu liz lte
dxc: vjm ebn xhb
jml: jmm vwg sce sst
abx: ino htj yrl gyb
sdj: szz xan
vqq: sbk prt
htm: yig
sxw: exn xyr xja
yrc: gmk
eqq: xlc
jki: vjp sui
hmr: lhd
hwg: yrw lja lsm
sai: xjf
bdb: clo lqy gwo
jcq: jpr vkq ebq esw
ifj: hxw htw laz
vlx: vmz xft
igh: hag yry yaf
cib: cyq cjk hww
djm: voo sju eay
kig: kql ryq cdi irk hrv hcu yxg
gzl: div vwl vxy sge
btw: iws hqr lip ljj lnn
isc: lou gwj
hkv: ham
hjo: yly gej
ssb: xjx
swj: eeo euu
lai: ljd gar
lbs: gmx
hvp: lks gia
lei: lxg
ihe: iwc yut
yug: lwi grf
kve: ksk bak cgg cuj izd hmy hqv yov
yet: grf
ekx: ezr xsu
lct: lvp
xla: xwc
vlm: sdg stx eho eud
gue: wkk wrf vhi veg vnn
vvn: vxr svb elw
wow: dau ddh dqu juh vyl eyt esc xgr
yts: lgk
hnw: lgr lmf
hvl: yxm
iri: hcx yyk lrt
sla: evu ema xbi xzx
vrd: ver xza
epp: eur
ctr: hiq llg
vcs: vsd vtt sbm sly slx eaw eqe
bzv: ale hbo lzn ltv gin
yfn: lka
byh: cvn avy ynx lxb
wup: dmi dza jmh vii ven xeh
kyh: rov brl bay cbe cux aey amr
swg: sos ebt xli
kej: rba raw bks csr hbd hzj ywa lho
vcq: sjk sfj xdq
aai: isn lmt
kxk: knf kuf rmw cve ipa geh
ykn: ylz lyc
rwx: cif cwn lqy
rzo: rtm bdc cxi akk ikb ibe lxj lql grm ggl
hud: yry ybm ljj gef
cxv: awd yno yor lwc leu gyb gpb
dsa: syc sgr spv snm ebp ebt ech
afw: inq gln
hnz: yki
bwv: bnt cri amw ive iuw
aff: hmu lbh
jsl: jmy vci vgj spi xfp
cbb: ibr hnm ywu
ede: epz euo xwp
wto: vkw vvx sky sem xzh
rig: baf bhx bxe cgt ark apv hbn hwj yli
ybf: yui lco
saa: eke
vvi: vso
guk: wyl wjl dwe vnw szw xri
yat: lch
yoy: gsf
iqr: hnc hqt
boj: als
htj: lrc
jmh: stv eff xak xnp
khs: bgl cju cxz cmc ytj lsh
rhu: ijx ivn itz ltl
szh: eke eut xja
dul: jhw vmo szy etd
jew: sll sle eqj xkr xkl xdx
xpo: prw
dae: dnz vda xdy
ymx: gdw
lnc: lur gej
cik: asn aok yql gwc
ehk: xpe
awx: asf ikf iuv hcd
ekr: xvn
jfu: voz syv emh xdu
amz: afr ihd har lvk grd
svv: ssv era egm
ydn: lhk ltk
keq: rrc aku lpq gxf
dxk: veb vpd scd snx soh eps xkj
seb: erf ejs eei xag xed
sbg: ssa xbs xcv
jhx: jfm vlz xor
rhc: baf bdl ikt isz ini gxr
veo: smd eam evz eea eui xjl xzz pkx
kas: rgd iqq lgb gyg
sql: xeb
wfw: dbw jpt jfn vgp swj
dak: dzi skp eai ejx xqk
eyo: xga xgf
vqv: ecf xnj
ckn: atm ywm ymh lhz lxk gxo
dra: dxn jlt jja
bew: imu hmd gku gvw
dme: jee vzq sgf ezo xtl
bfq: atv ych yem gyz gdp
loh: gro
iej: hxm yti yuk yoa gln
vwp: xax xva xne pkl
cus: iaa ydv gbx gam
aav: amp hbh hzs yhx
ilk: yht luc
vpo: ecg eub
vgc: srr eee xtu
ajg: gvk
ixe: hcv ybi ygz lhc
jgh: ebh xsi xmq xzu
kxa: bcy bsa hwl hwm lpk gdu
cma: abq ayp iiu hvg hvf yar yei
rdl: bwq cbg cff yrg lbk lzb gle
rfn: asl aun ibt hxv leq geg
dwb: jps syw ekr xrq
cmz: yps lrg
vcw: ssu egy
wbq: wdw swu xko pkn pbv
bum: crr hkm hhx yhj yhm yeu lih
cqc: ilv yyg lwr
bxd: ccy aiu ytx yua lam gwb
ysz: lzl
dtu: vqe sqd xme
suc: ejx ens xhz xwy xvq
ang: hwb hjj ypv lpg
ivc: itd grc ggt
cal: cwn cfe aat iyk yny llo gik
kcc: bpw cqq ihi hpy yti ljs
dol: jnn ekg eue xem xnl pcd
aut: ibj hlp hge ybr ymi glw
vzj: exu xdy xju xtp
dmb: sfh ekc xqi xol xoj
voa: ekg
gfz: wcm dwr jyk jge vqv eyg edr pbq
jtk: vze skr pkc
iqi: ham hgb yoy gjl
rxp: bmn cfp aks lcy
vtq: egv evz esr
icu: gsa
wlv: wme jbv spp xxe
kos: rqc bjw aww iji yti lnb gah ghg
eia: eje xmj
ycb: lwb gid
vls: vxh sgg
vdp: sij ecs xdt xnk
kcz: rti bgg bnc cur aif iro
rns: cau axn hec ycf
joq: sdq suw
kei: rkw rgs cyx cej hed
wch: wyf vlq eki
kzg: crg cdu alq awy yrh yuq lca lik
rjo: ctr asm ibv hbt yqg
slg: ecr efp xsp xoj
bwr: boq cvg cza aib loh
jhu: jlg sgi soc elh ezs xeq
seo: eea
wgk: wdx dml jkl sya snp
cjt: aid avz yxa
ikz: hji hvv
sxb: pbc
slo: xrj
yeo: lxa ltu
jrs: vga vqv vox
lmg: gdt
aqz: hyv hma
dqw: jjb jpe vrs sys eji eve efo xim xvl pkh
vko: vfw
dvx: dfj vjh stk xrp
jav: vwo vtn slr xdm
ldm: lxc lmx ltg
irp: iiu hsm gkf
bav: cyh aes ylz gwa
vdc: vnr xzg
ydy: lcm lii
ayd: ifo htm hug ynd
hyw: yer yqu ldy
dpj: van sql edt exd xxt
hyq: hzg gss
dbg: vqb sej eom xhb
kta: rlq rzh bmm bue cjc yci lgv log
kvn: rmn ade igb ytq lgn
xlt: xgf xxs xop
jpe: jqb vmj srq svo
dii: dza ecf
jwk: jph jme skd sul xpi xty
ivg: yks gal ggd
imm: hzk yww lhh
gnd: dgm jaa jhx sxn ewy
ker: kmf rrd aqa hwz
spm: xmw
yqb: leh gew
wmq: wos jvi vlb vlh seb sup
cxx: ajr izh hyv lfd ggz
kvk: cjc ayc aft ijm hen
xgf: xzq
wez: wpf jix vnn smx
rrj: bve cle hqh
huf: lcv lii loc
jbd: jxi vvu vmt ehk exe eok xyq xjc
sap: sty eaj etw
hnu: ypb lld gbe
kor: rqt cak afd lhy
imx: ywv lye gyf
rdn: rfb bgd bmp lou
sou: xtw
yvf: yof gdg
rmu: idg iqn lva ltw gby
avo: iwk hcx ynn lqk
vly: xmb
xst: xeo
ikf: iqv yeo
lwu: gdv gem
cby: aeb igf yai yqf lpf
rzl: ccw ctb ask ijg ynr gvd
vvm: vsv ema
guf: wic dms jrt vrn skp xvr xou
dmz: jms jnq vgp vwx vua emr xdj xxx
jst: slv xsm
ryh: bbf hhv yrq lsg ggh
jwr: vjo ved vfp vti sct eno
jwq: jpf vwu vsr vne xpg
rcs: rhz rwa bek ckd cvf ikt ihq gmg
elv: efl xio
vyh: elz xej xmc xtl
rpq: rny yjt gkg
ikx: hmq ydz yef
ymz: lec luy ggc
cgm: aes
klo: rqc cgy iyj hgo huw yjq ldl
yii: yxm
cgo: lfb
sld: xth
vun: eha eet xka xtg
rwj: rvr cwt cmx acr hxs hox ykl yim
yyt: yec yfr yug gwz
iya: hbc gjz
gtv: jxh vcc ege xhc xwd
rjb: ror cvs agd ads hhr hzs
hpm: llj lmk
rfv: civ iey hlu
vfi: sts xbo xlz xgc
jrt: jad jsy vki vmi vqv siw
ilf: ivl hik gez gpf
viq: vpn see
why: dkr dtx juq xgu
bhl: clc cjt iwe hfa yan
eab: xas
dni: dqf eos xdg
lgo: lor
eox: xht pki
vpi: vta skc sao siq evw
dgb: vph vtm spc eft xap
jpu: syb xiz xfc
eyl: xvi
icw: lan
hgc: hnl ycr yud gku glv
vxq: vmm snj
cdc: hig hwr
dan: dlv jbq vgl vnd sgv
bvm: cfr cus aax idv hnt yvc lqm
cxr: anw aoz hxu ytc lkx gei
wfr: dbs jok vly vuv sdj ekw xyz
biu: are yiv lhx lth gxq
ldl: len loj
dcf: dhb vyp xan xht xxg
ktj: rvb bux crs itr hom lsi gjl
day: dvz dmg dqi jmt vui swv pkr
ikv: iua yws ymj
kbx: rmq bxp cdz aem iwy ykh lcq
snl: eiw emn
vmn: vfg sjj xct
aqx: ijk hrj yyu lnk
sgx: ecx ewe
asv: hef yys yoh gil gyn gdp
hst: hxd
rmq: bcd apk glb
dsj: jjf vng ect xqb
kwf: kdk rad bxn aqh yln yff
jnl: skb ead xpi
wby: wga via svl sxv elz xli
ycd: gwb
hpu: yix lzp
cvk: hdl ynm
bcv: bdq cby czq ise ifq hkf lio
dnw: jpl jpj vsj sgb sgo ehl eqx xdh
vhw: xis xgz
jhd: jzy ehj
dhd: dsv dmd veu scs sxp
jyt: vcp skh swy eti xyo
jlu: enj
sow: esm
awe: aff azw ydr ydn yxr yfp gwf
dww: vut ehw eyv ezb pks
hvj: hfp lhu lnt gry
doq: srn eja esg
ecc: enq
def: jta sff ejg enr xbi xdo
wiz: jbe jtd vgw eka
ket: baq crt cio ctz ayu
gtb: wma dby jgz jfr sxb sxz sov xte
hbw: hhz hst yha
rpm: byb chn cea cuq ial hgb hpi yat ylq lch lla
vxt: eau
yxp: grp
rrs: bhb bzp cae hqm gkh
wwe: wje juh ejb prp
ars: awm apv yfp
slv: svk xpj
jfy: swc elm xrg prr
iuj: yjx yof gad
cyx: ihp ysr
eif: emw
bwq: csh cph ihd hjz ypk gbn gpa
dce: duw vpd sev xbm
btj: cho cne atm iws lem
dpx: vdh scf ezj xzs
dxg: vfn ebl
vpn: sfr xlj
bvo: bfh cwe lrz grl gbc
vdd: saa xbo
rmw: bmt cxp ivx yju lsh
ghq: ger
dzp: dtx sxg smm
blx: iyn hds yya
vvq: vpu sno szr ecb xdk
yim: gig
ikn: ira his hsr htq
kla: ido ywy yff glf
yrg: lrb
dkn: dys dem jac vyi eix xrk xux pkg
vsh: vqw sjn xcw xmx
wur: jsc jqr smm xwn
yfo: lli lvr lvd
vms: slz szy edw
cck: icg hpe hmm yiw yon lmo gpk
eet: epq xyj
llg: gho ggf
rbk: rzv cfk aje avb gkb
lyn: lfy ltx gyu
wue: vbe vaq swd sfm efo xhj
yxx: yzz gaf
vec: srm sqj ekr
afr: idd hpf yfg gxe
yue: lsg luz
law: lvh
bof: boz ckk cjn hlu ygq yxs ldb ggi
sls: snc epc xjt
hxb: yph llv
rfy: csn cfr hrr hcf hum yhi
rxo: bci clp awd yac yox lcn gvz
kgb: knj rhb irp yek
jof: epn xre
dgs: jwb syl xif
ipv: iqv liu
cnn: abv inq hld
iks: hmi yer lit lym
jro: jvb jux snz sol xbq
llq: lqi gmc
yww: lrd laf lmt grz
rlf: rne bda ccf cai cit ash aqd
kcb: bxq alm add ice ylc lmo
dzj: vnb xte
vsl: vxw vxe syn xvp
erb: ewu epc xla
klk: cli cxa aqw lcz gcb
bev: cgo aik aic iuq ltl gvh
ews: xrs xsc
acq: ido ixg lqd lul gsy gmc
rjf: cla aip alp hxc yph
abj: igl ivm iuv lcn ltm
xva: xsn xxx
kwz: ktn bmc aju lls lfw
xnu: prm
vfo: sbs xoa xow
vrz: veo sge sgn
bfz: hsn hnc yfs lgh
rof: btu hnt ynq lna
ale: yak yvl yzp
iac: hzb ylg
vmu: vzg snt sow
ygm: gpu gmg
jzj: vbh vlp sha sqe eyb
iru: ivo har yxy yzb
jfo: vhg sny ecb
cru: czi har lil luw ggc
stv: ekh erx
gqz: wwb wwf wex dpr vif soq ekp xoo
rch: rap avc iic lse gkt gim
src: ekg epe xds
jcn: jfq vsv pbj
ibw: gej
aop: hgh yuv
awl: iin isk hju htq hur lqs gaw
duw: jqy vbj elf xrk
vul: sha eqo xza
whu: wnp dzx jbu spj ein enc
wnv: jmm vjt siq
huk: lib
yjm: llu gbn
acn: imk ylj ywj
atc: hmk hux
itg: lnn
bos: ain ajm ime ydn lym lfm lff
etf: xvq xsq
rvs: bge bqd hnf
igm: hnc yqd lag
ihq: liv
alz: ilb ivo ixu yvx
itt: lnp gsv
cmn: ivj yth lub
hcr: hqz yjx
rmt: rod bsg bqv air lnv
bbe: arb hao ycq ysf yxr glg
wzb: jlu jga spw spm eiv eoh
drd: vev xva xuk
gcl: gaa
wyu: wzv dek jyw jzd vlw vpc shm xse
vvb: sdt sea
ybr: yff ytu
hvh: yog lqz
igi: iuo hkh hqe lgc lwp lzr ggk
ian: lsk lec
ylk: lwm
apg: ges
eec: enz xfa
bxr: iaa iap iaf hfc ynh ltg
wwb: sgu xad xov
wpq: vqm slk sne sfl evd enx pks
kyr: rwx bna ctu ixd huw lvo
afo: ice hdk ybg lmz gwd
vjm: sis pkc pbu
jym: jni spz enm eza ezf xca
ivx: ywo yxr lsg lej luj
sly: sgf eyx eoe
cof: hpb ltb gmr
rjw: cha ybz lap lfs
cxo: yjb
ety: xqt pcv
hsi: grz
bss: irb ihk hdf gbv
awv: azg hrd hxx ywr lur
ajm: aes axw iqb ytx lhj
bma: aqs hyp lkk lyw ggy
jdt: vbg vuc sxb
rzp: bxv akh hwh hmv lcu gjq
dyx: jdg vtk sef eav
vsb: scb sgc xqt xtq
sfu: sud edg
rmf: bah cer cor akx yjt yvs
asi: ifq ymc lci gaj gvw
jrf: jli jwg vge sam evr
vsn: xbe xsa xzk
blz: cvs akd icq
dcd: viy vip vsm syt
abv: iht hdi hzp
gwa: gmb
lhz: gsx
vzf: ego
gzp: whn wew dra dub vsx xzg
vqf: sld enp xha
cgb: arh gjc
sbe: sqd eyr
dva: dfc jqb vfk sxj
wsx: vqu emm xhg
rkg: bft abh ixs hbh hza ygo lfu
ssl: ecb
cid: czk abd hnl lof
hcb: lwm
hbp: gmk
ysp: ytv ljl
sco: ebh
rsb: rnr cqf yps yuh ltv gih
eie: euc
iaj: lwu lje gar
vwy: sln sso sxj xpp xqp
lkp: lxt grx gcd
vnc: sis stc xpu
rid: rfp bss yrw yoc lug
hyp: lzn
wqg: wth vmq sxo xdv pkq
kby: kfs bdz ckn hwm lge gdt gpf
war: dap jws vrf vbj vpw
caj: hvx yqj lwl giu
rbm: rnk acg agb haq
ifx: hxj
hdh: hmt
iph: lan lhh lyz
kdd: rml ifa hpo ybo yzh lsp
kdy: kmi rwc agj hrq hxd yxn
die: jlp vkr vil vdl vdx sya xnv
czq: aqu ldm lpy gih
kad: bkx bei ali azf heh ynq lve lpm
bfk: azt iid lkt lwf
wwf: dnb sas slv efy eop
dqh: jtm ezf eox xiu
rlg: hks lrv gkk
sxz: ere xdv xzt
rud: amm hyp gjz
ipr: ggo
epo: xvv
dua: jix jtp jtz vdf sdb
lbo: gyf
vxd: ssa
alt: avw anw aqs ire llp ldq
gzn: wrt wmt vwi vqx egv xbz pkj
rfe: iud hlq yev
kxi: rem bsx ceh hrg
gbb: gjg
eat: xrx xdb pka
aal: ayr lah lhw
rpx: biv ikk hmp lkn ltt luj
vwu: vme erd eul
ign: ixu hrl yjh lff gai
rym: arc aey hay hfq lie grl
aii: hat ycv gcl
jje: vak vnq xkx xuw
jte: stc evh xha
yaq: llq gkt gap
ecx: xfp
dou: jyz vdr xgu
koq: rhh byu bnn aue ing ysh lpg
ajf: ipc itv hgm htk yqc lab
yev: ynm yul
rqo: bac ilp yjp lru lyp
wdl: dit jld jxc scf ssw enc xah
jiw: sjl spn esm enf xiz xdz
jbt: jij jgg jwb sip soa xav
edv: xnr
cag: iin ycz yzn
iki: irz hmf yxz
yiu: gxq
ebw: xbg xip xmj
rnb: avo iln iqi itw yld lod
bbq: bcg bqk
sbb: sia swt eko eqa
iar: gbs gca geg
wgn: drj dnp jzv vlk sod ezp eth xkz xcq
cmj: ctb igt lve
jvc: vzu sef xhv
kob: rta caw ceo cxk hbp hci yfy laz
sjd: svj eiw esv xrq
ipq: ygj lho llc
gwj: gsq
yun: ggt gxg
hkl: hbe ggx
hxt: yiv ytu
kpk: kfi cuj gim
cxl: irf ifo
amr: yxv
vse: vpi vti sbz xrg
vku: shv xab
bag: bfw cpv lvn gmg
cwj: akx aca awa hcg yrx yli ymu lgf lwk
vuw: sxd ets xns
bsg: ikr ibc idn hfv lzd
gfq: dsm vrs sns ete xrn xaz
eso: xfc
spd: xjv
svc: elf
emh: xka
abz: azt ate ivx isj gar ghb ghy
byt: bsi crm hvn hef lce
dao: jjn jzv vtb sga
dxf: vpz say xnd xto
dpz: sti ecd
wef: vro vak vds sqt elt ety prl
rwf: cdn art apq hem lvp gsk
jwd: vvs vny sfx ebu xvf
ekm: eel xjh xoq
jek: sdq sjv svb
ylz: ywi yex yzk
kwq: knb ral lsy gse
smu: eto xpc
wxc: dtg dui vor enh xol
izg: hip ykt yhj lpj
jnn: vwa vvx vtc xtx
srq: sct ekl etq
awy: hbn hua
sni: sqs
syh: sjw ssa xxr prw
jpd: vob sux
kcv: rln ais hmo hqa yzp yqw lcr lao
wcv: wim dgy jzj vvr shj snx
egu: edx prp
rdg: bvs chf yxy lpj gav
cgr: cne cus ydi lyv
vfm: eat
gfo: wli jst swr swp xpl xml
jvz: jnf jfg swx xya xja
ief: ljc lni
kyl: kve ajp hzs gjs
lif: lwg lxv
wim: wls wjy wns ddj dtc jei
dfp: jis vdb ewz
cdf: iai lri lyo
iht: htj gru gwm
big: cmi imt iqw hdz hvq lbo lwp
hmt: gdd gpf
ytl: geb xws
skq: ejr eng xwc xme
beg: clm cjq aix ajy azu hft yzc llt
hol: yel
eca: eft xda xsx
lbe: ltj
yru: yfu ytj grg
ajv: hpb lha lnm gye
wcx: dnw sbi svj xuc pba
bpm: als ann lfn gkl
sdu: edj epb
ses: szr eoa
xxq: xnj
scj: svu eyg
dit: jjw vsx xwh xee xpf
sds: epi
jap: jwi jtk snn eiu xys
ibt: iof lgd gmb
hxv: ycw
ddm: jjm jfc vho vgv vzn
ewg: eqv xmq
hql: lko lrw
bby: afi hbq hcp
ega: emg xmh xfr
vkq: vxb eio xkq xgp
cqo: hev ymw yfz lpn
rro: rvt cbg ifo had hyb gyo
gab: gvq
ige: hpu ycr lbp gcv
riq: bts ahx hhc hnj
jkt: sjr xcn xmd xmq
rmz: cod awe hgl
lqb: lqt
shv: sdn xjw pkx
gca: gee
jhf: vwt vur stj ejq
cqr: iav ixz huv
rwa: bhs hbd ygb
cwf: ijj itk yhm
wmf: wnc vrk sly xew xmp xtr
kls: rdm rxw rud yub
lrx: lux
keo: kmv csj ikq ibw iix ioe yrb
iwe: haj yhj
sos: eqz
iqk: hsr yxm lpw
kpg: rrw isf hil hly
wxh: dlk dno jhf vdh xwv xxk
bnn: cne iix hrb
vzi: sgr ebc xxz
brx: ahp apm ycp ygp
kex: kup rzy bph bpn ygd lrr lpc
vyn: ekn xld xtl
cts: lyw
waz: wdf wnf wzr wzl jza vjc sak eba eio
srr: swz ear esp eqc
byk: chg yls
sok: xzk
izl: ioe yzy
ihb: ilf hhx
ylv: lis lxv lfg
knl: rcr bvx hpu hod
yaz: gay gxg
iax: ymz gvp
gqg: jid jjo vjp vmo xhn xst
iiy: hah hgj ysn
hpy: ytr yow gcu
ari: aas hrk htc
dar: dor jmw vka saa xrb
dcb: dts syy ezl xld xtc
ysw: ggn
bys: cji aar ade auo hri ldv lqk glc
idr: isq lni lfa
bgz: cww cxd aaj ijh ljr
vdf: eib xej xqn
xsd: xef xmw
avw: ljg
ifp: lri lio lxg
got: jbf jjd vtl elb xfg
ahg: ikt ind yzv lom
aty: iea yct lmr lzv
wdp: drb dqj joc vmr vqo sua xnp
bhx: bgn ljl gky
xxr: xfi
ayl: iem hhi ypm
rfb: hco lxh
evr: eok
jah: vzf voi ekm
hsr: ytm gwc
cyl: cov haa yfp lxm
aqn: hfb yaq gbu
vip: sjj egh
dvm: jvz vlc vxa ewj etq xvh
cdh: hen hxr yhk gym
enm: xem xna
bjr: civ abg inh izu
jqt: jog sok
dec: vbj vfp eka
hzu: lac ljg
bda: ifu ynu lcg
yuu: lbg
gbe: gem
rzy: iau isu
kao: rmo boz cit api aqr
bxu: csx iwr huw gkk
hgg: hzx ynn lim lqc
css: ilh hzj lgs gyt
xeh: xtw
jca: vsq vod eet xjn prc
ywv: gaa
wox: dbn vql vos xnb
hyg: yhy
ljd: gdz gmw
cam: ibt hgt lzs
azp: icw icm idq ipd
bjf: bvt btf awu llw lpq
bep: cyg atf yol lns gcr
xwi: xwh pkc
wou: dmu vfh ewq eph
ylq: yeb
ech: xbk xwo xeh
rhy: rxw cav ime laq lol
cxa: ayu hgv lsm
yan: lko lhw
jhq: jvm vri var sky spt edj xzl
wum: jhw vyq vsw emk xqz
brc: bzc csk yxc lmr
cjq: hgb gbm gcb
kce: kyf bzi hbv hdk lmj
bhi: boa csh cns ibc izz lfk gan
hof: ywt lrd lwq
epq: pbe
vgf: siw shp ehd egm xwl
rrq: ccs isc hbb hfi lku
xsc: prt
vwm: sge ebk ema eqi etg xlp
ivh: liw gxm
jds: spp
erl: ees xnb
ieb: ymr yzi lcj gyh
hxz: hzs lrq lym
dny: dzd duu sps een pcb
wqe: dxx jml vyw xco xih
iev: hjg
jox: sib eqk xym xtu pbb
kkf: bla ima hgb htp lez
abf: iwp lrn gjx
akv: hto
cia: cxh ayj gpw
bov: azw ipo inz hov ljz lnx grk gvq
bun: cfu lwk
ryz: asq aff aox hgn yfe lka lpk gbg gic
xal: prd
dhf: dyd dwm dxh dxu ser xmp
hgy: yvu yew
jtv: vpz sfa ein
bjt: acv ahs ayr ash iux yff gkx
gom: dsb jki jch vls vgx vwb edz esk
skt: ebl ebv efr eoe xyu
bae: awi lxq lpr
sww: xyo prh
vhy: vxp sab evh xnb
kxm: bvb cfi cfo cts coj hmz yty
rpi: rfk rqn bls bxb bxl clo icd ipf yyz yqb
amw: ian hki yda yta
rye: hrt hbl ysq yzg lrd
vzc: sky
iut: hlt hvn hfp lfm gac
vcx: vcm vgv
vzq: sjr ssx xoh
afc: itk yls ygu ymc
axt: hbq glv
hpe: ynt
ahl: lok ghf
cdp: ati haq lqo
wjs: jsv sxb sta ege egq edy xkj xgi xqw
keh: kzw rkn bti izv yzl lxy
san: sff
eeb: eoi
evh: xvy
kim: rvy chb aod heg hxp
adf: axa iqz itc lpu gvt
sqc: ejo eog
ytg: lyt
wrr: wle dga jhj vak vgb vne srm elk
shx: sge eab eus xco
jjr: scc xnk
sah: sav svk xqx
eag: egj xhs pbe
bql: cub yxf lra lff
ybo: ydj ydf lhm
xby: xqp
sts: xho xwi xpx prv
bkh: imd hgt yml
vkf: vza vuo xil
amd: izy hml ynb lct
vfh: spf exf xno
aiv: hvn lga lxs
jzc: vpy vmb vnt von snz sum eyz eoc xxq xma
knz: rbb alw avh lsc lnc grp gvi
asu: axh hse yob
llu: loe
hjh: gge
leh: glq gdi
iez: hjz lhd
cnv: czc lyv lxd ghp
exp: xwu xjy xtw pcd
djb: dtx jib vhq vpa sgk epg
wxf: dzm srd emf xly xed
wtk: dgr jwx jfq vmb
hrg: gcb gje
jvr: swe xbz xsm
hap: ljm
jbv: vic vhv syr
vhj: sph evo
hdu: hjr hut yel lzo gxc
wwa: wjf jzx vdf sge sja
wmg: dez jmv jqh esf xke xnm xox
rzi: cut asq yyv lis lwp gri
dau: dyo ewh xeo
bno: axy icy ieq
rln: aka auz lnw gxv
kmz: rgd can ajb yhs lkl
jag: jvr juh sxo xle
xbq: xhm
hpc: hqe lbi llh
bxl: btb crg lht
aho: iwy iwu hxe htj lxf
icq: lpn lof
hcn: hlx lim
kdb: rrl rng bzg cka ixg imw lrq
jsx: sus esr xpo
vcg: sdl ehb emi eov
jaj: swi sel eqc xll xta
gzr: gzh gog wnk dhu jib vqo
axh: hke gye
jvw: vut emp xrw xbn
brs: bpw cfs cth
dsi: sbn sbu sjf xzf
cpz: ixg yex ymv ynh gho gle
hvz: gxm gmi
vma: svw
cvw: cmm any iyw gxd
vqr: saw sen edp xvp
vgn: sjj sus xjx
vit: vtb sve xbg xqx
erg: eto
rwe: rqa cbr alu ieb lvm ghp gvj
afk: het heu lze
dgc: ewo edn efv xhv xof prd
bpb: cee ahd hdm lwc
vuf: szo
wwc: dof jfm vyg vmd xme
ifn: hqw
ddo: jwi jtg vap esl xdb
bif: cdb irq iou hnu yyv lyx
dbx: jcf spz ehj eua xoa
eqs: eti xkk
byo: ayj aem hyk yvz llq
haq: yzd yzz
byx: cot ifd hjs lxx gel
rfj: caa hjn ykz ywd yph
hjc: yyt ydw
eyd: esq pcd
sjy: sme
kuy: bdf crd agb ied
dxw: jjd sex eob xjn xee
ijv: ywu gra
ktf: rnu bvf cmi cmn
hid: hij yyi lvy
yip: ypv
jcd: vlv xep
rma: cup aiu hwb
kqn: bye bvb bti but anq iad grc
bek: cmu cuw iwa ifk
jls: jnx vlr ell
xco: xfi
ldr: lnq
gmo: gzv dkp ddd vjw xzu
egw: etl xdz xfa
dxt: jwt exy emv xqr
rel: bpe agc hpf gbq gdl
sgk: xdz
xpp: pcd
vmo: vti scl xbi
wqs: wuo jgi jwo vle ebf eys ews euo xeu xne
ylx: lsp
aab: icu hku hyt hll hfy yfq
kel: kft rig baz bgp cje aij awt lll lpj
vhe: spu xca xfq xqp
ixx: yqk gje
sio: enk xjv
snu: xns
vfe: shq xty
chz: aay aue hto lus
kwd: kxm kmf bbk baa bse ijh hni hzk ysg
hqs: yvn lyj
lix: gvc
vij: ewh eof xlb
yks: yyw lnj
rls: bib clu any auj hmn
rtl: avv hbn ylj yxs gsx
buz: cdf hgk yvl
rim: bau bmw cap cei iei imr
enf: xrp
jlw: vvr ssu ech xjj
ieh: hil hya ydr yte gxi
shw: sxx soj xmn xzv prb
jyn: vcf vpv sna suf ers ede ezo
dqa: jbk vbq vaa vwm
bmo: aat atj hul ycw yyc ygx
yby: lkm gan ghd
kbq: rbh rma bna iev ylc lng gxb
idf: hsj ljf ltf
atb: hle
llt: lpt
hvy: hsm gpx
cfa: izf hjb lsh
wkj: wev jqf vew shd sla xiy xxe
lkw: lsl lnj
apn: amj hbs lym
lsh: ghl
csk: iyv ygn yec lks
gug: jgo jne skg shf spt xek
jcy: jfw xee xqe
alb: ymm lic gvq
hgm: hgq htr yyv ggi
dnb: jhx jqj vca vhl vlm vzr ecf xog
sdc: eqr xia xfx
sub: emg xvz xes
scf: smd szf ene eol xgl xue
soz: prc
clh: hkv ylu ywm gaq gdr
bvz: bsh coh lad
wsa: wed wuq duu jrb
rav: bkg cuy ihb hep
xof: pcs
wny: dsr jbd vwr ezc xfp
sff: eow xae
bbo: bsb cbq chx huj
akg: aeu lro lht gdr
sss: eim xdo
rct: rds bqd yuy gao gxv
vaa: vnv sir epv xls
bky: cxe ivt hin hyn gal
rqf: byr bjb aet isx ipr ypz
hdb: yhq llt
ksh: ciu ifc ycr yya lkz gmg
kbm: ajv aog ifl ywo yji ysj lrq lfj glw
vco: vxq vza see suw xuu
vqg: svz eam exn
ium: hvi llp luu
svr: enh ezg xda
dia: vhr sii erd eap epb
ami: iyf lxz gcx
wqt: djx sgx eac xrx
rte: cbv cpi cft asc lde
ent: etn xgr
dyo: vei eea ete xhx xnz xfw pbs
eon: xad xov
rtb: bjf iie lar
cxf: coz aou ilg izw heq yzl
jmv: vuy syn xhv
dhv: jut vry vgy vqr saj sxe epa
eoj: xbq xml xme
vww: vxd vxq scz slx efz
iim: hqf hth ykx
joi: etd xrf xru xqo
wxz: jcy vhi elq xaw
how: yrs yju yvo gip gjs
vxl: sxf emp xba xaf prs
aco: amq hea ycw gwl
bsk: aje isg hqm ybe
wao: wpx wnx wqm djz jut vpv eif
jrk: sce xgx xws xts
hzz: lop gxb
cba: cxz hwp
ybn: lqc gkn
vgs: eba ect xqp
cej: iqt hyi ywc lxo
vpj: sho ehg eos xlw xjd
sic: szh euj
wsm: dcz sde xyy xjt
jfq: vmh ssw enn
ary: iqt hzw
dpe: vho vvy
vfa: sgw ekj efp xhq xxp
wuw: jzw sik sfp
kky: rnu bdc aqz ivj hcd hph gvk gvl
cnx: itl hkz hqa htx hoh
gfl: dii dhp vqp ert
jbq: vdz vua egt
hty: ykl yde lgh
smq: szs xzt xqu
ebj: xir
hxk: yum gig giv
idz: hkn hia ybd yxe yog
eim: xkb
rkk: ccs hwx yng lvf
wds: jbq evk eui xan xfa xth
yyd: lct ghq
hmx: lcv gwk
gzf: wte smu ekc xlg
aci: lnx
rtk: bya bgp buo hoi llc lwq
hsq: ylz yus
kgp: rcd rza bqp cab cuc hvs ycv yvl ghp
scb: xuu pbn
enn: xhi
rkn: rls bmn cdb abq ynr
wge: wsf jrp vhg voj six svi szy evy xce xaz
isr: hqj lhn grr
drv: ddq jes sus euj
dqx: srw sgq swu xrc
bxx: cly hfp
skl: erc eyy pcd
yku: lay gpy
bnv: cbt ags iyj igl igg izi ydj lsl
yes: lgc
inj: hoe yor
yyi: lls
wji: jbn jhd jgg jxq vey vtt eqy
hwh: gps
iea: hxv hov ldw lxt lpx
bdx: cuh ahm hkk yik
sbs: eef eqg eug xnc xqx
jss: vhm vjv sac
ish: hdi lqi
dxi: jak jdd sfq
agw: ivd hhi
dwa: dpc jcf sku sao svd xpw
inf: hkt yns yfx
shs: sgc sek
kib: bsm bqc avp aos
scc: sdk xbp
ymh: yok gan
yhp: gpe
ykg: lsb
kyx: bbw ajf ixj hpv
rpg: bgu btb igo ybl ypz ltp
hbt: hqo yqw lwd ljp
wga: jwd seo xwi xza
htd: lys
cux: ary hln hou lju gyt
eoa: xkx xzz
ydo: yeh yxt
bgt: bvk cpk iec yan lmo
ldu: lvg
bsn: ilq hht ljc lsb
cac: clb csi abh apo atd iva ify ykl lmi
crb: cjg cne iix hci lbq
ydh: yps
snm: sua sov ezm xsy
asw: lpq
dvj: dpo vqk ekc
vru: vvm
jkz: vfc xgb
gzb: wgv dka dcx vrx vpu xue
edo: ejc eou
dpl: jry vcx epg xwd
kng: rav rlc chc cgz hiq hyq lgr lsv ltt
jcr: vfq smr xcc
vqz: evw evn
ruu: bke cwh aeh hev ypb yph gws gsm
hll: lnr gbf
czh: ihs ixw hbv loq
ebb: eyv eln xvc
xdf: xts
cfn: aqc imv hsb
isq: ykb lhi
dcl: dsz den jdg vho xnh
itp: iuv hsb heu yzi gyh gpz
cfg: hez yhc
chy: ivm hmt yjs yee gho
itx: hwc lpk
jlm: vis xqm
hxq: hmy yso lsw gcz
amo: gyu
jxw: soe eiu xkm xwp
dkr: vns sci sgw erx xcb xcs
iuk: hyq hgz hpc yln yfe
krf: rxn aio azg iwd hdb ygm
aby: iwb gwz
yin: yod
ydd: ytq
bgw: chv axm hvp gph
goo: dmi jww jou vrd stf ekw ehk xen
hbm: htv yzl
rfw: bqf ybw grv
egz: etm
ypf: yoe gcl
krm: krn knr akw gvn
crw: hau ytm lvb gmw
idb: lpz gaa
afi: lcn
syc: ers eaf
ich: ilc hzj ycb lbt ldj gdi
dmy: jcm jim veb xha xwm
adu: hdv lvb
iao: itv yxk gij
bkq: iuw huv ycs gxm
kev: rhq bno bfn igo
ksg: rip bei cgl cxy cnl cqd hrm ljh gaq
dzn: vsg srp spw snd xdq
gaa: gdb
bsv: bor csu ikc hrp hig yrt ymy lyv
xlr: xvi
vjk: sio seg suv
eyy: xly
sru: sdt ewn ezd
euh: xas xth
ljg: lnv gga
ksp: rla rzw bkh bop cwt ind glh
eww: efs xyj xmy pbo
gux: dbw dal stu ecp ews xmf
dui: jjj xam xtd
abh: aez ixv hik lau
emc: xkt
lfv: gid
wvb: dmk jes vnf six sdl eke
lgf: gmv
ene: pkm
wbs: wla wty vik vga enc xcu xoj
hfv: hff
igk: hcj lsp
gzi: woy vxo ebr
ded: dzj jgu jps jmg vgb vpy syb son
rit: cuh hdl ldg lmn gel
vym: vdd vzw smt
jnm: vcj ekp euj xlz
svf: sfd xaw pkl
szp: sqg xqz
ebs: xru
vvx: sft xqh
lff: gpg
cdz: yhk
cjo: aam aov ixk yrv lgy
lfd: giw
cmd: avc hgu
byd: axt aqw icf ykg
lce: lyy
vkz: vvv sud eqh
aoq: iud hfx
hrt: gxt gpg
jrg: jlo vot xzd
wlf: wsk dej jhz jjo vqd sya evc
kmv: rsn rug inh ggd
jtb: jow vtm sfk xre
dna: vya smf xri xwy
svu: evz
sbk: etj
arh: abt lum
bec: cpe cua atl lht ljw
yix: gib
acy: anq isg lik ges
wdc: wqh dgz duj jsx viq sgq xfd
buh: cbv cod ayh
roy: irx iqp hgy ysl
xvz: xny
bpe: cia yag yss ymx yqe
kmg: kow rxk rft bum auo lhv gck
lfy: gxx
whd: jen vmf skv xmp xui
hlf: gxw
eyx: ewf efz xby xwd
aap: iha hbt lnw gkn
dku: dsk jek vgv sbt sdb
exn: xwj xqa xtd xur
jwc: vaj vhs skc eda
csf: cmr ifi yzj lue gve gsr
efd: xit
abg: aup iip hsu lig
cct: cgu cqy axd hni hzh
jmg: sit ssh erv
kxl: cgi czb axz afg azj icr haa hyh hmb yfq gjj
bjb: are yzf gah
dpv: jlh vbf vwq ssy erp
ilu: yur gvv
bkg: hgy yll yeg yoc lkv
jik: eic ezm xbb xnd xoc
hzw: hqm ykn lsq
ynf: gki ggv gey
kdg: rbr rgf aki agy irj hln gbz gmr
wad: dvm jdz vgf
lpm: gyv
gxi: gme
shl: szj prz
aku: abx ibn yjd
jkj: jly vuf sqi ewg exa epe
rrt: rnl bwz cms ipd hrp gii
wgu: dln dtm dtt vcd sua
dbw: dio djm vhj sqe egy
yhw: yht
cgp: csy ibe ygt lrl lqr
cuc: asv iat ijd hld hqh ley lqz
kpz: kqt rbf rpx bkg ino hlb
sbl: sug evm xyx xzt
lqh: gmy
lwl: lvy
kmk: rbu rvp bdt bnx ljx
wzn: vvq ejt evc xcv
vhv: vfb syi svm emn
dcy: vzm svt ssn epl xsu
bmn: cqu afo lus gjp
wsv: wfa dqz vrp vti xbh xmn xfy xuu
coy: aqv hkr ypm gxn
iql: yrq ynb
epj: xki pkw
xrd: xeg
sgf: xeq
jhc: joj vmr sgq eac ezw
vkl: sgm
eml: efc xca xct
vwg: vvm evz eqh xox
iot: ywn yto
rhb: aew ipc yid
vrv: vxp vng vfz sil sqg eqp xeu
kpb: cvq iaf iii iwm gcp
aml: hwc ymd
vbc: san sqk
lza: grb
dpw: jmz vvf vum sxt ebk
bme: hip hff yxy yfb
aqv: ipa lyh ljz
wxo: wfm dcc daj der snj
szk: ewu
rux: ruo bti clc hmw
vng: sjn stg eid
guw: wbl jst vij vdx sfl ewa xrx
cco: alr avt iij hyt yoa lhk lmy
cul: ikw hui yox llw
ior: hwt htl
ake: arg atk iko hky ybx
juu: snu eir edn eti
kgr: kdu rau bbp bbt bdq bzp ivs lkc gvs
wcf: dpz juz vkv vag sfs stb xhj xxa
iyu: itz yyo yxf lbx lgx
szy: xwp
gza: vjz vui sib sxv egn eoj
bve: ibi yci
hey: yyq ydr ysn lbs lvc
cdj: agp hzm yle
kkr: bkr hoj yjh lna lnq
eph: pks pkq
rok: bkd yqn lts
sud: evp
lqe: gde
vud: sqy emv eup xwt xtk pbd
lpo: gwy
wld: wun did jxu joc say sop
bba: csj cpr hsl lcq lge ljv ghc
gix: gyp
svp: erj xom
ikt: yil gvp
dmr: jhc srp enx xzk
rgz: ruk rot ahv ijv hyv hyu lsv
kug: kom ycg lrf lzp
raj: avn anb ijx hfy llh
wwu: vzi sxa eyc ejv xzd
wkv: wbf wfl djz jop ssw xoy
hjv: lxg
vsd: vxu vnu eim epp eml
kkj: keu rtc chd cmt hjf ght
enp: xyl xjc
iwc: iwt ipt izv
vin: shj xaf
xnm: pkt
wjt: vdj xci xik xwt pbu
isv: hwh hwe ydj yjv lyt
jrd: jzn ssw
spf: smx ebl eqh
cbv: cap cxp ctd aqx ysd
itc: hda
edr: edz xoq
lva: gcf
xcp: xfz
vwk: vfm scz eav xtf
wfj: jik jmx jub vre vev voa eme xms
vpz: xeo
kys: kpx ktt kto clr gwq
jrn: vsv sfp eiu pca
rqu: iqy yha yei lrc
hhv: hez ykx lhe
vzb: sic sln esq xvw
exa: xwt
cgw: aeo iqe hfy
wpx: jds vzs ssz ewc
swd: xwl xvo xnz
kgw: rai rtz ino iqp lqg gbn
isj: hxh yax ynw gml
ddr: vbh vhq eql xhp xgd
roz: cvi ijs inw hvj
hub: yfo ldq gkg
eke: ebr
wwn: dgp dty vcn eyw xuq
bol: ckj cla cds ioi hqu ljy
vwo: vvs spv snl
rpw: byk bwx coy agj ivb
aky: apo yhw lzw gal
rdr: ita yrb yww ymo
xhc: xpy
swm: xgb
czp: hcu hft yht yyb lkn lwo
wux: xjh
sep: xhb
gne: dys dzl vxq sox evj
wqa: dlb jfl xbx xvf xng
aed: ywi lft
hxy: hmy yhv ywt yfu
sey: efe xap xvm
jex: szh xrb xpt
yis: ynn ghx
kkx: khb kxr rsi csb hsk ygr ygi ynv ltk
yzf: lnm
iyh: ije lte glr
vmb: vuw scu evu eex xit
bff: aaf agm aqn ibx ywp yqg ggz
rtc: cpk azl aqp yvv yxn ypi lvm luq gwn gwq
col: lhc ldo gxn
bvd: ctx ics icp iyl ygs ywu gve
cla: hkz ypu lbx gkh
rdq: rxb bho bsw axv hxa ytt
hli: hsm hsu ymi
xbl: xaq xfd
rcx: asi ane iya ioo hqw huv yii lki gms
wzm: dza jio vtg vuu exk
iic: ils hwb ykw gho
iso: hch hqi gds
awn: hju ygp ydd gbf gec
xbh: xpt
lhw: lug
agz: hzo ytu lwx lqz
sxk: eqj xhi
cqk: iip lht
baz: ctc hxh hxn
cqf: apz hry ycc
lvm: gjr
cut: aay ioo lhp ldj
vug: spn xyd xso xek
hal: gku
iig: ysp lqj gcq
ect: xoq
gal: ggr
dup: jkd siv etp xsd
rni: bjo bqv cyi alh hxb
jmr: xcz xyt xpw xud
vpx: vuo xji xqz
brk: bfa cdb hsh lgb gvt gel
jmn: vil vge vtx ehb enp xib
bcc: bhf chr cyc itb yba ysz yew
ksj: kpr cdp ihw iuo heo hum yxf gpq
gnu: wtq vct vac eeb xlo xej
cxt: cuk aav aqm gas
exb: ezq xpj pbh pbj
agk: yis yei luw
hop: lzq
dnz: vmu eto
swi: ejk epi xay
ejb: pkh
kah: rfu aal atn hcv huf
kjh: bdx bzi irj igx ltg
yak: yys ylf ygk
xzb: prx
imh: yes
snq: ery eym xaw
wrn: wwj jwe seo emc xct
jul: ssm
asb: iet hzz yoj lrv lfd lob
bqb: cif cgo adl
sih: ste stm
ybd: lcd gyg gsz
kbs: rjo bpl chy ali yie lut
iwl: ixj ygx yxs
cud: ihu hhj hvq hty ycx
hul: yzv yqi yta
rra: int hvc hec ggp
srl: sjm sph
dbc: vpo eiz
wac: weh jvn jpn erx eyw
abr: aoe huw gll
kuh: bph ykr ylb ggs
bzo: ahl ill ifd gji
rty: cza isn yce yhe ldc
ktx: rqu bau ids hru hsq lwo
rna: cij arh lmm
wlj: dnh vbe vfw vfx sbz svv xil
lbd: lgc gcw
cbi: clc cpz ajq aeh igu hys lbu gjo
ebt: eur xhu
ryg: bra bsm app amv iaq
jwf: jua sow ewy
kee: rei bvj bzi agz
yae: lvr gwo
bde: hnw ykv
jow: vdq vty esh
bjn: cwi awy ypk lts gaj
wru: vde vnc sml epm xzo
htr: huz yds lxv gia
eae: egi xve xvm
jpi: vjc eev ezu xrg
xsz: prs
xht: xxw
lwx: ljy lxk lng lfv
djy: jhj vkp vre vsw voq xrk
rrc: hwo hvx gdn
wtm: vlr evg xdh xeg xfu
adt: ikj hxl ltl
ecy: xfr
xck: xcs
hmq: hol yzn
iua: lmp
vlj: vee ekd xku
clk: auz
ddu: dxh era eaa xau
xvj: xup
cqe: ait iyh
yzv: lel
hwk: ybg gej
cpy: acf aun izl hre laf gyr
kom: riu rec crg apb inn
ykx: grn
ybh: ypw
iae: ija yuy
cxi: czw cui ate ygk
bfi: cck chu atz idr lzq gst
rht: aqk ige ink
wyf: jwa jjj jxg shn sxm enw etx xha xsf
wyq: dcw jrn jji vud
wqz: wti dds jbs vrj vsl erk eum
jpb: vka vvy sff eru pkg
dkp: diq dus egn etl xjh
sxo: xfz
ixr: hnq hfb ghg
lzz: luh ghj
dac: dao jer eda xir xpm
lku: lcw gsr
akq: axs iqx lwc ljk
gfa: wyh dri dud xaj xsj xta
jdf: jmh vhb voo xxt
ybm: ygb lgh
wet: vbw vip vmk sel eld xkk pcg
isg: hvj hsj ynt
job: vmp vmq sey
hov: ykn yce los
vdo: vmg shb ehd pcg
ehj: xop
crn: cxz avc lud ghq ggv
iye: ild lnl
rer: rmq buz avd igz heg hzs
kdp: kpc btl cdk cvw hku hba yuf ldb lep gyc
jib: vzi xeg
iuy: ylp lbc geu
jfx: vyw sxb xio xdf xzq
klv: ruf ciz cof ame hoi ljo lpd
rti: bua ahb agn heo
ijs: itk hfg lby ldq
hxs: yih yud gjw
dzh: juw jof vhv sht ewc esr esz ezi xhk
rtx: bzx cml arb afs hkq lfi
dat: dnk evl xww
cqs: acv axd gms
bgo: bug isc ipy hde gdu
ero: xdu pca
lzt: low
hha: hub
yie: ljd
ijk: ijg iux
xgp: xwl
bqc: itn hcu lkw
syl: edw pcc
suw: xzk
ihy: huh ggl
shh: ssd els xuo
bla: cfw aek anl ipf yuy
spz: eqh xih
dps: jia vet sds
dnt: dzr dql jcd sxf eij euv xrq xtr
dcc: jsf vlo vop sht xpd
crx: arn lcw llq loy
rja: bqx ick iml hed yms lsj
gfh: wpf wnw wqe dyj dww dfn jwe jsd elu etm xqw
ksc: rkd iev gxb
imq: hcl hoa yfv yqr ljw
snz: eht xpp
yro: yma lcf gdi
jfn: ecs xlx xos
ien: iop lyc
ydc: ghc gxr
cvi: hwg yst
csu: abj iud hsj lur
vwq: swg eqj
sso: xmr
ree: rpo rox ije iqg ldj lqo gjn
vdb: eho
ruv: bhk bhd itc hre yiy lqy gjs gpw
xmd: xon prz
rai: ath iez hio ylx yxd yza lnt
ddq: jcr jyl jgm vfz xws
acu: agf inr ybs gdi
voz: eaw etx
vvy: smj ebs emb eqn xcw xpw
szu: ecg xgq
yzm: lcd lxi
vgw: vwk eex eff xjk
dbb: dsv jcd vgv vdp sik
bea: cpb inu lrb gra
jgt: vfe edf ese etr
yag: grk ger
dim: jbh vem eqy xkb xbj xlp xet
avd: ino yty
iwa: hfa hfm lkq lae ggs
ivo: hbm gcu
duz: vdt smv xhl pbj
wpo: wtn jbc jdi vpm sqj ell
vbu: sbs suk ede efv
wvf: jlr jzb vlj vpl syf
cmm: ayn avi iys
kiv: kxq ktq rls ivr hdy gdm
ivu: hti grc gvz
ktk: ras rdg cws ctn ivv
sdi: sep xeb prm
jgf: vev shw sos
yjp: ysk yme
asd: iwf yli ynw yzj gmp
ita: lot gkh
ira: hll gpv
atw: hzq gjn
hwz: yff lxh gkg
skr: sxu ept eoz
cee: acf iwj ixj yks
jnq: vtt vtu eal xap xsv
yvw: ysf lwj
rjd: bds ijz hcu yxg
jjt: vdn syb ejk xvw
hxp: yme gcp
skz: est
vqx: sej xtv
jzh: sbn sbt svn
dzx: jhw jye eue xfm
hhf: gry
yqe: lrr gks
hda: lws lpx
eqa: xke
egv: xwe
awr: ixn yvf
ibm: hhe hnn
wnj: jti vkq vdz eno
wzc: woi dhd dwi slk etb xtg
vii: vgg sdf ewp xzu
wma: dhv scx seb eun xwb
suz: ebj etr xfa
cdb: ilu hij hfm
kfy: rqb bof csl ykd yfk yzx lar gwb
jzq: voa spr spg szz ehl xil
rqy: bdv hgr leq
ryu: rsx bgm bdq bff cnb ctm
lrt: gkr
sgb: sze eri
gll: gpy
etq: xiu xxs
ild: hil
edw: xuk pbg
wih: jqo san ssb xrd
kes: biv cpx hea hua gpv
rly: rza bgu bor awf hrt
kmx: rbw rxr rot bno cev iiu htg yxc
kgk: kog rsb cid auf iav iig ipa
jqb: jqx vay vsy eef xor
jad: vdd vnv shz swd eaa evg
cef: aya hyy ygy lgn
ioc: hln ljp lzv gde gmj
rxf: cio hgr ypz gkc glt
ert: eju xti
szc: egc exx ezz
yvj: yul lui gpw
ddy: vko vru sgj ebi xdv xpr xfz
sva: eoq
guj: wgh woe dja jmq vhx vyl vnd sbx smk ero eon
llf: lwj gsb
eax: emu etv xkp xyx xwe
bef: iim iuy hsp hpz lse gkd ggw
yhi: gpd
sjk: eyg
sij: ezu
htk: lqa
jww: jxy sun evi
lud: gdz gve gvz gev
yzt: gdj
jmm: vml skq
iwf: ygx grf
jfw: sxm
iju: imk
cyg: apl hph lji gwv gve geg
egc: eqf xdr xtt
vhr: vyx six ehq xke xzx
kyp: keq ajg aph iev hic lgq
rdi: bjg ihc lni
jpr: jqw vyh vnf syu enw xxc xpd
hhm: hjw yxj gcv
vht: vej vow ehb
wja: jki vgo xpf
jvn: sxj smk eso
dxh: vaf sxf ejm enq xyh
vmk: vmm vnw xsa
woy: vvz euv xem
bto: cpl izx hyb hpm yip ywb ldy ghc
vns: vqs ejf xoz
kvz: bla cko cdf cqz itk itt hwf yez lmb
lko: leg
hln: gwm
vkd: srp eqs xbp
vgq: ehv eel emo xjc xnr
xwh: xne
ssv: xeu xot prj
aiu: ixd hne lkh gkx
jom: vpj efb xsr xxb
snr: ecl xob
jxf: vic egp ejn eob
hdq: ymp yfj gwk
dty: jlm vcf viw xtt
dbs: vzy vzl syh ebm
rqi: crx asm iqq
snd: xam xum
ciz: ygt ghc
eit: xyu xey
vgb: vpe ebk xfp
jyy: jje jqh vpi xuq
sab: szn exu
vez: smg sfe xaf xoi
jed: jmv vze sgn eaz
ehu: eek xgl
rvn: rnh aya hie gex
srk: eff xrm prk
ccp: ail ynw lxo
adq: hum lgb lsu
hnv: yhz ytm
gzv: doz jce vny xno
iqs: yri ytf ghx
vew: sht sdb ejk
ehp: xkp xno
isi: hck hfl lqx
boa: ade aob yit
cyi: akr lis lyw lym lnw
dek: sye etf xmi xtp
ahp: icf ivk ytr
ren: bpv cwp cts amn lfr
cqq: ctt ikk ina hfq
jyl: vmz vne vfe
xde: xqc pry
aom: hgs yjw gym
xsi: pke
dts: vsl sbz szl prn
abo: awe apf iys iqi itf lsh
ity: lsl luu
yrq: ysn lrk glc gxj
vvw: vpp siw edf eqv xqy
rgg: rsn agy ibj iqw huj
jgw: vhy sef elh eqm xbm xjk xty
iyr: yzb lcn ggr
vob: pkf
igw: ytu lpu
bei: bor aop ixb huw yds
iux: hlp lwk gsv
jws: jvs enf xax xgm xpk
xxp: pkg
sqn: xik xvm xzo
aea: iip hca hty
dpo: dqe eat xoo
kdq: rwl rod bmn ibc yii ygd lbd gbr
yry: laq lss lpc ggy
wfq: dwj jfu sqy ebz etb xyq
ehy: xhk
bcw: cnw alj hay yci gsf
csr: amr aqo hxw yab lbu
gfc: wxx dja jkv jmv vgw xgt xts
agv: aox hym ygw
cch: cgc imd lfo
xgj: xeu
wdq: wfi wuj dae dmc jfu vve skj sri scw eql
glo: gwq
cig: cfg aei hzz lvn lps
hkt: ylw
rcn: rzb iit idh hqp ybd
clp: yco yql ljc
air: agx ivb hhc
isx: ios hcp yjm
hxx: lgu ldx gjw gxk
wqv: dif jwr jsr sih xac xev xxo
yfs: lna ggj
ryp: rge rvm rus hni lqk
yey: gyf
err: eqy xzk
cas: ids yof gwb
ywp: lya
hyt: hvv ylj lnr gcg
aqw: hpl ykh lqv
anx: hgg ltk gdb
rxz: bcf iwi yah gci gym gvf
ifo: hng hug ght
wtv: dqp vdy sdy sjq xdz
kva: bwz bfv bzv aip aog ivp iqj hzd lol
rnq: brx bru aoy yhr yzh
gct: gjs
shq: squ xet
llj: lvx
ygf: law lsc
adl: hdl
bnz: ybk yak yyo gli
blm: bol hbm
lba: gvr
amg: lqm grq gyz gva
rfd: cbh ara yjp yms llb gei
jji: srr xft
auo: ide htl giv gif
kfz: ktv bec aup hbm lzl
doo: swg exj pbe
epl: xbe xyu xla
rxk: aub hyb yml
gfd: whr wmb jbw ecb
iho: lxf lzk
jyi: vmn scq xmv xmt
xbr: xej
wso: jya jep erj xyg
ebp: ehn xjo
cii: ciu iky hop
jkx: jxr vyt sec xkv xrq
jqs: err eze xax xpo
abp: iua hsy you
gmt: gof djx jle sob epe xya xgg
lpk: gvb
xcs: xag xlv xgg
gjj: gsk gxh
vcb: szr xcq xhj xsl
ssg: ers xtq
wss: syk exn xml
dap: vdp swj sjj sxc eku efa xmd
hsm: lfw
acl: yji
sra: snd etv pkq pbt
sof: eli eee
eix: eli epb xpf pry
dzr: jbj jex vdt sto etz xhg
yrr: lma
hht: hwg ybt yhb yle yne
gjy: gjz
chw: hsa yvj ypi
ewe: xys pcy
iop: yvi
vgp: skg siy
spo: eez xcu xyo
svx: emp pbs
hle: lzr gla gvn gsg
ysj: lgy gdh
ymr: yuw lmk
hhx: hvy yym grp
vrf: erf pcl
gkq: gms
rlw: rlz bsm bql hhb hlw hsu lpi
wxl: jvv vem xgo
sgl: xbx
kap: cip cpf hmc yhx yls
wzf: jzi vnr sdf ebs
kca: rrd hcm hhi ywv ytg
eht: xkt
rod: cdg cmc ilw lky gil
xbo: xim xwu xuz
wvp: dbd joo shw sdv sjq sxt
dhp: dnw jqo vaw spo xhi
cvt: czl azy gyl gxb
sue: euf
cui: ydy luj
aqk: iru yjc lcg gyx geu
afe: iaf hzl ybk ylk
cri: hzb yby lnu lum
axd: atq iwm hyx ygh
ysn: yzf geq
buw: czt iot hty
riu: rnm brx cbu idq lvz
ize: huu yvq lam lqr
abb: abn iuz hon llj lfz
ijp: yqg ytm lst lfw gvr
wdo: wtp wuz dkq jih xgr xev
vuz: sdb xan
ykt: ylj
hdr: lsc ghx
vsr: vpl ssn stk xzb
sbo: sxq szz xcn
bbj: bnw hvu ytp lbl
lxf: grc
dzk: jrb jtt vev vnh xjf pbg
scv: suq evx xku xae
bds: caj aco iip htz gpp
dcj: dsf jys vzp slx eqb
sam: seu sms xpe
jhh: jhm vsu sco ekz efw
sop: xqn
kzv: rft caf aib iwm iex hyl gjf
bpr: cjb amw ans iwm yqw
evd: eqv xsu
bxi: bnj cwe yeb lub
dxp: jjq ssi eak edm eex xil
ylb: lhv
aht: ysy lki lih lte gij
ydp: yzn liw gbp
wut: woh dwv dzx jgh
aba: inl ins ybb
dlp: jow viu vuf sxb stx xhn
hzh: yvm gru
egg: xmm
ygx: ypi
enr: eqf xat
bwk: afq ify hxg yvs gsg
iyk: ivc hjc lcj llx gva
yba: ysa lgs
gdg: geu
exk: xjv
syg: sgg ssk
vkk: vwh vxw ssb sxz esl equ eot
bul: ids yjj lln gyp
wzy: wqf dug emt xnb
lyc: grc
kdr: kew byg bta ael ynj lkb gkl
amy: hrg heq gle
cto: hdo yax lyx lje
eup: eow
daw: dap jwg jwd sik stm xxw
rfr: boj cua aqw ilo hti yni lvu
suh: sow ebu ewf
itz: hbu
gts: wmo wof jeu jun skh scm edq
vgv: est
hfb: ytp
rzx: clf hvv lmd lor gwh
hgu: hdt hdu gjk
vve: vxq
vxj: six sjz sxd xpb xmu
jwj: vjc sbk eot
wza: djb dzi vwz vxc sdf xxb pkr
hsg: led lfd
ago: aju hsl lly gbj
dnc: jhm jdr jjt jun swx eeq xkj
xyk: xqg
bbk: cra aul ipv ifm hji yzk gyw gwu
sqd: eyg
bsi: cof arg atb lkg lxx lnz lqs
dxj: jmb suk evb pkv
whe: dkx dgg duc vyg scd swi eqm euc xbu
jdx: ssq sfh emg xlm xet
sfh: eol xhn
god: wxk ddy jlp vjf sas eyy
aob: ydw lul
keu: bnp ibl izb
wiv: wlv wsi dwz dva vdr egj xcz
rnh: aft hav yvr lji gpp
rnu: cif hlr ysa gks
jtq: ecw etf xkg xxw
yeq: ymx grs ggc
gfx: wri wos jts joq syi sdv ebw
bar: bqr ckw iio yrb
wgf: wwe dng vqi slk seo xho
wfh: jwz vsw vmn xqn
haa: hnb yhx yoq lgr ltz
ims: hho hxf how
etd: xly xgb xuq
kge: rtm clt ahi apz iao lyi lum grb gsa
ipu: hvw gvm
kko: kwc kpc rsa bbs hke hyz ydj gxw
edl: efx xrb xmk
ema: xpx
gyv: gxt
yic: gji gpy
ebm: xre xhv xdl prb pbb
ckh: civ cdz aae alj igw
ewq: xev
jxk: scv enc xli
hxr: hzw lvt gpv
vrw: sxj xtn xut
dut: jjf jqu vyq vga sbl exr xrc
xfe: pck
rwl: bxw iva ifk
iat: hio
vzz: evy emr xaa xxv
cyt: ien iqm
skb: xam xxs xnf xob
hpj: gpn
dsm: jre jok vvj
vlq: vsx srr sfy egq edm
wpi: dne dtf vcd vmt xuv
crs: ayh awj izm yoz lcl lst
ecd: pcv
vtz: swt prm
res: iyh hmx yhz ydb
gqj: dyv dju dpt jrz ssv eix
wvo: wnu slu smk xhm
bip: bus aqw irv ijl iqq ygj
rve: rtg bfl cho hec yae lqr
ksd: kty bjw hud yna
jiu: jfc siq xxq pbi
aqh: iek
yrt: ygj
yih: gcs gyv
jej: vqs ssj sqb eun
gqs: gtp wep wna dcu egz eqo
szj: szp pbs
vlr: sgg sjn efh ezu xxk pba
asp: idb ixc
bfe: cwy cwo ild lbr gyd
kuv: rmh ctw hcn hqb
seh: est eqi xed pbi pca
cgv: ivp hrx yzr ytu
jjz: vkr ves snb pbq
cew: iby isr hbi
bzk: czp cou ips gxl
srd: xxm
lpn: gke gch gjz
drk: jrk jia esq prj
ego: ezh xrr xhj xvg
ruz: rob bzn afu ats iyf hun lrp
jef: xgs xzs
jsh: sho slp eha
wnn: dxi she sdr pkj pbb
dzd: ekl ean evz xkv
azn: ipn hbn hoy lvq
lcn: grs
ilt: itq hmj ysw gwa
gfp: dab jdp ejd eqr xgu
aym: hxm lan lij lxi gkf
kqb: rpj atv hup yiz lxd lpc
hlc: ymz lpc lmv lnj ghg
ysx: lgp lzr lom gha
dvu: vte seh xhj xta xoj
jxu: sna eqo xqn xub
vcp: seh ezh xau xid xiz xnx
dmc: jyz eio edt xoo
shn: erk edd ets
hvv: lac lez
sin: xjo
dyp: jhc sks eoc xsd
dgk: vdz vql sge xvo
yfw: lax luw
icz: ixu lql
dda: vbz xjj
weu: dvt jdp vyd xdm xsr
dhj: vpu syz evp xay xjo
jza: vse sxr egu xit xje pbz
bvs: ckk iys ynx
yki: lri
brw: cim apu hxu lld ghw
sqg: eut
klq: rlj rus axp grt
crh: yca lcr
yov: lid
jgj: jdt jnl vyy slu sgk evk
koy: rio bgy bvz awh iil ihx hpq htd
cvf: ceb acw lrs
dqq: jkn jbh sjg ebb
igy: int hcl hpo
lrr: gkk gpu
ihg: hre yve yni gaf
agt: ano hpx htj lqg gpk
jdw: edh ezv xgj xvw xmn
vmi: skt szq esz pku
ifr: ybu lsa gba
wnx: woz dhc dtg jev vne soc erw xtw
lru: lcd lfb
wil: wtr dfs jcu sdz sxn
cmu: ics hsm liz gkv gpr
kxt: chv iwk ioq gba gci
lwe: lqw
ara: iko ivf ykb
jqw: vgv xxm xzh
iqo: hpf yaf lso gym
kon: clm gkw gpq
vqj: eeh xsn
asr: ipg iqo yyx laa
xwu: xdu
wgq: dae dlq dvm dtj jxm vcy elr xym
cvl: ixm iou ljb gvc
dne: jlf vip vhg vvl xmq
drc: dsu dqn sgd xot
woi: ddv jwz vdj sik ezd
shk: syp sli edd
wky: wjd wpf wfp vhh ssj sql eho
vhp: vqx evv eub xlq xzb
dab: dql jlr syh sdc xry xjk
veh: svj eta xsw
hmf: yny lnt
hmg: hon
aup: icy hlp lkk
cds: cvi aew hkc hkz
jzo: srg xra xlo
rzt: cak iya htw hte lli
bug: amq iho ium hgm ght
xlc: xez
sfp: ewz eeo
jak: vdb vex sxn efg
rgv: rdc bxn ckx ghd
vqb: xfg
cep: ijw hmg hmz gcj
hpo: hnl lco loq gge
rst: cdc amw ija hfi yrm lpc gda
aqo: yin lvf gil
vne: ecr
irh: icz hee hoo
bqr: ioq hvm ymy
wew: dmz dna jue vgi vpj esi eei xjb xnb
sml: edf xxe
ccj: cpo alx hqq yyy
vce: sye sdt xfr xto
wlp: jyl jgp sba shl xay
gur: ddu dji vbu voj sza sti egd
dxe: dzd jaj jfh vrr vgx
wpw: wmp dzj jjc jfj ees
avc: icj hxe gln
des: dot vry vxc ekv ejm xmm
syu: xdc
xge: xua pbl
sky: exu
cbg: yrz gbp gsu
din: jyg sry evc xkp xcn xlg
hpb: lnk gkl gja gmb
ayn: azd ini ldp lfb gmj
vie: egk
vje: vtv sqm ecs eoh xpv
xkk: xgy xsf xxp
jec: jtl ssq ste xfp
vmp: evr
bnh: aib iyp lrz
rlc: rle cbp ajw lfh gcx
bmy: irt hbp ybx geo
szf: xqd
agr: hbq
xhj: xwq
axw: lid
ilc: ise ykx ykf gvy
hif: hhm yje
ytm: lld lup
euq: pry
ebn: eik xpr xzf
epa: prq
rxi: cmd hpd ljx lnx gsc
rat: bvv afm iik ite hkc yab
ykq: leh
dez: jlw jmn eoj
syf: ekz enc xvu
ilr: yhs gkq
egx: xif xlw
eru: ees xvd
rzc: ace iio iqx
axc: hwi ysw lsu gef
awz: atd ldw lfh
ctl: agr hel lco gkm
wpy: djv dqq siu pcb
wjc: weh dva jbb jqz vnp sod
cvy: cfo ahz ieq yhi yfz
eek: epx
htb: htq yxu grx
lbc: lag ggw
ljp: lom
jqa: vmi vfu epd ept
hby: ylv ypa gyy
ckf: che cpr iyt idx ijd hwu hnt ylf
cbo: yyl ygw lhs lth
ekd: xys xwl
evn: prl
lly: lvy gyd gsa
dmf: vth sdd ebz ewa xiq xpj
hry: hgs hjv ywb yvn lbj gvr
hdx: ymg lie
rqs: ciq cwb ihb ivv itk hej yls lpv
hfg: ldi low gww
spj: soz xfb
jwa: vgo eup
aqi: hmx
ccf: ipf
vad: smg ehf xdd pcc
gon: wgn dca vrm vcm vvf ens xsn
ibc: ybc gir
ixs: haw hxs gsm
anm: hpn yep gio gpi
bgh: cgm cvx afl iya ixl ynl
dnp: vld sjv euj eoy
sku: egd xrr pba
sej: ewh esn xuh
jvs: jpw vmu xio
dgv: duw jmi vry enw ens efh ezh
ltx: gvx
rot: bog alj auc aux igy
htz: huj
wot: dfu jrp vxf vfv syr
sak: shp sqs xtd
hfj: ytp
ejo: evi eqz
dfv: jqr vih vix swd ses env
ivk: hhl hzq
xvu: xzo
cve: arg lmd gvt
woz: jsl jfo vas vli
ghl: gss
ajk: yrk yre leq
ezl: xuf
suv: ewm edz xdt xon
syb: eto
rto: bsy cva ymn lzy
dms: dtr jii jwf vbc ssv eir ehv
wxr: deg dzq szk elx emm xsj
sxx: xai xiu
rri: bcz bnb hcd lta
ylt: leo
jdi: sin eiy xqq
rhj: bym bgf bev lkn
jba: vxs sqz eie emp enz
dju: jyr jty
kih: kse ktv rbm bqk btx cjw iiy yhf
bgj: acn als aey hjy ltg
afm: hox gpy
bsm: ggi
sbd: xas
emr: pkp
rau: iye hwu hmv lzp
kfm: kzi ccn aix iij hfs lth
yfi: lcb
dix: dfd jjs jqm sle sga sxt smw snv euu xtv pcg
cfo: cut ica hvt yhm
bay: bae iec yzi lbh lxk ghe
aor: ici hdn hni yju lxo
jlr: jwp jdh jpm sgn ezq xob
aij: aqr ywy
vdr: sqa eak
gly: gsr
dzc: vwd sdb sdf sxc exi ene
wwg: dwu dns jyg vow elb
ict: hnm lif
ijt: hcj yba lmq
dqi: jwm sno xoz
vmz: sya xbp
vic: vvz sbr eeo xyf
xqv: prw
wve: dki jol siv sdl evv efg
yje: gjx
anl: ina hdh hez
jmp: jne juq szw elq
rww: arw aga ita hwt ggf
ddh: vje sjc ebg epp xas xfx
cev: hfc yit luh
ifi: hki
equ: xgs pbx
vfp: svb epm xzr
xft: pbr
glu: gwo
dkc: jdf jft jza ems xjg
rjk: bko bph buy alx ajb gsd
wdg: dbe dwu jjy ein pkw
xec: prf
hlm: ymw
wmn: jyv vfv euh xrb
ruk: cho ikv hya hyv hxr ldr
kbu: rju bxz asl gmj
wjh: dqs dut doq eha eph
csd: ylr yvm
yzx: lyx lzf
rqt: asg ipd iqm iot hxt huy ydk yzw
wau: wif dyo sbc eoy xld xwb xmi
xjy: pku
vat: vnu shg smt
izd: hmx lbr lyg gec
bdp: czo adh aqe liy lnk gpy
sci: stl emf xae xvg
atz: hco hee ycl
ias: iwg lao lwu
diy: djg vhm vyf sjo ssq xrp pbn
lzn: luv
rmd: bmk ahm iuc iuf hiy
vwt: slu
jcm: vvw
bza: cvt ctx iji ljv
wfb: wug ekh ebp xkm
rmi: bak coz atb lcc lga lud gwp
ezg: pbj
bix: bun cgu hio heu gak
vzv: xuo
ywb: gdh
blf: bpg yiv ydl gka
jlc: vnp sfk xvj xfp
gyr: gls
hkc: hjo hqa
gro: gye
asm: ype
dxo: jzw vce vsv xwh
dnm: dfb doz jhd swp ere eyi xdo
gcw: gmv
dlj: jbo shv sww sqs euj xiq xsh xsy
agf: isp
ajt: ann yxx lpo
cwr: lal lww gil ghd
liw: gry
jpk: vzz voi snm stw
jxp: vdb srm swq ezz
wdt: jjb job vgn svh era
lxs: gbl gii
iuf: hnk
cxs: lek ghc gwz
luv: gpo
gua: dxq vdi sgt erl
wbn: jpf vnb vtf sac epk ena
dli: jug vez vzv exp pkq
wwm: dtt jtx vjn vzo sya xxu
jho: jgo vur swl xma
xks: xmb xny
kpw: rss blo auu ynu lbq
dno: dtl vne xzy xqy xtq
aeb: icz ilg hgr yah
irc: ith hjk hpc ltq gbr gds
gft: wpw vgk sed sox eam xyz xuc
jfz: vam vys sha epr xir xls xlz
rju: cvi csh hyv yhl lae gmd
rsu: buv iso ypp lpd
rta: bwy auz yoz lty
eck: xhp xgp
ayx: iez hgf hxi yew gds
vmc: ste xve
rmm: brk bjf bsy cbq aas avl isr
jbf: jwf vpy xco
awg: haa hlk lgu lee gdy
yca: lxn gyj ggb
bur: chg huv lbv lxs
vbd: srk xdo pbj
lcd: gke
cql: yku ygj lvi
cke: itw hwh len gwt
eak: eyd xjw
yve: ytr lve
vpy: vpw sqe
yvg: ymd lcw ghr
wbu: jzs vwd ewt epm xkt
gzo: wpx dlm ddi vap eab xvr
iyw: yev yxx lkw gvd
dbp: dml jcg sam xtn
scu: slo elh
hkm: yxs lxi lol
yjb: lzw gxn
cuo: aan hva hnw lrh
drb: jrv jwx viv seq szf pkg
aim: iey lwh lxo gxa
ehr: ehv epx xrr
bqu: cdy cnr ait ygz lum gmh
bdq: ier hpj hmm gvt
kqq: bax bgb hha hok hoh lhz
jas: jib jfo vjj slf ekh
hcw: lzs
etk: xyz
wlo: jbs jpo sxo smx
rmv: biy cpj igt iwu yez
hqy: hoa lxs
dde: dnj jau
ilw: iwb iva htt
kfq: avn ibk hud hoz yyp ydb lla
iqy: ymc
jij: jfr vtd vow evj efo
vtk: szw emw xmo
vxy: vqb xrf
jbu: jnh vov xdw
woc: des dxs enx xil xfx
wua: dia dsg jlb soc xbw xcw
sie: ele egx
hbb: yzy
avp: ydv yxj lyy
ehc: pbq
chx: ara avk atr yjj
hcv: yyd yvv
rmy: byd bfe cbu ijf gyw
cnd: abj hcs hyi lyv ljq
bbu: caz iyf ipm ipf gpw
itd: ysm lua
dql: dts duo jna soz etx
ham: hvu gkq
lzx: gjd
xku: xwb
kjw: ksv row bee ydv yql
axf: ioy lzt
voq: eyj xrq xsa
rld: rev rqo ajt yks ljp lzw
rhx: rwh ahh amj idc yfp
bpz: bpu ard ldh gva
wjr: dku drh sum xfn
aax: aoc yqx
bwx: aoc
rnn: imm hwa ggv ggx
sed: ebl esh xyu xxd
agd: hal hik laq gcd
hly: yea git
dsn: vkp saf ssz esv
wwl: wol dru jqn vmq sle sxs
bax: bfu iyr hdq ytq yuv lzo
kou: cct cpe hts ypv lkb gcf
cic: cwc akw iyz lkw gll
ctd: ied hro yhq ymj gxb
eqx: eoe xug
aju: apv ixj yeo
lft: ltz
cor: igb ish ipf iqh yua
dvs: joh vae sfq xgm
jaz: eja ejl
vuo: sag ecm ege esv
xbg: xcc xjt
ewj: xag xgv
vup: sqr elg
yzp: lhi
dve: dzb vgm sio swo xsb xxu
vnx: sls eyr exv xmf
swk: xwm
inp: htp
kct: kxq bxb ixp hce hyy glr
ise: ykw ysh gae
wfx: jba jjz vcp sge euo xmi
ahs: haa ytj yue
vkn: vas vey sbq sya xfm pck
hzp: yqv lrb lni giz
iid: hbe
hju: hmc yri
byl: bdo cnj ild iez izt hxi ggf
dsq: dqs ezu prv
ajs: avm amg ilr ixj yse lhu gvg
rfc: bcs ioc hct gdd
sfn: ewr xar
jsi: xbi xac
rzu: bbq cup yxa llq ljv lsc loh giq
sux: ebg edx esv eev eng
irq: iyg hzg ysu geb
yiz: lbz
ral: akv afi ysa yok gxn
eib: etp
bdk: cqs ywm
jsw: jtz vjq scp shh
jua: swy eow
ciq: cgl igl grt glx
bqo: alb ibc lya
aeq: lzs gbb
aaz: agp yiv les
ehq: xsw xpf
bdf: akb ipg hlu lhs ljg
jqy: jtw juv sum xqf
klx: rbn bdo ctn cuy lkb ltt gxu
czn: aen iee hrz yfi lpv
aad: axb ipj itn ggg
gnn: wnv dfz jtg vgc xdc
bgn: cgt ajy ikk hcq ytw lmb
afj: img hkr hsz lml ltu gvh
jpv: syu xsj
rbf: rdw rvf ajo hxn ysm lem
bom: ibc idr idt his yug lzr
bta: aqv lkn ljj
ydt: yvc yzr gvk
idd: yyu geo
jhj: vhg svr ssg
vhu: vlj ehx esv
sry: smu xku xxy
cpu: aez amr ivh hiz
bjz: cmx irm hws llr
bik: bvy cyc leh grd
iny: yed
iwr: iww ivj gwf
cgc: cqi asb afv isf gad
ljb: glf
ray: rel bth ccb ank hfo yap
sys: xnq
cws: icu yxo
dsf: vnn vtq ejg pbn pcy
bxe: cxz axw irx icv iuw
kjc: kzt bwx akj aqt llw lpz ghw gst
dhr: vcs erg eat xir xeo
chh: ian hrf hnu lop
aeo: hqo lbs
jam: jvt vgz ezk xnh
yrl: gvs
rws: afn ilh yts lpb
ijb: hin lkr lrc
soa: elt xpo
bxk: ckv ceo ihp inl hjp
rwc: acs lbh lbg ltc gdh
whv: jos vdb suo xig
gud: wbt dir dvn dqf jpd ewy xbb pcl
rxx: bqt cvk ikm lbn loy
vhs: vll vdm sty ejv eey
lys: lxf gem
ewk: ewf xis
cwo: aex ife hue ykc yln ght
dfw: jie jur vvx scn saf ecm eoz xzt xqk
jzx: sut emv xec xxj
jnp: sij sns xkh xrz
das: jbb jne vdn vjr vxo spx
hdz: hnc gvb
elw: xdf
aio: ilp
gob: ddn vqg edd xrl
cfm: aeg lif
eku: erj xwz
ceo: czv czs
vjw: vns skn sie epf
inu: iop hrh luc gla
kru: cxk afw ipv hic hll yad yut lqp
hqz: yxz yob
snf: eke xac xgu
jxs: xef pko
kal: rcn rxh bjq ije huf lgq
chc: acv amn iza hjf
cyq: ahh yqw ytx
wkw: jjt srd eih xgt
jaf: jyx sim epb
cwe: hvz yaz gis
asc: ivw isw gxz
atr: itd yni lwg grb
kjg: ker cvq hoj yka lqe gyh
vhc: vfv ssr
jan: vdl spk xfx
wsz: wux dtw jlf eil xfk
rsk: bye bvr hut ykj ygg lib
dys: dqh jjk jxt vlc vzi pro pbv
ikw: ijk yrv
vqm: xvp xsc xsf
yco: ygp
cir: ihz ybo lin lnr lud
wvr: sjf sty xcj xhr
jgc: vis ebf eys
ygv: lpp lnq gli
imi: hbg hjx hqe lfj
vlt: sra svw xtv
rgh: brz bsi bfo awm ilq
bzq: atx yru yca gct gas
bmu: atj ijw yay liy
idp: inp hmx luk gvw
yaj: yqq
kwl: kul rxd bhn cpa anf anu azm icn iex
jwy: euh xwu xvm xej
snh: eyp
kzi: rol aio yej gld
xji: xpu
rfq: bpo cjc cno ipn gjs
iiu: yjl
izs: lvt lnk gju
yko: lvl lqn ghs
vep: voc syw esb end eoj pkb
xrc: xpe
scs: sih svo emo xpx
rqc: iim yyk lpv ltn gga
ctk: acp aai alj imn hrk yyh lox
bfn: iuy yqo lhk lwg
ied: hxv yjx lek lte gcf ggl
jln: jfk jqv exn xrf
dag: duw jui sbr sog ezz xll xjb xpk
kdl: kni bws ceb ihr ybs
kjd: bcc bjd icc lih
bjx: iqh iuf gwd
dyj: siy eya xgg
kec: roz hfg hzz ltd
bej: iri hjz yrg yyd ljk
rvy: bgw cwg aoz yjs
xuv: pkk
sfb: stc efk xls
svy: sfh eis ega xef
rso: caa aar yba lxf
dug: jmj vek xkd
lzk: gyr
kuu: bss art azm yqm lxc
esu: eqb
ids: hnf gbi
krj: kbh kij rre bgz ckw cbj ilh hjk glc
vhg: sar swx eya
krd: rjh bpi ypw lhb lpd
ceg: czm cqc aik hyj hza yii yhn
lwz: gsn
bcm: cas ayg lgx lsu lph ghu
cei: cnt anl icu
bfy: bud bus ixc hjq hor
cow: apa hry lyj gcb
ewa: pci
hue: yka gbb
cvm: cut azk hvx gbu
cpl: hpo htt ydp ghk ghb
yal: lad ghn
kif: kqy bkf bcl ibb ips yye
vtb: sjj elv xbk
dsp: jil jsy vrg smj
jvx: val seb xyo
ldx: lxw
rgc: rwy rzc ruf bkh bbz cbl afn hwx yuz lwi lxn
kpx: rok bcg hsq ypb ytg lsy gsc
hkf: yok
iss: hsg lgz
iap: hhz hjw yhn ylq yzo
kne: rwv bdp aak iom hlf lqj
ioa: ygw ywz yne
iuw: hhw hlb
icm: ixg lik lig lxg gyo
bhq: idn hjq lsq lqb
xdw: xpj
elu: ego xkc
jgd: jws vkc sfc
idc: hoj yhb leu
saz: sfq xws xvs
aox: yrn lgb lwu ltf
eyp: eeq
ixu: ysy
gnw: wqa vrs spf ste ebq xcr
elp: xjp xvp xxn
jnw: eva xav prz prt
gnm: gzo vio emg xhr
ckk: cuh coo imv lcm gpk gpf
cis: ijl yrl ylx ydv yet lul gjg
abl: hbu laa lnv gcn
rwn: ahe afp hnx gsz
ygd: lfp lza gcm
xcx: pbx
hwo: yri lge
wcn: wgr jzo vab
xfp: pkl
atf: hxf yai
blg: czd hmi hni ysb yqo
rxr: ccp ask hfa lta
wfo: wup duz dov vij vsf sli szi sqq xji
azc: lkn
vcf: vgz efa
lop: gdg
anw: hll yxw yoi gjg
afq: ijo yno
acp: lsf gcl
sjs: eal efr xle
rrh: rdp rvk ajh ifh hbo
clt: acw aqg yza
wmk: jhv vwi eib xri xtj
efj: xpz
sza: egc eua
brb: bdw cxn ats yba gbv
yqn: lfz ggi
bbc: ild ifs lly lzd
cpp: aro hlc hwe ycv
hgi: hzf lmw
vlv: scu xsu pbr pcs
cox: iwr hdk
vmj: saf xrq
dyk: dmu duc sko eel
hhw: hla yvf lgk loi gkx gge gdg
kba: bdr ckv cwx yje ysq gkz
apx: yeb
gov: dan dmc vnw xtq pke
ckx: cqc ibo ioj hav ylv gdq
kku: rxv bku bwx beo asl ibs yct ymg leb gkd gkn
req: bls hbk hfn ycq yjn lvh lvw
kgo: rok bib clw amr ljh
cmi: hrh lmy
sen: xsq
arq: yqd liv lhz
dyb: dot jwn vbt sgz eub
rrl: rhv chj cef ayk afh yai
rdx: amx afd
dcr: dwn vjd vfl sct xxc xmi
ind: hce yld lct lgg
vwd: swp sjb sos eqp xzp
gfm: vds xty xtf xuq pkh
hrm: hcu hpp yjg lhd lvg lpx
jsr: via snr xyj xfr xzz
hqd: lat
ggf: gmd
vxx: xqe
kfu: art aoh ixv ydp ynn lve
vwh: eff xsz
avt: aeu gga
imj: ygl lie
xrf: xyg
rzm: clw aas anc hcg hal
bfj: che cmw acp iza hyo lvf gsa
hrk: hvk yvv
vbx: vwx vsg vel eko xmp pkw
jfc: jon vxn
yza: lrl
wqk: juv viy vvr swr eiv euc
cxk: cmh iyb ijx iso
ckc: aqs iyz hpr hqp lre ltt
dle: dqv vue sdm sva emx xhj
jlk: jmh vbk von sre sqo ewy xqv
rdd: bfk cfm cuz coi aqg hrj hbm haf yly
juv: sww sdz svf
bdo: igu
eyt: eqf xcm xhd xum
kai: cup ycn lri lez lmg
ekn: eol xcg xpe
ssj: sfe xqg xus
reg: roh brh cgp lnq
cqn: imm gwo
add: ist hnd hom gln
xdj: xvo
knn: btx cki aba aph hic yje
ifd: hwp hxc yth
hdn: htd yhu
igx: ivu loc gre ghs
bwn: akd afa htt gjs
jwu: vqp stx xon
ysk: yes gpa
leb: gsv
cta: yyd lrd
jmt: vfr ema xkg xat
jtp: vyf svm stw
bqh: cjz iyt iow ygv
jle: vos spq egm xgh
bfp: cfn ipa hzz ypl lvt grb gap gat
ehs: xmc pbo
wip: wgs ddr dni jqr vks eda est
rbt: bqh agx inp hrr hcv hqh
bhs: bwv hvj loz
aao: ajo yim
crt: cyt aik yrr
shd: eku eif ett eut
ife: ymr lin gkq gyy
lfs: loz
izi: hdg hee law lqn gdr gjc
him: yqt ltw
iip: ytd yot ggw gdr
eya: elm
iiv: hzl yrx ydw lqx
dzt: vju vqh sxh euw xev xmg
hjz: yaq yvp
khb: rip blw bez bpm ace ivf
eeq: xjt xpe
dtk: svh ssu epj pba
xlw: xws pbu
dtv: vam sdj svn etj euu xib
lsv: lxj
svw: spa xoi
jwx: vcb spz ebr
hru: yia
ysl: lrl gwz
jiy: jvf sug esx xky
boo: cqc lqe gju
rzz: icg hwo yrd lbk grx
hor: yqp yqz lah lle lgx
dyn: dqr jds seq eid eno
edu: xac
wls: wze dax dul shn slp ekw
ixm: lmr
yye: lhq lzk
esp: xfe
kni: kuy rqs bts ayu ata hkh ybd
lae: lxo ltq gpk
wnb: dec jqi vrj vvb vpr vtu sbd
kyn: cbg csq cte iwn lid
igf: iuc hqh gaj
ith: yby yfq ytl
erv: ead ezn
wvv: dfg vuf eic ewp esp emc
jbw: ser
wpf: vpi sjy xzh
goi: wkb wqy jfq vyx syd sgj
kmu: bfw ylv yxz gmk
vdg: vxg snf ewr xhl
crm: cxl iaj hip
euj: xgb
bnf: auu hge hdp yxf
cnk: gpa
yvs: yev lax lwd gru
yyn: lbl
kti: akj aes iax ycn gav
vxb: xkl xjv
epg: xkx
ieo: hcv hnr llh gwa
ris: csx ish ytu lay
ave: ani iqj itg yid
euc: xqk
dmp: ekg edu exv
rom: aho atd itj hfu hza yfr lvk gwb
cnq: iqw heb yan ymh gls
dds: jzk vvb smf egx xwj
rmp: bpj abc azu ily
rem: rnp brs akw ida gey
dhw: vip sry snh xke
igs: hxz lvn gif
grg: gdy
iue: hbb hdz ycc luy
vgx: vvl skk
wol: dmd jau vux
bhz: alq aww ipz imi hnq gjj
yjl: lha
cwc: ibk lgw gjd
wwh: jxm sjb eto
spe: smo sto xck xts prl
hwb: ydi
jgv: jdn xdh
htq: gxh
anj: ihs hsj hml
rxu: rfe aen apn ihf
dbj: dcq vvo xdn
kyq: chu arz aud hrk hld hxw yze ldj lev
icg: ieg lzu gej
bwh: bxj clb alj idk ijs hls heh
jfg: vcl sew euk xjy xmc
sjq: efx xmg xnm
wer: dwh dvu jrd jsf vbf saf etq
jgg: vhl vso vxg vqc
and: idz hcg ynd
lmq: lfi
lvg: gxb
raw: rsx izk ylr ymi
vyc: vjn saz shh sxv exl
aas: axv azm atz ije yih yei gdo gsl
ecv: xkq
wcu: drq vrt vql sby ecg
ryf: iid ijy ykb lxp lfe
sgh: eid
hwn: hjq yyb lca lgw ljz
vxf: sdo ebi pro
hkp: het hzi ykq ymo
dvp: emd xza
jvd: vbo vzh vzz xkc
rfm: iba hgh hnw yyr lgs gbq gek
auk: hqh hux ykx yfk lqh
jqq: smj eyv xje
sdb: eup xkn xyy
sct: sgc eje
bjo: cfw ilu hbb hso hel
cml: cqw ati hda hxq yqw yun ldc lsy
sjm: ekq etb eog
wrq: vvc vxp evx xpw
sjb: sxh eby elv
rsz: rpz cmv aji ipv hgi lkh
icl: hgc
scr: szp eln xhp
kik: cny apk yvb lvy gpg
vxp: snf ehw
drm: jvz vrd vda vzz syt edo evv xyf
byy: btq arj ajb anz iwq iwu
wze: dni sxs een xfw pbl
cub: ake ipy ynw lqy
wqi: dws don sxy xsz
bed: cka hfi yku gwx
hen: ybw gdf
eao: ett xbb xhh
gld: ggm gjk
amb: any hhq ywd
kub: rkh bya hlg hfl ypx
bnu: cur hmw hzt ywh yqv lel
gkb: gik
crk: afi hkq gdg
lbx: gde gxd
rvr: rns rtb iwj iqq lmz
dri: vdy smk ebr elo exg enq pbe
afl: iwu lpc gcr gew
jim: jph jzd
wbw: wvt djh dqw vko sse xdu pkr
bze: aki adi itr lry
kuz: aty ilc iur yrl
ksb: rnr cil ymk yfh ljq gcj gih
eem: xvb
egd: eqc xdl xvw
hla: ykk leo gxp
vys: shb smt sqz xxd
jxn: vun slk sst
voi: xkm xjl
hxj: hnl
akd: apj anr hbl
bfw: cmd igq
akb: hqv yvm gpn
wlg: vkt vyu sxn sft ebc
bns: aks iwm hws yay yef
iil: lgm
lsq: lnb
wwp: dbm dcv jkz scx ezc
hso: lbt
kpd: bea cai aba iyh lct
dwe: jgb emx xfo
vrg: vwn ver ven efk
wtq: dhm sra
rfp: bbd csv auz hkg hho yrp yow gen
jpg: vgj sah svw eqo
bqy: cps apr lft
kmd: ihn ypo gra gjn
dkk: dvn dmr jfu vcj srj spc soe etx xpv
wps: dbm dns jap skh sfg xcx xmb
gup: vbi vao vhq sxg xvs
bsl: cov ava azc ivz ieu ixg hkq hdk
djr: vsc vtu syo ekg xvz
bvu: arb aef azx igk hbp hvb lta
via: eym epi xjr
jyh: jjy vky vax vvr vfa ekr eeg epd xnp
wlz: wsk jkp eyh esv
xcf: xpf
bic: iws hen yio
dwr: vbc vzo slh
hhn: huf lir lwf lvc gkh gjl
vfz: von smx ehh ejz ezt
wsn: wqw dpa jzh vhs
cbr: iya iyv ijq lnd
jjs: swl xbc xnc
ilq: hto
jzs: vjp enl efa
evf: xix xji xei
ixz: hsy
cie: arl hbq hmi
wts: jbs jml skm sze esg xqg
kzm: bhu clz ako ayt imp yhh gwe
abe: ico ieh ljv lfk
svk: eba eum
dem: jgy jsi shc sqi xee
lyo: lnh
vtf: ekj ecv edy xzj xqr
dtg: jqg vuv exb prn
wtu: jzq sbu eyb xnr xzn
dti: jco jjh vby stu xxn
rcm: rgx amq gls
voo: syy eeu
ypy: yqr
wcs: wdg dnk jnp vrc szr egx
whk: jaz vrw srs eiv epj xkw
gqb: wed wtq vyq snr xoi
iiz: yel lis lez
xem: xmm
xio: pkn
jgi: jqt vhp svu
vtl: stu eqt xrt xzm xtf
ycy: lvv lpp
abs: yaj yef ynm
yqo: lcl gah
szr: ebu xkn
hmh: lbr lyp
aok: ifw loj gec
ghm: ggr
bow: agm hfv yop gjb
kit: bfg ckg cya iyy ipn hme
rlp: bbq aga hqx yoe lym leb
bqp: hvh hok yvo ljm gja
dpf: dmo jtp vxx ehi
guv: wdo jyo vrw ems xop
wyb: wom dpx jju vbi vyl sqw pkh
ewz: xbd xor
yte: grz gxr
dqg: doo jnz jfk vrr vja xpz
jlt: jsk sjw sto xgk xul
ehl: exk ext
ljh: lul
rcr: rpk brr azq hrv
scl: san sxo stm
dfe: jqt jtc vvd edj xnc
rze: ccd cxn avu hki hyi ywz lsb
kfr: bjq ivk yxo ypc yza lue
ipi: hlg ynl lhk gbm gyk
bdt: lyz lex loq
xdy: xfg
cbj: ybo lau
cng: cza adi ast ite yja yje
jfe: vqb sbj efs xgo
ylj: ymp
kxd: cva ifk hpw hmv hzc lia
ije: ybo
eep: xpx xmi
dsv: jye vjz xim
hsb: huo ywl loi ggm
yrs: gbc gyz gpd
hsv: hnb yem lod
xga: xpx
chk: iwh ieb lgf
ioh: yzd lcn lvb gld
vhm: srr soe
kjb: ktu rsx blo azw yen lrj
awm: icd izf lqf
hsz: gjl
dnj: doy vsd ssa spd xzs
rtz: btj ctp iub
ruo: bkc ieb hyu ybe lsd
rdc: rnw bsn ayo hcj hir lug
cbs: cjw hjo hmz ycu ydc lps
ssi: ezx
cfb: hbu hph hft ycg lbv gaf
jxo: vju sii syi svn esj xyf
yds: lah lhw lol gav
wfs: dxb dov jbt vjb vxe vqg spt ewb
aoj: yso ytr yuq lmq
gdk: gjn
dsc: jpc vfw vfx slw xjz
aun: iiv
rvo: roz bns buw yaz lto
rzn: bbn bqe cxz atv iew hrx yuh lsi
vbo: pko
btg: css aik itg lro gkz
axo: ifd hki hmu ylj
gao: gsj
aex: atn izf hbx gll
vjl: vxj vtj eyj edf pba
iza: hrm hgv ycn
cgt: acn igr
jdj: vxe skp sda eii
chs: hcx hje ymz yzm gaw ghu
rlt: reh ahk ias hsp yzo gci glc
riw: ami yan lla
ruh: abw aed iom yvt lld ggg
aik: hci yaa lyp lsy
dhh: jfg vhz evg
bhj: byt iyd iqd gvi
adw: hgn yen ymt lxb
ltq: gja
wrx: dyg dek vph ebw eln
ktv: cww cxf cqe iun laj lhg lmu
jic: jwr jqi vai een
hrn: yke yif
cuv: lju lvf lud
its: hqk ykj ydq
hbe: gix
kxz: cfq agb ivp hig hpr lwz
aow: iir hym ygp lol gby giq ggp
ccu: aar iyu yzg
sgp: xue xor
scz: sjy
jgs: soa xeb
yfh: lpy
jyj: jou sjn ehe eye xpy
bvr: cbe hzn ymd ymp lkt lhi ltw
bbp: bfb ayu yjy lnl gir
rtq: ctw awm hfy gba
ktt: riv irf hiv ysn ypd gad glh
vxv: say xmn xni
xbs: xec
cjp: cuo ibv ipl hjx yfv
itw: ygl
hlv: hum ywk ltp
wia: dkn vqu skg ebs
wse: jll jub smu ebr xrw xxe
een: eqj xkn
lmi: ghh
hne: yre
wqc: vcb vsv xnj
ere: xlf
lwa: ghq
dky: vaq ekx xwu pre
ynk: lrx lgm lnp
gui: wlu wge duh sdu eyi
blr: ibc lco ggi
cip: ipg hsf hna htm gvi gsy
ihz: yba ldc gbd gyt
ymo: lik
rhv: rvl ayl hpw lpe ghu
cfy: ibp ldg lqg gdq
cah: iyi hrl
ddd: vtc ekz ecx
rko: cew hhx ydd gww
dze: jtl vlg vzf ssl elt pri
lvq: lxg
weg: vhb sbu smk xsv
lyy: lvb lty
con: amc afe yiu lkd lro gin
isw: ygw yea lzz
jly: jna vvs snz esy
wxq: wuu vxf erk ebq xtm
bnl: boo inz yav yen
wnw: vvy veg ste
ibf: hfq ybx ymf gma
jcj: sir xed pbz
rad: bys bqm bog igk ixs itz
jpc: vrg vza ero
wbv: waw dvk vle erg eio xgo xph
iwj: inz lig
kcl: rqp aig aem afi yyf ypc lch
hgf: hsf lzs
kke: kyc rnx yar lhv
aqb: ilv lsj lpd
vzh: vue sva
rcf: ryp ber hdl gjk
vpl: saa xbc xsg
jzu: vfj esl ezb xpe pkt
elx: eed ezj eta
wht: jtw srg snd ehe xxn
srh: erw
cdt: heg hol yjo ypo ytn
hkq: hbi hms gjd
woq: jjf jfd vwy sbt spt sfm xti
wwy: sik edr xhs xpd prn
sfj: esy
jpm: vwa xcr xtq
awf: afu yeh lfr
eod: pkd
jry: snl ewq xwb xup
eja: xrz xvf xom pbm
vpv: sps xlu pci
jzk: jqc soh ehj xup
xbj: xyy
sqt: edc xgk
hku: hxp htk lkp
ahb: gxu
bjc: cbv cwi yng ldl
ejc: xuh
cys: cnf ahr amm anj
jsa: elr
bcu: isj izt hsp ywy
llb: ltn glo
wcm: way jyb jyh jwz jef vda vze srz sgf seu sod xeb
xhq: xvy
avl: aui aum hjo ycl ydq lgs
jay: jqg vzs sjy xlz
rdu: aod iab iww yrp yzd
bxa: ahv iem inn yua ljs
slq: swv ekt eej
wlk: wzo jpt xpc
ijr: hmb lgw gag gje
drf: jjz jqn sld ssd eyk
eil: ehd elu xef
xvg: xxr
lpc: giv
ate: yjz lfn
shz: syp eko eob
dzz: dtg sht sef
jdv: vmd sla eyd xdb
bbt: hcr hnd yuy
egq: enc efm xzh
wfk: wqk jab soc erz ejq evu
yqh: lxz gir ghr
jft: vae eha eno
cuj: amb ixl
dlq: dde vtm vom srt sth
yke: yay yvh lol
arr: adr ivd hhp ywb ymc
lez: gjs
dad: jrn jws xyc pkm
khq: kdi kvi rrb rlu csq ave led
rwy: bfz clz aay yzw gam
wax: jnl vig spf eaq xsr xqe
lnu: ltl
hrz: ymt llc
idw: hfz
vja: ech ext epl
yhf: gan
jvm: vqk swz xjn
rzh: bcr bcb anh ysq lrh
sks: ehu xla xzb pbz
jql: vyz vli ert efw xnf pkx
bai: cnc hxf yaj lnv
wtp: jpk vie ems
vge: san xsi
iwb: yhw gbp
hqe: lpj
cjb: cxy hsw gyd
imt: hsd
dyt: jxx vvm shr eyc
ytr: gpc
cld: hat yyk lao
krl: ruc iqt hae hqd gig
hjn: yhn lhd
wmy: dlw jqa vdb vzo
evo: xgf pbg
cga: cnc cnp ikd hjs hfr ymi
rsc: rqu roi cdj avh avm anl aoc ivt yqa
aay: ada isb iqo yep glw
kvp: ksc ihe hax ldg
wwo: wxb wxo dns jgy jul scn ebg
ynv: gdn
rnl: bcm apa ijt iqa yfb
sbt: svq
wjw: duy jow etj xvu xsn xxw
clg: aie awa awi iug hkf yua lly gwb
jie: jnj svc evk xba xcx xhd
yep: lje gbp
scw: edn eqf xph
rzf: bwc ime hcn hpi ymb lsl lel gjp
bkf: bbi cgq cjf ctm abe ach ibg hkw lbb
wzh: wzm slx swa svn etk euf xym xmj pby
xme: xqf
ibq: ipo ypx yul lyz lnp gak
ixv: lag gbh
ixn: hrr hor ygg
amf: auz ihd hkv gmb
ihm: ljn lte
wvg: wec wfg veq sue xjd
hwj: yla
jmi: vkr sxb xyt xut
lzy: lug
dte: vee smg xjm xou
jut: vbb scf sdu
imp: hxo yng
yhx: yot
ynz: gpn
enb: xkf xbe
vsi: xcc
ytv: gdb
bpg: hpu yeb ltu
ikq: ieu heg hta yrf gbf
jih: vug swr esf xee
ych: ydu lvx gru
wex: dgs jac pre
iaa: ygr gdp
kut: csk cxd ipv izk ytt glc gdq
xyn: xtp
roj: bxd clz amd iqg hon yea ltj
yot: lab gcb gjd gxe
spw: erv
ixo: yhw lrk lfe
hpt: ykb
yjr: lyv leh gac
efk: xci
exu: xtm
chp: afz iaj iuk ynj yzp lec
vdj: srz slr emh eqj euk euf
rwk: bkq asl gck
kyz: roo akp apx ilw yde gpo
esi: eqw
wsp: dnh jba jfz vwc ega ema
lgp: lnv
kkq: rku ryg rjx bqb yfv lvw ggc
jat: joe ved eyv
cwg: ifp hga
wth: jlc ehl xms pcs
rtp: agv icj hih hoz
smt: ewi
soh: xve
byu: inx hps gjn
all: yvx gie gmj
bws: ake iet itg
xmv: xqs pch
jsz: vaw vvb eeu xww
knp: rmf brq hjh hob ytr
cap: aev yya ygw yex
isy: iuq yty ldz
rby: rgx bca cki aro iak igu ymo
krh: bab cev ala apb hwg lza
jcu: slr slc std elv pkv pkq
rlr: abs hdr gmg
gto: wsv vih vwg vpr smp sum xaf xwq
cez: akn imv grz
bux: cgt csn czl hyc lkq
vuj: xhk xsr xec
yoh: ljk
ina: yyx ynz lhj gby
she: egi emy xgz xqv pkz
scp: spn xbm
eza: xfh pch
hps: yez
hfm: yfo lgd
hyb: hqz yco lvv lsf
aia: hls yra lcq llj
hnk: yjx lyh gde gxl
rvm: cmr ibh iot lxk gla
esz: xwl xsb xxi
edm: xdj
bfa: lgn lur ggl
hos: lys gly
vdi: vql sfu esd ezr xai xah
yhd: yqf ldx
idy: imt hhh lyi lwa
yvq: lmf
svo: som xyc xnm
lfr: gbt gvm
btq: cdb azi hla lzg ghr
bjq: bvg chr cuf afs hsb yet lfy ltf
yap: lum
ays: alo aef gjo
exz: xki
vwb: xaj xor pre
ama: idn izt lyo lxl
dnq: vvo xge pbs
xbm: xxk xns
lyp: lgn gxf
jty: sco
jge: jdm xnh
icv: yaa lyq gwk
rpu: btp chv any yhr lbu gsx
rya: rze bcx cao cep cuv yrm yhi lqk
wpr: vcw pkg
rkx: rtc hvm yhh yfg yqa
wfc: jdm jmj veb
yxa: lvb lto gau
sdd: sds end xyt
jjg: jqj xan
brd: bdr crj aio auc ykf yvw
bwy: bsa hpr
kcm: ahc ahz ikz hji yag
jzy: jqz vmp vzz evn xky
jld: vgb evw xiy
rwb: cje axy yvi gbg
ahz: atr hxi gck
hqh: gyd
deo: vwh vnp erg xll
dfd: ekb ekt xio
wws: dtx sut ell xvx
kqt: kul byo hza yiu
due: jsc vct ssz xic xlq
cum: abz awm
lfc: gyy
wrd: jio jzk vtz xxk
cit: axq iao hfq ykh
hae: gyv
ssc: emd xux
kbc: khx kxx rpq lkg gxh
yyo: lsf
egt: xot pby
ing: hvd her yfn yqq gdj
cye: icq yky yhz ywx ydy lzy
ifw: lkb lrf lwa
hqb: luu gln
sqj: xti pcd
epv: xdh pks
art: ixi
cuw: lnf gaw
aoy: hmu hob ljg
sii: eud xxv pbu
saf: syi ekf
lvk: gjf
chj: cti hhp hsk gsh
imr: ycx luv
cab: ani lju
wbi: dos suz ebc ewq xee
lxt: ltp gvz
hnh: lag ltm
ift: lbr
dxd: jyd jmh vqv vup sip pbu
hme: hmf ydj yme lwm lsf gvm
kre: kmi rel asq hlb ydf lbe gyo
exm: xsf
hdd: lvu lsl ley
gcp: gmr
daa: dmi jbh
cnm: add idf hky hxk ynv lkj
gep: gpz
lyq: ljt gwm
bsd: cvi izy yxz ght gjg
hlh: yqe gwj gxo
kvq: ccw hyp yab yvp ggd
dsz: jmm syo swm
cym: asn icl iqc hro yuj
xqh: xom pkt
amq: azy lax
dth: jsy jfz vbz sly
wcr: ddo sir sgu swb eye ewx
rvd: aih yfl lbp lfs gwq
iib: lrh gaa
vnu: sip xst xmq xff
kzp: bks bnt aiv hsg hxp yhg ytf
wtj: jui vbq siz
hgb: hul
rme: rfl hmc lbd ldz ltf gxv
hio: hzm lov
vis: szy xzc
dof: jgx xvl
saj: saf ssp spk sfd xtv
yvu: yoa lbg gig
yyl: yfc yzt lhf lwr gdk
khu: ror cui ymh gxp
ewy: xie pbr
avr: ijk
smz: xnp
sqz: evz xlz
xik: pbj
wdx: jsg eev xay
jil: jjl jpd jmk xrg
lwt: lxq
wsr: wno dnm jls eol
sav: eex xld xln xwu
iov: yrb laf llx lsi gko gje
dlc: jsk vlw vwj voa xjz pcr
ypj: lqe
lzc: gci
egp: xff
cfh: yix ynq ltq ggt
wkh: wce jhj eum xag prk
jwv: vuu scp sah sxb
kbk: byx cdg ikx ihl hxs hth lir
gyq: gjj
grd: gyy gjt
cfj: aku afr isf ium hcm grc
kxu: ryd rfl rtu bbm yft lrs ldz lox
eee: xvy
kll: ram roh igo iuh hwd hef lsa len gjv
knb: cqp lcj lhj ldr
dci: dcq jnf jun vct vvi etz xlk
kmw: bxy bzc aju iwo hdd hxg ysk gmj
edq: xqv
aln: aet hsj ysm lss grk glo
ctu: hex yyb lga
crp: agj iss iop hfb yaf ydw
yyy: ydd lff
buj: cvj alw azh aog aof haq lbv
ijz: lzv
dph: jnh eqk
yys: ygd ypo lzv
wfn: dfv dum vhw vvc xra
iyd: ywe
yyq: lrl lav
dng: dtu jwz vgp xsy
lma: gps
doz: jjq vjv siu exy xfh
sfd: elm
jar: vkl vkg vmx smw ecu xbg
eoq: xkz
sit: szj xjq xxz
alq: awe ike huc
xxl: xmk xqt xux prf
jhb: jta sxo ert eqv xkj
ksf: ibf hxk lbm lpq gms
jra: jba jqc vjx sxv egk
wiw: wlk dct jxs jtg sxf eke xiy
eai: xga xef xzy
has: yow grk gxf
diq: dzf jfk vyu scd xlz xdf xfe
kzf: bbr cru acz aqz yau gdv gmg
lzu: gpa
cih: cld avl hjw ycu yja lsz
suq: xly
sll: sgl eoc
kun: ray ahp amv icq yqy lfa
vfy: ekd
acj: aya iny yho glz gxx
cro: cxo axt iyq
wrc: dpt jqv stt ehz evs esh efl prc
szm: evb ems
svg: stn soc ehc xya
axj: iky lfn lzh gcv gso
yzg: lrq llf lup
rha: bob ykg gii
yvi: ymb ghc gyq
dvi: dvn vky vjd
bkb: bwn
ijx: hwv yoc
ktg: kuj czf ahu lom
rga: rpp cpx czc ivy hrz hqs
cqd: apj igv hga hom yfl
web: vzx ekt erh ecw
emf: xxl
rax: rmv rnl crh cgs cuu cok awf hve hsa hnz
jjv: ecg eqe xgw
eqv: xmh
edf: eva prp
jkr: jnz jfi jfw jtx ecl xbs xis
khe: kzf bde iiv ybl
vky: vxs esj xwm
bli: ckq cdh czy aix
ank: irl igj yfs
scg: sta evv xkf
yir: ygc yzk lcr lpv
dgt: jgf jjg eym eoi
jtl: skr
jky: jik jvf xlr xdk
hlg: ler lmu glt
sat: xhp xne
ska: xvw
rvu: bke hdx hvv hzh lkm lsq gap
hcl: hyy ghy
csx: akl iay
jae: vjp erk exq xos
jey: jfo jul vvj spx ewj xln
rvi: bra brd asg igz hvr yvr lio
ieg: hrz lmb
szb: ehm eti
jmy: vra vvu ekv ejo emm enq
ddx: jjx vro vlg vlu vqj shg sga
hgq: lbi lth
cqm: axx yqq gdb
cdu: hhe yuu gbj
stu: egd
dcg: daa jac juo syr emf xjn pbh
ibn: hor lrq lbt lgi lwl
deb: jfc vpb sme
wpg: jir sxe xav xdd xum
jcp: vkz vaz emk xlg xxp
cyr: asy yio yvo
hxh: lao
hfo: hom yik ymt low
knc: ryr hwm ydg ymn lya glp
yao: gsq
dei: dnn jjj vfn vqy sjr sxl ewa xrk
vfn: szn xby xya
sun: xbg
agl: ajz iaz gmi
jht: vrw xgn xjr
xgc: pky
xvm: xnd
vdn: xhy xyd xpc xmh
vba: vbs sgq sdw xsk
xtk: pbl
kts: rgd rxa rxt cbb cun iwz iqx hgo yei
xzw: pkj
dgg: jyp jvz snq
dwg: dde sbo suj xmz
rzv: bcn bxh cbo cog ixu
sua: ejj
ynj: lmd gld
spb: ehn pkb
bgu: cxg azw iib grg
cfw: idu yee
gmu: jbw jgp vlf vsc epm eqi
gcn: gel
xdh: xzv
wnm: dgv jtc skv egq evq eel xrm
xxt: prp
sbc: smt esi
dbn: dxc dxj vso svk eex een ene
yso: lgg
don: jwe vma syq slp erk prq
jkm: vli vxi sfl efr xcf xan xgg
rpn: rug ifx yvf lsv
hin: yyu lxh gvz
vqi: svl ewi xfp
sqf: ejf xsm xpm xfn
bbv: bho arm avu iia isp
awc: yqd
bes: csm ifi los
jnf: vau vtg sfm
ssr: egw xca
vbh: sbr sys snj ewb pci
cwv: ikx yur lgg lvu
hvx: ytl gbu
wnc: djp voq eow
bsr: iap ijc lza
gzq: gqj wjn jwh exl
goh: dfe sja ecc eiw xpc
wee: wpl dvi jgb vsi xct
wdz: dhl dyx dei jab soa
agb: yop lrd ldk lqv ghe
spr: ehv eho eef prk pcy
xlo: xng
aws: inj ywx ysx ynb gin
buc: cbt cxd iqy
emw: xbc
chm: clf anj iat
rsj: bms bfj bfn ivm lme gbj
sqw: xsb xzl
bpc: itx lax lir ldf lfh
jnd: jzm vjk sdy smg
exf: xyb xea
rcz: csi aia ydl lhf lsn
gog: wth don ery
jia: syn ebq ewb
hde: gdn
rle: bvn bxn lrt ghx
sce: exr xus
wuv: dba dur jfu jta joi vwg sit slk ejv
whp: dii dhk jgr vgu vog syx spd evs
hrb: hgz lac
cqx: afu atc icm hly
lbn: lcx lww lfq
wiy: wgo dbt dhn job vpl spi
bgm: bvg ibx ijc grn
sft: ehs
sju: svi eiy ell xbd xtc
gfs: wym dff snh xug
eid: xbs xcc
iod: lid
bcq: atc iwu hqv ghv
bat: hep lid lda
sqb: prl
syy: see edk ezq
crg: giv gse
vcl: vxx ehf pcv
yux: los
krs: kcu kjf kjq bkg atx gdd
vnn: xfq
ydz: yqg
ecl: eqn xrh prv
kga: blu cjw aod ivo hax
lrh: llm
hbh: ygn
wfv: dww vlq sqg eou xkw
hlt: hmu yhd ysi gxk gpt
hyh: gwg
ins: hoa lft
chf: aia ykf gbc gjg
emd: etu xia xvd
vna: sjw eib xef
ecj: emy xiv
rml: roe ckv ikc ini hdt
vrb: skz ejw xva
rxc: bai cjb csl ihw glz gsv
wxy: dyw syz sqd epz emg xvk
wne: vst vml soe elx emz
cpc: lln gdy
wiq: diz dok jbt jqs vyq swc sdp ese eqv
kxr: chw icr izo huo lcd gwh
vaj: shi
hgv: hoe gsd
sek: xgw xpb pkv
eip: xwf xvs
cnh: ivc ims yup lbx gsd
ccl: cif clo huu ysz ltr luw
ywz: gpo
eqm: xta
bsu: iwq imo iol hhk lsy
coq: acl ayk lvv
azf: yew gdy
iff: yvz gjn
lbt: lpl lpo lzl lug
slt: sqz
lus: gdt
sqx: epu xdj xvy
aat: ilr ifz hiq hnd grw
wlw: jse vel vzg xro xqs
duv: vrl vby vwh elr pcb
hjs: lws
dst: sam sxp xij xlg
hni: lgu
llc: ggo
wkd: wpf wnm sdt
vod: suq ewo xah
vhi: esf xie
cpd: aqe lss
htu: lme
jwo: sif xsq xeq
lvy: gwh
xcn: xlf xmk
dhs: dqz vhb veq str
rfi: bta btd chx clt cwh akc hyy hny yul lsn
ypb: lvz
yyz: yma gvb
daz: jeh vxl sab xbt xjg xev
ype: leb
bxy: cjm iiu hrk hgo hpe hou ley
eye: xlq
irr: iit hnt ldh lmh ltq
wzu: dby dhu dzd elv
dod: jkm jof vke etx
jrv: vee scy stt esv xxo
vel: xrh pkz
rbz: rqy blr cgb hyc hyz
vgi: srw syl snt eai eio elf
efe: xuo
rgf: rfw ctk apt igq iwi ivs ybw ygg
izx: hdg lhw
cqj: ars adj axc hmm hfd
btd: gsn geg
jlx: sxy xbc
yjn: gpo
dur: jhw vng sdn
sox: xrx xce
jlg: jfp sab shq egd eej
sph: erx ecy
jbl: jul vbn vfo pkb
bod: czb htu huz gyk
rex: brh bzd cgp hfo
wqx: dii dgt jdj jpw vay sav xxn
apb: hjx
wln: dff jyi jfe sre
wro: wng jgs vwi svn eph xzc
bpu: cux aiy avf hvq
iif: htk htz
yzc: glh ggu
hoi: ywk
dgn: dwq ehp eyr epf xjy
efy: xle pka
sfz: sft elt ejh
bdv: lma ltr
hbi: hyv hzh lks gyf
gql: vlv sfj eiu edg euq
duy: jnf jfk
vcd: sgs svt
bkz: chl iaw yeb
xpk: pko
irk: hql gjh gvi
syv: eqh xzb xob
ihx: iwc hrh ymc ltt
jii: jtn eka
jni: vne vti svr xhf xfm xqb
jdp: vrc sbq xcw xpg
hzm: yqj lhg
vcu: vnt vtw vuv smw eks eqf xhs pbd
hsy: hny yhm glv gvi gem gpb
ain: ito yyf lch
dmo: dqd vem sye soa
ilm: imd gkx geq
jrz: jhk jvd jpw soo xdw xzt
iqa: hdb hpq lxy gwj
anq: aqk aui ljo gjm
slb: sth xsd xex
snv: xrb
rpz: ahl azw ige hri lbm lfb
rhs: ibh ywc yjp lct
sfc: suk eao
sac: eka exo prd
joe: vgt sch xrz
kfw: ktb rwl beu bne ihi huk
hmz: ywq gae
bty: aax ahu haf ybx yzx
gnx: dau vgh voz syz seq eii eus xlp
edk: xgd xua
dok: jxn vin sgp exl
izc: lkl lfc
bca: ljk
vsj: sag ekt ecd
hoy: yxv lck gpg
hyf: ldx lns
jvi: vaj slh sxs edo
xgo: xjo xoz
hvs: hpw hzx lxb
btb: hhs hek ynz
hbs: hzi htx yrb yxf lac
szd: eej
rbc: bck bii ali aqt yie ymd
aqm: ijp ixu hce loa
red: cft yxk ynn yor gpo
djw: dqm jcp jsb euy xcx xjb
ktl: bnx ijr izh yls ysg ldd gvz gex gpr
kua: bia blu cqr akh gcb
klf: bha byw bdc ayq ihj imx iof hea lde gpe
dhi: dmf eku exc emz enq xxi
ima: ynv yot lwt gbt gaw gax gxk
skn: sza xjh
ski: snp
hlo: hsm grf
rhh: bkv cqs lyu lwv lzt
ahq: ald iwv inb inw
djv: jgf vkv xtr xuw
ewn: xrt
ipx: hks hwr lzs
ecm: eer xzf
lfw: gcw
bzz: aur ixh ykn lsm ghm ger
ikr: lvr ggo
hmv: ygt yna
anh: ity hhu hpy
dxs: juz vhd xfk xff
baa: hrw hmt ljj luj ggm
hxo: lga lul
hhz: yub yor lew
gko: gyg
czx: axu igg gjh
jvt: jpx vwh epn
xpm: xfz
jme: vpz sqz efs
hcy: hvz hzt ynr lab lhl grm
kmc: kmn rzf bjd cez ami ifj iua
ayv: icx hva ybb grg ggh
liy: lil lok gie
apa: aoc izl
ixh: yns yog gik
dvv: vcz vsx sxj xcq xjq
cop: yal lgt lmf gkz gxc
rda: bsb bfn crz ihg lhw
aar: yxh llo
idn: huy ytz gez
vka: vbn vax vpb
wfz: jpv ezv xwd
wey: vfz scd smd ekm xig xuf
jgm: jvu jpb vkl vku voo stj ejw
hcu: ygj
chr: yhh ygn gyj
jpp: joq edh epx xnl xoy
sez: pbd
kjm: avl hmb lia ldc gik
kqh: blr aed hxi yyk lux
cst: ios hmq lyt gyl
dhc: jds vuk sbx xry
lpv: lmn lzu
ehh: xkf xar
kpv: ajb apx iyi igz yja
ejm: xay
kka: kbs cpx axl gyg glq
ans: laj grg
cpe: cpm ihu hjm loq
sba: ezo xwf xdd xml xnv
eoo: xax xsg
yjw: ggb
aqt: iwh lhr gib gwq
ydq: yus ghj
vkg: sjp sxe
bzi: crp cpe yek
lra: llt lso
kgx: byc bsr iys yup lid
hcc: lvz lxm gxt
cgk: ihs lst lzk grh
hxn: ybg ygw lyz
dbr: vbp sve ssc ebu
wlc: wss dbc dwp dmt jiw vjw sbe smz
hwi: luy
ijh: yjw lmk
ivl: itk hdx ydv lpn
ily: iog ynf lin gkg
ikg: ipj ycd lkq lre
ezk: xrw xib xdn xen
duu: szv eah esu
rec: cfu atr ise
czs: azt hst ybc lvn
rfo: bru bgc iys yoq
hvr: lcd
vrx: xgd xdf
ezm: xfi
kbi: kpr rcw rce aaq aia hrz
aaf: yqo
hxc: yai leg
ykv: yyw gbk
rui: ipe yar lad llv
srn: spk
cnb: yol lap
lsc: gpu
aef: ikb iqd ypb
cuu: aag aot ykr ytg gxi
cha: cyv aju ims hmg hta yba ysb
riv: brp auh icx ino hzz ysh
bmc: iya yrh lnt glp
hbx: lox
eyu: ewt xbe
kmh: bca hjv hvw ylc luj
rkc: rdu avj hst yad ggu
cyn: ipu hiy yew yuo
jzi: joi vce vwq evx xja
wus: vrj eng xay xfp
vhd: ehb
jud: suz eaf epg pbr
ioq: hnv lzj lql gll gln gjx
bkx: clh azx icb hsh
yzn: lvq
buf: ctz ahl yqg lfq
wnu: wtk jbo jga vsr xhu xyb xqs pcy
kae: rym ikk yab yhv
del: jup vdx vjd ver egh ejk eor xzq
coa: aeb ioe hig gkq
slu: sgf pbl
bpf: cfb cqx ayn awz idg ium gsh
hex: yjv lsf gcd
hta: lhi
rjs: boa abd aml ybv yfa lpk ghx gll
esx: xdh
sle: swb pry
wkq: jls jdm vkt vjk sqx ezp
iwg: hru lru loc
clm: atw ipl gkz gyo
rku: bkx ilm hvf lbz ltc
dil: via vtu sor xih
rfl: bhy lks
hgd: ynz gaz
cpx: hlz
jcv: evr eva xlm xot
cse: arh acw ian iat lyw glr
wql: dqu jcx xle xdw
vjd: eod xlu xfj xqo
efl: xsi
wfu: vgh eqe xgp
did: ezm euy
ytz: lqa
ibj: hse
cjl: hhn hfo gap
cln: ibt iyd hyw yjd gcz
iaf: yex
wos: dat sou etz euu xhx xwe pkm
dgm: epm xia xlc xsw
kfg: csj ato iai isi iex hdq yuh lbs
inz: ygu lkh lzj
gtf: wrw wlj dkh dhe dlx siy exe xxo
kze: ibb iub hku hxa
sdm: epu eoa xvr
ead: ehz xqm
eaf: ewt efy xwg xfg
hox: grj
vof: sax sde svq eif
dgu: jba eti xbe
aji: aeo isp ife yob lti
dvb: sze eez xga xon
kcd: rcw bsr cbr akv ixc ykw ygj gbx gds
aen: iva ghw ggm
dxy: jcx jgt eov xpc xzk xtw
wdy: wnj jvc ewf xwy prz
dhy: dxf jvo jnb juy syl sxx stt ezx xfq pkd
jdo: vci vaq sus
rkp: rwx bbv ath igv lqy
rth: bho ifw hyc hex yml
vut: sme xbj xyr xxl
ruq: chv cmf azy yzz lsc
woj: dzz jju joz vtc euw xka xls xsk
jfr: vcq ser xis
dzo: jwr sqm xwg prv
ycq: yim gyt ggj
gmf: wlx wft vfr xyk xys
vcj: sax snx edn xyz xph xqq
wjg: drw dtq jap jvl jmw xzb
wsl: jcx jxu shs snw esm
xyc: xgy
ahu: afb iuy
yyf: yvb yzy geg
vxg: vov sjh eio
ihh: inn yzo ytc lxv gag
ibd: iyb ive hib yqu
dkz: dsz dmp vhp shk sfw
ekz: ejv xzu
dko: vvb sng prs
jja: skq sxs exw xvn xmy
vqo: egt
bmd: isx hep lqp
jmu: sbq eyf edw xkg
rlx: cza iwg izv hrt hgt lyd lgv
wxu: dpg juv vwr ewg xdk
lak: loj gjn
rgj: rqx rua hxp ypv
eje: exf efs xvi
bqn: awf yrl yll yey lou gdp
sfx: xap
rlo: ruz bpj azh yub ldj
vpm: svc xdr xqg xth
ves: svd ekr ebg elb xrq
yli: yxa gsu
aud: hhp
rck: bvi cvc yuz lzw
bwg: ceg ctt all hae yna yos ggl
yjs: lrz lww gcc
ysg: gag
eas: eib xid
bls: bmp ybl lyn lem
vok: evk xnm
hyk: yzc lui
bgc: cll hrx hxj
ycz: yhe
ddt: jwr jqj vvv vqc exr
jeg: eeg xic
shg: ezh
ayb: axt ydw loj gen
clr: ctx ikn yar yvy
hmu: yoy gsp
vvz: sqq ezi
lax: lzj gpw
wyw: dhk vuw sst pbt
jkw: vyj vzb sbg xdh
ick: ipy yuz
biy: czf anp irb iat hkb hhh hwq lyr llw gii
cdi: ila isx
sog: xtt
hqr: lid
yuv: lpz
dwc: dfr jxn vae vlk veo
wmj: djj sck xry
spk: edu pbh
swl: sqd xjy xop
kzk: rcu chh gcx
rhg: bmd iqm hzv huf leq ghv
dca: jfr saf sig xno xzi
dtf: jxs vcy sqp ebu etu xye xwk
aya: aon ipe ymm lpf lqy
jpl: snc
den: jjc vrh sha ela xet xmk
wzd: wus dqo ved sir
aqd: iyd yjb yxo yqw ggp gda
wsh: jzn sty xgy xfc
ccr: ifp hqc yvp lyb
drh: jcu jhd jyc jjj vpz syi ebd eha xco
cbu: cjo igo
czr: acj aeq igf hws ylg
cwb: ann att ifi
klu: buq cfs aql ija ljo
jzn: xhe xfh
szw: elz ezb
crc: lls lsv leq ggm
rfk: bar cqf lkb
kkt: ruy hbz yqx gwr
cdl: ayu yhc lgx lgt
jmf: skf sid xyp xyt
sji: spl
dib: dlg dod jgt jsq vwx vvn
yoe: lwf
eyw: ewa
hzd: yko ytn
waf: jch jxj jtj srj sql efs
sns: xgm
bkk: bth ccn hie yyv
vqa: sgw xyx xvs xvo
slr: ekz
vto: stl xkz xvp
baq: ioh hgk lhx lsq gbb gea
bup: boj caj aki hrq hcb ggr
vgl: szu xmx pki
kgn: kfc bpj bqk lsx gjb
iwz: lwv gvb gst
hqm: huv yny
ike: idu ivq hlm hxa
bcb: ihl ybg gvp
gzk: dzo jcd jyx emt xsl pre
wcz: jid vrp soa xxk
cdr: iux ion hun ywl lmi lmy
ywf: lpi lof
imc: yqj
vju: era
hgn: lwj
wok: ddl jdt evi
wly: dyz djv dps vbn ser sma xxe xul
syk: esd xka xno pkp
jhe: jwh jso jnh vxa xhf
weo: dmi dmp jtn vjb vpr vqz scg sem eec
iuv: hkg
ruy: awr ivt yjh
woa: dya jef jxi sla ejq xzm
afd: hyd hvt yct gcr
hii: hwy yss ldl gbe gdn
gbd: gpz
kdz: ryn cxu abu ijp iev ygh laz grw
jyz: jps sxn szz xwe
lfo: lun gdm
vsk: voe exe enz
chq: hio hzl yso lih
dfn: jfw viw vdg vjl svs euv eou
wgl: wvx dou vyv vds sfj eqq ett
bye: btn adb hlw
iin: yhx lhx gep
xgt: xje
kwh: bui chl apo yez yzs gps
jot: sik exw xoc pru
wtz: dmx dqp juc vox stm xkh
kxc: rqi rtt bjr czf ahl hxs yyv
gqx: ddd jcm jsx vud sdh egv pkm
ssa: edk eqa
xag: xnt pro
ddw: vls vmm sdo svb xyz xtv
gqd: wur jkh eew xrx
koo: ibf ivc hbq
kag: clh ahf yrc ywj ysz lbo lvs
ahr: apt ikn ijm hkz
dgx: dpf jpz sqv xlm xuh
dwp: sog eie xab xtk
akj: afu ibl lct
gaj: gld
aub: htg ggd gvk
jgn: vhn edl xys xsh pbf
vtc: egn xkp xge xpv
soc: xgz xvp
iqm: hpe
yrb: lhx gkx gep
gww: gpl
dzf: vud sop evs
itb: hkj hif hpm yyb gak
hhy: hda ybf yjx gxz
wwr: dcy vro vei xys
kfi: rss ros csa apj izt lix
kov: cbn afe azc hxz ysw lbl lov
ros: cio ahv gif
dzq: jlx vds xwx
eki: eer
dso: vgz etk xbt
anp: ifp hlk ymj
jzw: pru
bjs: auz ynb ltb gsw
rei: aro acm hbr huy
azu: igj ljz
cce: igz ivn hyn yqu ged
ssw: ekw
ddi: doz jqm sfd eya
kem: ktu abn hcj ldn lxp gry
hce: ykt ybh yos
hlx: hsd hqv
rjp: baf bip cyk ifr hob ysc lru
yvn: lmq
kto: rgc clk ake add hnz yzz lfl
isa: hyi yfl lxu gcz
dqb: doj vlo vnf vtk sye ecg xfb pkf
hrj: hlq yjw yvn lwt gsk
ruj: cyj cqo hbi ybk gbf
xbz: xsc
luw: lol gme
wbk: jen vbt vdn ecv xik
bbd: bye cfb lxw
bcf: cht cjc aag ibu ihj hrb yiv ypt ync lir lqu
eok: xfn xol pcb
cgf: hde hdo
rgb: bnt ccf coi gdv gvj
csq: cxj hby yiu gci ghi
lkd: lll lvd
vgo: stf exa emh xqf pbq
adg: ytj lbi lxv lzk
juf: vxj sgd
iaz: ixp yrj ybp ghz gvz
wko: wpq jnl vtx sdo
lpa: ggn
iuh: yry gmx
eft: euk xxw
vca: vfd enl xcd
cfc: czf aud ikb irv hap ykt lds lvx lpl gpr gpj
lzh: ggw
wsc: wpp dlk dmr ede eji
klr: bho bjt ycz gkp
ryn: rlk bnd lmz gjl
wgw: div jgu scy
ekv: egs etm xfx
swz: eqg xyq
dqf: jbg jgp vms seq
wui: ddr jvr eli
vvc: spg eam eqr xqx
vau: sxi eee
yrd: ywz yzf yuv gwh
gag: ghu
vas: san sha eiv xhg
dpu: vbp saj xax
kxn: bog idv ioa yrh yvo lxc
ekj: xqo
dsh: jys jwj
krx: kdn rpw bjx cgv agf ilo ivb inm ifz haq yht lct
esa: enf xbr xxq
cns: aab idg hbc hoi gmp
gip: ghb
jcx: vst ecp xml xnc
aix: ikh idm ifc hsn yjy yvl gcq
doi: vvi vum
cci: art atr hal
jdk: vln vow sso
het: giw ggn
lxg: gam
wie: jyv vsb sjl eem xyc xly
bgp: cjv cpv hvo hmx lye
aft: aup iqb
bcp: bez cuu aqv hmt ykq ldn
akr: arb hdi hmd
bee: iqz hcd hfj grc gxp
ibs: glp
amp: hzb luz
isd: hpt hzp lvy ltj
iog: lvk los gar
ycx: lpb lmr
cpb: hyu ymg yts lpc glp
vdm: voj eub xww
ync: lno ghk
sxf: xbt xwj
cfr: ibl hht hwj
ejf: xlc xfx
vsx: ehg
dxv: jcm vtt edx xwf
hrf: hth htq gaz
ksy: rde rjj blt bjx hmj
kar: riw bur lio lok
vlh: vlz ezb
jdg: vhu ven vnl
wnr: dco jgu joi vsu sir
sax: xcf prg
gqk: ddz ska sgy xye xxu prg
boc: crr iko hlu lha
xxc: prp
rbd: aga anq hwq yfj yqx gks gia
cxe: cmg apf
awb: glm
eqf: xfl
jxv: jzm vjc smh eai xhl
jga: vcu vgq szd ews xlk pkk
xww: xxi
amt: iuu ybk yfz lnv
evk: xps
bfo: awy iel ipp lit
dhg: jal jsa jza vrv vzf srg sap xkr
vsw: ecp xrm xdm xvo prh
cdw: luv grq
dsd: vnp epa epq xcm
ayr: ity hvg yco yos
gzg: gue wsy dks jzg vty eyk pbp
jne: vli
sev: suk
ypr: lju gvd
lat: gvh
rrg: bas cqo ibo iwd hts yrw lux
ykw: lgy
ken: rau bfz aca apg afx hct
ysb: gmb
khr: kwz kdt kmt rzf bfs bze hbg hbf lhk
iah: izi lyk
rnj: bhp bee irw ylt lqd
dlg: dnv dfq jkx ewu
vgj: vwt xep
xxh: xxw xtu
lvl: lfe gke gpy
ytb: gem
jsy: jtv vdk sjm ebe xqn pra
hky: gsd
jbn: vxb ezq xbc
hzk: lbh lzo gex
crf: cbm cut aml hqg lxt gvw
yst: gkv geh
roa: bbw ykp yhv yzi lzu
jlz: set sxg sme exj xxa xfp
avu: asw iig hkl hku hve ldo
eua: xca
hjr: yow
ccg: czj adc afk iar isq hxb hpx
hiw: hxb lmf gke
vmh: ewx
jpa: vwh ehr eqe
bph: att gbd
kil: kxa knq rrt bqj cmg aep hli hmr yac yxx
epy: xri xzj
xyp: xmq
yee: gmc
jce: vek sco ebz
kso: rli rvn ccf cnr aka aaq lvn
epn: xry
lro: lph gbz gem
yig: yeo
kiu: chr are ipw lwe gjf
eyh: egv esy xbf xsw
lgb: lmv
xlm: prd
rie: amw irj ybn yzv
cbx: hnb yfp lzl lqh gai
cdx: hha hub yag lls ltx grr gye gyx
wkn: wqt dqs vgv spy sff xad
vyd: vmz sbf sjb ebv eap xyc xpm
khz: rwu bho awv iqc
cjr: hsf hxp yje yxd lwo ljq gbj
ygo: yfr gbe
wra: dkl jzm vhe sfz esw xhb
gmq: jac vyv smw epk xzg
bmf: ayy idf ivh
yfu: gvz
ywi: ydl
wty: vfm shz spr sfa xpu
lxb: luo
lkb: gke
ido: hzg ylk lzl
rzb: rtv ccg aaa inl
lyr: lmd
bjm: ago adi aum ykp lqe
gmz: wfg dtc jdu vbs sky
rph: cvz cqw akn axv yky
sar: shu stw ema
ijc: lro lwy
elq: xfg
ipo: yeg lmm
wre: dac dzx dot eik eip xnb
hgj: hmu
gqf: wpr vuh scv snq sql
hwl: hsk hmv yqa gvb
jfl: vjg vvi vxh vxy shd
rlv: bvx bxx azs izg llm lwp
aoc: iah glg
cqg: ajv aej isj hjd
khf: rih rwk bhn bgv bdg arj lvy ltk
vll: vob sac syd xao
cwn: agf hzl lbk lpm lot
ypu: ghu
whq: jrc jdv jsp scx sfb xfm xtm
yyg: yys ynh
vti: xvf
azj: iwm hyp lsw ghu
vdt: vsi vsp eej
dse: ewd xfl
kzd: cff aho ynl lrh
yfm: gbj
rqw: ika hxe hpr hms
saq: sxw ewn xge xxn xpe xfo
cil: awh huz gbf gpn
ayt: alf hkv hbj
wep: eyg xvs xfa
vhh: vlj sle edf
aul: ioi yif lih
gtw: wnc dmp dug vwg enu eur
ckr: ytu ldy
rol: bpm itc yyf yjz lve
wzk: dhi dhh jsu sho sel sfr
beu: cbj azo aov irx yde
kqr: rst bgg ius hcj hzj yxl
ybk: lbq
vwa: sgc sji sem sfl pkt
hho: lat
cwp: ctu hra ljh
sqs: elk eed xbz
eed: xlx
dmq: vhn sey snr evf
eud: xhw xlq xws
sna: xck xla
kth: rct arv afj ygx gdl
run: cye cda ife yap
wsg: dop jel veq epn xpl
sqk: xkv
hqx: lbb
eul: xsq
ips: iqo
xkl: xin
vxz: vmf sgo sek edp xtf
ecw: eux
wbj: dvk doj vas vhx ecf esu xvi
rjq: aie ixv yup ggs
rip: hau lbc lsx
sip: sgz edk xgl
smh: exd xze
bht: cvp cps adu aqu hji hqu gwn
ypn: lmo low gvd
kjx: bok csr cpj hzy
acz: hyi hdz hta
klg: amm hra hhf lnx
vcn: vaa spi ezo xwg xuj
vow: sta epj
cnl: ibm yaa loz gli
llm: lsm
jzg: vkl vvx xcl
bbf: cms ahw hwr ybj ggs
sgg: swn ebe
ctj: ihq idv yro yis yyb yxc lam lit
shf: xzl
kna: bvt acu aqr ips yll lyk
yqg: lyh
lcg: lji
evg: ezk
bzt: akb ijk ijy grl
ewp: xuq
hcj: lpt gce gdc
exh: xrz
xcl: xpr xpq
ywn: yqc lhy
igl: lcz
cvz: ast aeu atq aou yzl
ayz: ien hnp yoe lhf
jpw: xap xjc xnr
yll: lyt
iem: ipz ysj lld
jcs: ves skk xof pru
boy: aat ilb hcm yyu lut
wqr: dnx jgw jzp vzq vog xbs
wob: dse jhi jjj sab swg sji edo
dgr: dvd jbn jgn sku sxu ebd
itf: htp gdt
yvk: lfe
kir: riz blo cne hlw htt ycc
xvv: xss
ive: hoy
jir: jfb vgo
ctg: aiy ibw ijf hhj yyp
lmw: lqs
wrf: wal dtw jjt vuy szp
bpn: asd iln ige gcj
wpa: dmi sbb edm eof
wca: wsg jfd sro ekj ejl eqq xmz
hjm: ysk
hez: lrm gce
gkp: grn
aug: ixp
dyc: vqz ekm evi xmf
iys: ixi hhs hvl hea lpf
elc: epe xez
gqp: gub djr ebt ehr xdi xpi
rxg: rps roa byl aco ikf iti yjc
amc: iqe itw yod
whl: dpe eiv eob xrv
kry: bqs cjk cmv ase aqb hew hqn
izo: yga
iol: lyo gxs
kbd: kwa kmi rlh bgu att hgp hum
dzu: dtc jbi jpw vqs sdg elq
xsj: xze
dss: dfm jog vfj xsj xnx
voh: syw erc
arv: ayi agw hkf yhu ysb lbj
eyj: evl xru xeg
xkq: xus
dwd: det eiv pbf
kvc: asn atc idg yox gym gjv
wrj: vin vnm srv xyw
xab: xha xdp
etb: xal xsp
wug: dkd dnt evz
bgg: amr itr hed
hgt: hsi hqu
amk: ikl
rne: bkh aqq iug lar
cwq: iph hqs ytr yth lon gah gvl
gum: jad vcf vdf snr xzi
ahc: aoa iie ytc ged
rsy: cgh aat gjd
jzm: viq vnw xhf xwf
wii: jlp vls ehp xdy prq
ayp: ycp gyo
hja: ynw gkd
yvz: yxb
efi: xav xdn
eyb: xqp
ref: yvr lih lnq
lha: ltc
wvd: wzx wtp dcv jmk vmw vms xur
wdn: wnn wtj jkm jol sxc
jrj: vww vss xpr xmv xzt prd
kvg: bbm anq aqs hso yus log ggc
vwf: voi sxc elx eof
srv: ect xbp xil xnh
vav: scv slj ewc eeg ema eoj
yel: lgq
gqu: dkk dky jwr vlh vjd sla eex eqr xic
wvz: wny wtb dar vcq vji sjz pbm
ycn: ygd
sqm: ehq evo xcc xli
wwq: wni jks vtt
jjh: jmt vvz sgv eyn ewj xbf xle xuf
cra: ceq lyo
rcd: cnk hub yhg yen
rxw: alb hsn lob gsz
aaq: hrr ljv
bwt: ccr hsb
iba: yis lmm ghg glj
xhr: xzm
koi: rmr cma ifs ifn hyh hld lgt lzn
yfb: lhe gmc
cxq: agq hqp
xpr: xti
rek: rto boq gjl
dgw: jra jng jfl swk sqt epy xlo
rxj: bxa ajz lim gxy
siz: eqi
vfd: eaw
jse: vsw ebl ela xcv xyz
pkk: pbt
jup: vau swx xjd xnn xzz prg
khk: kpk ccn ceu iyg lbr
kdw: kuv cph ahu gau
irb: hpo
enj: efk xif xxl
sau: eqx xao xdb
wqh: ddb jrf sqg ebi ewx
hlr: ygc lvc lvs
ezj: xoz
lta: low
lkr: ltz
are: hvt ykr
kip: rdl bya bmf abs glm gsh
dcq: sml eem xic
izn: ioe ynl
jps: vcg vod xji
dwl: djg jbz jdx jjo vno xvj
rvk: rta brm ibu hfz hzz yrz
dow: jxm vlj xhc xst
sms: elp eda
xbp: xyw
bie: azj hjr yim lgc gwp get
coi: ike hvq glt
jtt: vkd vts svc ssb emb xpw
scm: xhu xvv
kek: hmb lpy gkf gge
eaj: edc xjn xzh prk pbi
koh: bpn cwa ivf gha gwo
vdq: sue exh xhg
wpc: dlh jtu smz xpb
jze: stl stn eia xhg xxq pcc
ibx: ift iqy ity
dkf: dqe ewz xoa
dub: jbf jcb jvg vbw vhx vgd sfz eql
skg: xny pbn
dah: jgc juz vds vvx sxz snq ejc xcs xiw
cjj: cjs cvj ynh yum lsz gaz
aam: aao ale hlm ytd yot lrs ghw gxe
hje: ytq lcb lwi gpp
viy: ebz eam etc
cgs: iwc ytj yto gxt
aum: yrf lgp ghk
egl: xxl
yvh: yus
etl: xjo
eta: xjm xmm
kjk: cef cpx ijr hvn lqc
lea: gsz
kvd: rsh res rqn cal ara ibd iwe lih
cmc: afn icw yby ygk lzj gsk
diu: dek dfi skf xkt xlm prj
rpt: bht bva ilj yfd ytq
adr: iku ihl yvt lsj gxo
kpq: ktz rrw rmz aeg aoo
kml: ktc rkh ard aqi ilj hte lcz
ytc: gyh
atj: iyd ymm gha
hnf: lsf gbb giz
wvu: jsy voq spp snw snf
ltr: glg
sdg: euq
wlt: wqe jjo swt svz spt ehx ejz
xlq: xds xqs xom prr
kym: kwu ktu rfd ban bdt bny ahb hvd lus
gns: gqi scd smg egm evy
srx: saq suh evj
czj: ahs lxr lng
bru: bxb cba csh ynk gdt
syo: xtl
kvs: rht rxw bbd haj hsp
igo: hby lpq lmz lzx
vjr: xrl xov
epu: emj
ces: igg hyr yar lye
gls: gxy
icf: yer
rjv: ayi hfa lgl gcm
eiw: xjh
gtj: dys jas eki xgh
swp: ssi
xrg: xrs xfc
xnl: xfv xzz
izq: hlv lje
coj: ifx hnq yao lqm
igt: yig
ads: anj aur ist lqu
aqp: hsx
xls: xtx pbb
ybi: yqe lku ltp ggu
kcy: kwk rqe ruh cfd ins hcb hcx
ibo: hka hxw
vpa: ejr xlp xuh xux pbn
hkx: hdk loo
hrs: hzv gcy
dgz: ddt jde jeg skr sit spt soo
vtd: skf xin
dic: dev jiv xwv
cxb: ycf yhr yvy lhm gga gvq
cnw: czj iwh hds ywv
llx: gjw
wbf: jap eju xyd
sug: ert pkp
cmr: ahx ady lzh gco
dpa: jzj vbp xbi
hdj: gag gsn
vnp: srx sir ssr xaj
kyk: bqs aks hco gdk
hqq: yve lxc lmh
ctf: yjh yqn lfx lon
vwr: vxm xdq
vlz: vub sgf eip edr eod xtc
yzu: lgj
jxa: ven vxr sig shc svw elq esd eoq
xcj: xsp pbk
ali: aqc hfj ynu
hmy: yij lnd lnj lti
ioo: lxy
lng: gbi
itm: hax lbo laz
bpt: chk ifw yex yfm ggc
ags: atw atx lae lvn gyf
egf: xbn xse xmy prv
hcz: hdh ynp ljv gic
brz: cci yxi gcs gce
goe: wls jsa jtd sbo shl slp sva ecj eyn xdg
dkj: drl jex sqb
xlu: xfc xqa
ebk: eiq
azy: ilg lyr gjj
ltd: ghv
bdj: ahz hwk gde gjy
jrx: jgq ekx evv xyg
rlm: bsg bmw coc imh ycu lbp gev
ycj: luu gwu
evp: xwz
sfk: edh enk
vmf: ehf evc xhb
kdx: ryj rta cgj cfa afy aqf lxd lou
sro: sqd xrj
hfw: hfp ygg yfk lwl
wtn: dbh jeu vau skl ehs xcj
hef: yrk ylv ymx lny lzi
acc: asv hyh
ern: xgn
bzl: cba isz ljp gbt
rgi: ixw hki lnx
hsj: hps huk lld llp lgf
jrw: evo xkd xos
seg: exv xgw
igu: ixx hcu lnz
vri: vzp
kql: amb inc hrw hss hqw yym lbu lfk
dfb: dzn jqh srq
swf: eqw xgx
yab: yel
rfz: cff aau atc yvo
juo: vws xmn
wea: juw joy sgp swb esl eur
rmo: clu yem ynf
dmk: sua xps
iyo: iel ylr lhx lmg
ksa: kpi rew clk afx lha
ipj: yax
dgi: jzm srb epc efv xtk
kam: hej yue lqm
eve: etj xuk
wdv: dlr djx jbz jhd srh epm xgr
xsp: pbm
jrc: jrt jwk vuk xey
yuq: gic
cbk: aja hax hze ylv ljt
vfl: sac eax xnt
rxh: roc cjk anx gkf
sqa: eov xia
cvv: axc igj ior
ypz: ldr ljg ltd
hcs: htu lke lgk lxw
kvv: idw yac yqj ytg lnu ltk lun
bdy: iea ior hra gyb
bny: cnn yfy lpj
jel: vlr xct
irt: ijg lqk gbk
xer: xtt
vtg: epu
clw: ame ywr
ihs: iqp hwo hel hqy
hpx: ygt ywa yqz lhx
iyp: hfb
hba: ynm yno lir gik
cph: cny iig hja hjl
dyd: vwz svb sqp eit
yhh: glo
hss: yfo lbl lcr lwb ggt
kbr: rsm blq bpd cbx ath law lmi
cij: cqh iht htg lbv
wak: jnn vrx vnp szg xbx
kqj: csx cqp aed hee lwb
wta: jjr vgs vwk sml edg xuv
att: hho lxe
wqo: dox vkb sib sdi ebd eth
hib: hht ymq gbi gwl
wjf: djw stt xna
wtx: jek vnb sqj evx
bfc: cgw yce yyt yzg lrf ltd gyy
rys: rmc cbl akp ioz gbb
kvt: brk ijj ybx
dlh: vwc vss vfi slj swu xeh xfj
bzg: cln agr iej lgn
wrz: wxp wqq dsj vlp ewv eet xig
kfe: iyq ygf lfa gjq
dev: vgr vwl vdk vdb ehv
agn: asl ils ius iol ljo lsp gxy
kco: kjc rgc ijv imh ywc yda yml
kzo: ccm chs ios hip yma gpl
ykf: lhc
kkl: kyw rrh rvn blp aeu ilk
wym: wej wml woy jha shn sjb
jiv: sef stb esa xub
iyl: hzu let
adx: ajb gpw
wrh: wtc dcy jgk jug srk sbn sie sfp eox xze
kbn: aaa hhj yom les lqh gyg
stm: pcc
ckj: ayw afh ijp ime hlm yxe
cqw: itm hap yij
kay: kgs ktw rof bkj cjj aio hrk
bly: cki acu afl hel lov
jee: jxd vhx vmc eib epz xkc xbh xvk
wgy: dsi sgo ehw
lsx: gmy
hdk: ywd yji
lkj: gyf
dor: jzs vvn szm elt
hzt: gwh
wba: jej jpy xrt pro
ezp: etb xhe xft
vah: srv sse sot eru etq xkh xfh xqv
egh: exi efo
dkw: dxi dff enw xzo
jjj: std xkd xag
aau: imy yoh lgw lzt
yyx: lle gev
vbt: sez xir
aro: and
sea: sts xco xsa
bzp: cto amt ics ily
bgv: hag yhi yzk
vyg: eul xbw
irm: hyo yif yvi
xvq: xuo
gzw: div jga sgs enx
bqd: auz hjz hus gxg
hyd: hzu
aec: lnh lfi gxt gpq
juj: vat voa ebf efg
yha: ghx
eby: xhb pkp
vqe: swh esw
ahm: aza iju llr
hac: hjt yep yxa
hro: lil lov
cbw: avk asr iau hwb yvg
apf: lsf lnf
kfs: rjn cmq aky acr ihn yex gpm
gim: gee
aof: hcc lhi
rcu: rje rue bkw bel cyz cdc lah lsd gwy gvf
jyq: jvk swf xav xlm
rgk: clk hag lia
acg: ywu gaf
dbu: dtj vwl smq xtb
gtq: vzu eco evo xaw xdr
imf: yyz yxa lrq
yyb: ywn yzl yuk lne
lkg: lbw gpa
dtn: vnz sbq sgk sxq erz xte
dfr: jha vln vxj xme
gtn: wzk vrp vbm vvk syu emn xxr
rus: bxi ite yxl
vzg: sjp xfo
kya: bhp cdn ihc hhv
jwl: jmm erc egk ejb etf
etx: xlu
gop: wka wic dls ssn smr xij xek
kvh: rpq chw cvr cnj hhn
jmq: scc eed xbw xip
aly: azp iix haq lvu glg
rzd: adk lcu lxr lup
rxe: iab hmp hzb yrd lia
bcy: ilg ycz gya gsc
bhd: ctr hgd
apj: int izz ypg lft
dqt: jgv sld std eup
spx: exv
kvo: rea rzn roi aul imc hhe lzm gwe
blv: ikt iil hba hjk lzy gdy
eda: evd
jeu: vsx vsu syd xfv
jqz: juf xfd
brp: byk izg ioe hod ysv gbn
ana: and ihk ixa imf hbz yyg
wjm: jef jxg vpu vnx
hkz: yhz lkx
rmc: ccf ceo asg apa auy hlk
bge: ajo hbe hox lkh
hes: yec
jcw: jsk vod sxn ebf xnx
bja: bek cwp ixv
biv: acd ijl hvj hvx yho lsu gra
hqo: gks
wyy: wvr jkh jax vkw sxk sot eap
eap: xld xpt
hrl: lux gdz
ipw: hjo llu gxo
igd: hrd hgx hto lbz luz gij gmy
vvs: sdg stn ekf ewb xtx
rhp: rmn rfu bwt iik ixu ioo
vjh: ejy
afp: azb iii heh
dzs: saa sqe eup
hji: yde gyp gsl
jrl: jcx jln jjy slq
wcg: wmk jxd vgi vgf sqb
hlw: lrp lul luz
wmx: dar dyy sar sdl spd
bjh: bur bop hhj
bap: cyh amc aob ljq gax
kui: kud rwj byb apl
jrr: jvn vyz vdj vdz eek
yhk: yoz lzg gvr
jgl: jjx vqt ebg ewk xyp
sal: evi eus
bxc: cso cze apd ibl lrq
lah: lwz
wbx: dci dhy jbk jgf
djc: jhg jpq vkt vlq slp
gyb: gva
dpm: vkr sfr eip
kpt: baf blm arn ank hfx lqu
kra: rbd bwj ckc cgr adx lzh
kgv: iyl hul yyz ljy
huc: ylq giu
yxk: gme
vxk: vmj szc efz
jnc: vsv edy xgx xnh
bft: cdn cox hjq hfk lye ggp
rae: ban bss cjg alg atq lwo gla
xfb: xtf
acx: iwl hpi lyj
avv: hoa yal laa
xba: xat xtb
vjz: shm syv
gfw: jue vjs srl egf edn
jsk: vyd xtp
cfz: yko gvu
cat: cog imp hci ycb ylm lpr
edg: xdj
hqf: gbo
yop: llt ljg lzf
jus: vua sgm ssl
soo: xhy xdo
rqm: rqn hnp hun ybx ywl yxj lol
rqx: bpw iik hhx lww
jxz: jug ehk
hrq: ypy lgd lqt
jbc: vcs sbt ekv exx
bha: bvh bnm anq gay ggv
bog: lag
jok: vpv elx
sut: ewd xsv xxm
apu: anb iqz gry
alx: aft yit yui
vvd: vqn vua sce
kgg: kzk chc aci aii grm
eal: ehm xej
vvh: vnf scu spg ecn eab exq xrj xrp xow
lua: lou geu
gfg: wdb jhk vlc suz xpa
wwv: wjl jrp jbp snt
sri: sbs xxd
btf: cgv ikj hlu yxy lnj ggj
hjq: lsz
ada: ajl hlh yio yhz
cyv: ajy yyh ydk
wdm: dew dzj jkk jax vqh ewh xmq
lzp: glu
smp: eee eez eud xyt
rbv: bqe abe aat ghp
sqo: egy
apq: yzy
izv: hlb yrc yxk
spu: eak
wgo: jia eks ejw prp
kdo: knb kfp rzs rtg bsx cdo hyf yqn
wsb: wep dcp dsd jec vvd sai xab pbn
eho: ezt
hzb: lcm lpp
kfx: kzr rfv crc cls aih hfu lde
iav: iff ltx
kdf: kqo cxt aze ihj ywl
rcq: rsb aac lyl ltf
dal: jiy jxd sch egk pca
wft: jnw vtq xez
xju: pkr
wah: wda wzf eyg exy ezg xhw
hab: ypn yoa grb
hog: ywh yfi lyl loh gpx
wnq: dsr jha jhh vrt ebs ehb
idv: lkn
wdi: dks dcd vic slt
yil: lmd gpt
hot: lsr gcj gga
rlh: rso alc axb aqq yqe
jyw: slv svz eis
yfy: lss gwe
wmz: did dya dlp jly joc
bsw: iuj hgp yky ywz gcw
kof: bnf isx hct
hsk: ydk ggx gpc
hav: hws hdl ykx lwe
jqe: sly xso xxv
lyj: lwz
abq: agk ipz ydh ymr yzk lfl
vji: prt
lcq: gjx
lnl: ghb
bex: abw ygl yzv loc
wcp: wdj dge jur vwg xfv
rkr: arn and hax hdf lvc gjy gss
ixi: hpq yrf ymb gma
llo: lqt
vdv: vpi srn eia xjj
wti: jwk jnc spq sub eyt
vzs: evq emy xpf
suf: euq xnw prf
eis: ezp xyi
yxb: lpr ghh gji
ctc: aro yav gpg
iml: geq
ite: lqd
ymy: lwt
icd: yhp ldk gci
bnx: bti hjr lbb ldk
lyb: lvb lmd
bau: bwy bqz ako asp iij inj gkr
anf: ind hrg yhf
dtp: vaa vsl sue pbe
doe: jaj jiq jys jth vhk vol eyl
wfe: diw dda dzv vrz vvo xdc
clc: cuw akc yss
ssp: erx eaf elx
voe: szm eph
cji: iac yfn lrp gpz
sur: eda xpl
bpl: bzm avh ibk ldb
lgh: gsp
bxh: bqp ahx geo
gng: gfz wop jdf sbk eue
rkd: rcc bqx leq lxd gwb
inq: hmd yxf
dpt: jjy vqo saq ebx xal
hfl: lwn
wwz: dpz vrf vvq vmt syv ebb enk xjs
wgv: ddz ehm efp
ron: bwu cnt ifb yam yod
bxf: cra cay cmh iod ioo ygi ymc lpy gwi
jwg: jwz efn
iga: hup lbj ldd
jzd: svk ejs pkd
wdr: dwm jwb vfu eei xpv
yej: yxw ltf
klb: byc aco aah yia ynk ldv
wce: wgy wgd jdz xyy
ykb: lea gjl
any: has hqq lkd lay ggh gsp
yra: yje ynu lhz
wig: wll wvd dck dae jsm vsu vey swk ell xim
rio: awq hmq yxu ltt
eeh: eoi xwy pbt
ios: ymq lgd
ifm: lgs
vno: slo soj xju xqn xoe
vgk: vwl vop sgd xrb xgm
kyb: rrv rfm rqq aqs iia ycd ypk
ilg: ife lxz
kwx: kof rbv cge ybk ync ltb
deq: dpb jnj sae xpq
jjp: vpq vms eil xqs prb
gnf: dqd sqq enq xdw
yng: ytc geh
hhh: hze gbf
ccx: lkk lby ltj
bra: bqy cnz gxy
wsy: wpr wuk din jah jmp ssv
bna: axm apc ics yty ghe
dge: jfr smx ese
sgj: eic xix
yef: ggf
cwu: hfu ypb ypy
cwm: agp hbl ycl ywo lxz lxo
yon: lyp
yqc: lad lmm gao
rap: rzu afb hvj ydh glb
hnx: ydz ynl gse
snn: xha xwo
sfr: xrn xsw pcd
ejj: xcp xab
img: lmc
idm: hln hqj yjo lrh
atd: hcx
vmq: ebj
hhi: hxd yjb lml gwv
xvt: xpz
heq: gpq
erc: esd xdq xma xmm pcd
hon: lyv
vsc: sje smm eng
yzo: lpk
hjx: hqh ypv lym gwb
hum: yuy gwx
jjl: vyu vsc etc
yvy: yzh
bmq: aza hig yit
hbg: giw
was: dcv dvv dxn jsm jqw vzn evx
hyx: hmh ypr ldr
hxe: yph lve gbn
jfb: vim xlg pcc
sir: sie xwa
apv: gvw
jnv: joz szl stp xkh xmt xth
vxh: svd soo euk xzr
dyi: jeh vgp vxu sto
bel: cos ypq
iym: lws gbk ggy gve
lmn: low gwy
wxp: dya def jcb pkm
dlt: dgx dml jtl pbx
vck: ekp exu euu xuy
wka: vwb xhy pbx
yjz: lja
igb: ymd lno
wis: jsk jus vmv sws xvc
ist: hkd hkf gcn
clq: ima htm gvp
lfa: gbv
xka: xaf
ijf: ism
hhu: hvk lpx
hnl: lxd
clu: yio gjz
kol: byd cbh cjh idr hpu gka
whh: jvz jmk veu sub xyi
bch: cjl ybo yqh gep
coc: awo aos icp iim
vab: vfy egt evy
arc: htf yyh yyw lti
cey: ago lzb git gpy
jms: sbq esx xkt
crj: hrn lve
lxx: lmr gyv
kcg: baw iqr iqp yuz ggb
emq: efl etk xra xrs xhm xwm
ynp: lrv gcb
svz: sqr
gta: dmn doi jix eyv eqe xov
bml: cea cnu ibx iuv lgr
dbv: dwc dvf vhr svp
kbl: rnl bko cfc ikn yjq
dgf: vkj vys sul ejv exv xyv pbp
rmk: cgd hqd yxf lhd lms
raz: rxs bgo arb aof iip
rsh: bnr iwj leg lpp
ihf: hig yiq
wwd: jhp jdb jvr sab xwk
squ: sqo ewl esf
ydj: yxe yuf
xyr: xuc xuy xoh
ekc: eiq epw
bac: crp cxa col apm aog ieu yms lsh lsp gxp
jqj: voy
boi: cci csu cfj hsc loa
dht: vln vdc egd xeh
dpi: jqv ecj xyl
wel: dws jcm jep vpn ett xzu
ihl: ijy
hdv: hun ymr lpf gyf
jnb: vpe syc ssf elj xnj
ajn: azn yms ley gdj
wed: dpd sgk swy eky xjj
kpj: cpr alx aos irg ltu
brl: aua yzf llz
bfd: cyl ayt anl igg
cll: iew yqx yue
izy: gmj
yxw: gir
dav: dgj dpe jrt jtv vfm
vam: sgf egp etp
rbs: bjp iqv yud gdp
vix: vta syd ela eer xiw
akt: aja axw ict ijw imw lis
dop: juz vjd sgg xdu xmx xur
kte: ciw izf lkw lgj
lfk: gbx
cot: izz hch hgy lgw gdf
cpw: awf hxt ytm lmt
cnt: hbx gdp
axl: azj leb gla
jrb: vba sld eoj
lfg: lqh
hmw: hfh yfg
jdl: vvs vqf vot stv xvc
guo: dqs jtq vkh vbw vcd vzg vqo sgn sds szd xrp xfl
awh: ydn lav lvo
wrp: jdt jty vif xai xhr xuo
icc: yca ljv gcx
kgf: ccu cml aae alk aox ivg iml hpc ycu
vuu: scg swq sdw eah eqa xyl
cca: hdj yae yeg
akp: hct hma yjm
rwz: bao bey boj iki yfw
vwi: sfv
lhm: lpy
jon: xaj xhl
ber: can ibb ive lqx ggg
bsx: ilq idi yso
wxm: wfz vdu sca spw ebi
vqu: sdy sjx sti pbm
agj: hdp hql hug yiu yxh yqi lwr
wwx: wvc jrc jwm vmv
gtr: jbx jsv jth exs emh emy xnk
jfi: vku sdj
lwm: lug
yxo: gky gby
jug: egg etv
hel: lwp
alo: hsg yfp gan
xcg: xvq
hew: ljn lfs
hbl: hgb gmx
dnr: srk svn epy xvg
sor: eif ewx xrm xpo xzo
gnc: wid wlh skw xcr xin
akw: yuw gjd
swn: eyt
exw: xln xgr
jll: vly vvf sip smb stm eyw edq xhq xue
kxg: rjk bad axv ldf
wzv: dxz dze jhc vva sqk
wgb: wsx jyq vop edi ezz pck
yle: ggc
khx: buu czs hec yio
chv: hjk
smb: eml xcc xem
jtg: vtl sjf xsm
evy: xbo xzw
slw: spc exs ext xki xir
ewm: xxu
kzq: rio rth buh axz iun hqq lco
guq: wjj dpu veb xdr prp
rdy: bvi bfr adq izy yoh gha ggz
slm: enl xlt
rak: hee hpx yyz yjs
waj: wxj jrp jva jvi eko eiy
ydg: lzk
sbi: siy sjv xcv
ade: loz
hci: hhj htg yst yul
sne: eyc eeg xyk
dha: jkp xiw
haf: hlj lyu ley
vig: vla eop
ksv: alm ael ygk gso
wjd: jiw jyj jmq swg ste
dsl: jbu eup
ecn: xtq
vqc: ecz ejr efj xct
hzv: ldp gar
ili: yzo lcz ldd
jhz: eqg xrw
iha: hdn ygg yxs gal
reu: rmk ays hdx hmt yjg
avq: idx lhc lnb lul
itu: lkk
lvo: ltl
rkq: ctk ajz ijb hxx lfe
vui: stl eru
bfb: bql ict haf gxr
itr: hua ypg
wjy: wqc jny jtd vns vof snf
jmc: xct xhi xhp
vog: suz eto
hfn: hzv hzn led lzm gam
ciu: gdp gxf
dyv: jjv vkb vha vzc vop sbx xch
rke: bbe byd cjv aoa icp hmo ghu
std: xpj
eic: xrn xuu
dwy: dsk dsw dec jvr
ssy: ekg eis xph
sjl: ead efn xri xfd xuw
cfp: ayz iwi yok
blk: ccq lyd grt
aej: gwy
isp: ggh
inm: hgq hqn gea
jqv: vii stg ece
awu: ade imm lfi
jvj: etc xyz xeq
agp: hyk hpg hfp yui lnz gkz
rdb: hcl hmj htf ygy yjd lbg gga geq
gkk: ghr
ciw: lru
yjj: ghj
cmv: hqw ypy
vya: sls erh eie
kdh: rbg biq bho bjh lkf
djj: jac jep vcf exh pkv
gya: gge gmk
wbb: jbr ski sgf xlc xgt
eto: xow
dsg: sla sdg xdt xtz
dla: jrd smi som exw
iag: itu gxd
btx: cnp isw hcq hwp hta lbs gso
lwj: lzq lol gba gai
jku: ved sag ezu xkh xqc
gnz: gno gqh wkc jon vqo shk ebx
bmi: iyi imz grw
gox: waa wjm vep swe xww
czc: aqp hog ykm ytb
kfd: rsx buy ipj hbz hvr
drl: jrw xpa
ecf: xqb pbf
kvw: bbf apz ipt izu hrn hqi gxy
ebh: eco
yit: ymp ggw
jkh: jfw vng eep
xqr: xol
ceq: hwy yyp yoi
ikm: iqo hiq hhe hui yip lfz ghx
rdw: bdk chg cen cmq apk ycr geg
dws: dei dpr jvb jqi vwd vvh spo esa ezw
ylu: ggl gxk
xkr: xfa xqd
hoe: lfm
epw: xsd pko
htp: yis lii
wsw: dku dft jkk jel vhc ekk xzw pbp
iit: ijg lxe
csm: cof ioa hlz gjd
bas: bgr bxe bpu ywt gjg
ktu: cru adc idh
kuo: rzx ckw ijv lyz lsf grx
ceh: asu lry lwy lox grz
jha: jyi xoy
dga: vgf sdz eac eio eeu xyb
jlo: vdm vto ewm emy efc eut
hwp: lxl
kgy: row bnl aik icj yzw
yqr: grp
vxe: soh pkg prg
beq: czb icw htv ykt
stt: xkm
cmq: idy isw inw hpy
kyu: bsu cfu iaj hfz
cix: ayz ylo lml lzq
vyv: vxb
asn: gyi gec
ywq: lqj
axb: hpn gcg
vao: vtr efp
api: iar iqm hwd yoy
cth: akk axd hqr yaw gdd
kop: rou buk ixv glb
hah: hgw ldg gkc grv gll
yuz: lhy
ccq: cus akr hci lyl gjt
ahk: ama hqv
dma: jxa erc esm xwq xxb pkj
kks: kxl bui cjv afl
jsu: vnc vto xrn xxf
aei: iav hse yaq yon
hpl: lfe
aol: ifl yqi lyi lvb
aou: lbg gju
dxm: dpy dzn jdd
adi: izp ghb
aic: hkk
ail: axz hlv lva gmi
xlx: xqp
ksz: cyl adq avw asw
bni: cte ark lpi lua
iqt: ybt
vbn: vig enr xbt
vye: sqt eba eqr
chu: cqi aif lia
slh: eaf efm xlg
cjk: icn iie yef lei loa gix
kii: kdw rdc yjn gwp
rbn: cbv cda hzb gwn
kzx: rke bos hrq gik ghh gwf
vyq: eck xcj
sjr: eph xem
ijg: lza
wla: djs syv syp sdr ell exg eqb xpw xqs
cno: aqg ire idz huo yox
sig: ezd xla
dtr: vio skn shp sec ejg eqw
snk: eng eom xvb pki
jyb: jti xra
edc: xsw
cmy: apo huo
gzc: dbe dcu jjd jsd jte xfv prx
yiv: gin
iyn: yeb ltq
afv: hyc
sfy: szx elf epy ezw xnk
sbr: eqo
wvh: dlk dmx dqr vob spd spn
wul: jry sbc ebu ele esb etx xpj pky
xch: xzg
jxd: vzm ezi
cqb: abc
hpf: yoa
apm: ijy hoe yer gaa gyn
wic: djl vla vpi scz eau xyw
xtj: pkm
eth: xgq xnh xuf
kqv: rde cah ayt hky
cek: aru hfb lpj lmm gsn
ezn: xpu
iyc: yhq yyc ygg ysq ymt yte lhz lme gmj
asg: ibm hdm
jxc: sle smp soy xuq
suk: egr prq
ado: aqt inx ios hfx hoz lgq lmu
ywj: gpg
gwk: gvg
vio: vor sbj xpq xtu
end: xxp
ihv: yjx lzr
aoz: hxq hfe huu yhd gdf
ssh: ewi efc
yjg: lhu
rts: crr cvi isk hym yuk lbn ldk
jvy: vri vca vwd sdj elr
vpg: sdb eah ezl xlj
wqj: dzf vaq vvt ece
kqz: csy ctf idq yhn gvt
avh: hop
lmy: gaq gvi
cbf: acl isb iuj lbk gbm
wrg: dgo jjc spl smi
avm: iit hhk hdg
kcr: reu bbg cdc anu ihk lro gge
grz: ghm
jeb: vkm vid ssf ecv efg ezb xty pbv
vou: eii xvy
gbt: gcx
kiq: rwe bhu iho iei imk ycs yom gvp
hzo: hqf hon
lyh: gvc
vni: spe ekr xwj xvx
rfx: atp hwq hns lkx lck lvt
cxm: iby hoc yfm gsv
hit: lke lfy
ahx: gsp
wid: drq vqe elc eji xhk xxj xtg xul
xen: pbw
dlm: jcx jtm jon sms
aez: iwc lot
bts: azv ieo gcm
awd: hbs yqb
vkj: vpd vtv sri eip etm
lnh: gxw
hvb: yyg yjf lvg
baj: cdj alv avc ify hzh lhd ggk
kxj: kzx bfb lat lyg
wfi: dbc jpu scl evu
ahd: iqu hqk ynm lvc
kuk: caf cju aqg ibm
ayj: adv ibx yjr laa lgv gsg
rhm: rxh iun lvt ggw
les: gvq
vzl: seb exa xfk xuh
koz: rop cdp cog img ldz
vbg: vie vnu shg
ixb: ioj hpr
jtr: vde ekt eyb
jnj: xjs xpk
wtb: wot dof jhe jys vbl
dxn: vfd sxh
svb: szk equ xjd xpe
dun: jgg jzg vdn
vsa: sel exi
jtx: sfg exo xam
hiv: yag
jbi: jsq vmj slz xyu
vqs: suu eqs xnq
btc: csx cpj ybt
wzr: dgz dfv xsi
xfi: pre prf
cfi: ywe yvx
vqd: ewl xbq xak xzu
wyr: wor dgl dgj dnt sht ewm eun
cjn: aab ieh hcn yyq
heg: ylx
jor: ssn szn eve
ccz: ixb gdn gvd
lbj: lwm gib
ils: izi hkg yrx
azl: hux leu
cqt: idi htu gge
eyv: xhh
gtx: war wvj wun jwa shh shf snh eye
knd: rdv rmw bdh icm imw yht yeh
eny: prn
xak: xjx xfv
lpe: giz
rqa: bxn csa axg yhq
ibb: hhb ypj yqk gia
lsn: lqj
veb: vxp sbo sug ema pbv
vrk: szd ewv xgt xwt xug pbk
hqk: yvs lmr
bam: bvp ial iup hlp yhn lix llh gbg
etv: xhh
bob: can aie ahr awa
eqt: xmw
wlb: wwd dzp jlz vwp vmo ejm
xgh: prw
wvc: wqz dmv emg eqk xev
cxu: aie igg hup yar ywn leh
svh: snc eto
vyj: sja soj eba xmi
xjd: xtw
anc: yjo gho gwj
bid: bgn bzu alz iai ilj gab
gte: wxh jox vkm esi xih pkp
dtx: jqe vgw vfk sfa
ihn: iul yed lkv ggq
jyd: vin vqp ecq pbz
arp: aap agz hkx lnu gxd
wmd: dkj jci vkp sex ern xmx
kfb: bwz crt akv heb yge lsc
bgb: bxx hwo ydo gsb
euo: xei
anz: iii gsm
dyg: dnk slu squ suy ewv emc xgl xxp
kle: cnx czn alv hkx lrb lco
hdm: ymb lxu
dvq: jsi sbk ssr ehh
ayw: ijm hmz yss ypl
jhi: vyb vjq sls xlh xpd pri
jur: vlz ect xqo
lhq: ler gdz
ljm: lfj
xmi: xub
kum: bdo ixm ipj hjl llu
jeo: jzt vnm syi epy xcx pcj
ygn: geg
cjd: cps ixc gcu gjt
sja: eoy
iyt: hly lmy gsl
rdv: bkj ajd aoz imt yqg gvv
cod: ipk ifa hik yag lqw gja
rey: chp icw iwg hui
haw: hgx ylj yjz lrd lik
wye: jll jee vqt eqz xvv prq pby
sul: ezr
dtm: jbq jlq vio vyv vyf slb ehv
ryx: cun afr hbx loe
anv: iuf hdj hql yaz lcl gyn
ifc: hza lyr
hza: gsv
rkz: czx ati iyw yae
sfw: ety xad xtb
xwk: xue
bkr: beq bmn ceo
kwj: kes rcv rig cgb air irf ibi lzw
kme: rec ydn ldk gxe
ixw: yvc lpe
imu: yrx gcq
bsf: cdj cds iqq lqn
lcu: lpp
wwi: dvu vib vti eaq ezu eur xon
alv: ycz gvx
ghn: gdb
yaa: yzp yzm lel
gfb: wxz dyq jwo suw elo
cne: aut
axq: hvq lbr
gul: dqi vwm szo edw
vyr: vmt vnp snj eam xcf
yce: gpj
dig: dxm vny smd eqn
ane: ixf
eql: pbx
lbf: lwa
cyu: hch hld gdw
hig: yfn lic lwi
ydx: yvy
irv: ivq hzr yrh yov ljq
jqk: smt ert egn eme xym
eum: xbe xeb xpt
dom: vri sht xig xvx pck
jxb: xic xnd xue
daj: slz
asq: lcd lab
hiz: yxc
hww: lif lse
alc: hyl
izu: lbl gek
dzw: jth suh ejb xip xzl
hts: liw
sjg: smn suz eer
btt: chm irk hux hof
vmd: eka
agu: axx amt gwc
ivi: ygh ywp gsp
jer: vkt vrl snn ekq erm egi egs enf
hjp: gbh
lip: lzi
cdo: iro hzt
byi: aka abs aoa ikb hwd lbq
hwf: lzp
ipn: inw iuu hlr ynp
hlz: ydu lsx
vak: vso edq enk eoq
iwp: hwa ycc lgf lqp
aye: hdu lxp luc gbo
xps: xmw
beo: cko cjp axt yor
vkc: vft sao svi xmt
epr: xqk
juc: sgx ehc xcz xuk
anu: iop hiq gee
skc: srl eba ecj xte
bct: afk iap hzc yrn ymf lpi luq
auj: isf hxa yyz
vlf: vjd vzm sdi ead
srj: scp
idj: yin yjz grb gcq gdf
doc: jks jsf vkh vnv vfa
cli: cgo cpe geb
sxt: exl epr xvk xvp
wqq: wuw vsv ehz ezi
gbi: gav
rvb: byj avw iry idw yqu lou
rry: bwh ckl ldp ltx
yja: yeu yzb ljm lvu gpd
gub: wis wli vre vos swv svx efb xfr
bqj: aih adu ifq itp hgj
yfr: lan gii
vtx: swn epu
amn: aus aon htm lhs gwy
adp: ijl gav
ixj: hwz glm
whf: jap jld vcg vvx scd eaz emk xrj xer pke
wzp: jan jhp vpa vmi scy sdu sjn
kwv: kna bdi bzq cwn anx iej hht
rpr: bma bmj ajh ytt yue yut
dct: efp xrm xgs
yqj: lxu
rza: bsl bnl cdw azf aqe ydq
bbl: bms acp irg yuk luf
prw: prt
inw: haw
ecb: ear xlr
lda: lmw
dvg: jli ssy erw eni xcj xzo pkb
lri: lxh gik
vbe: smh edo
krq: kfc rbl rcy cro cur yui
aha: iix lzx gcq
egm: ezd pba
cdm: aeg axm aoi ijo yrr ycp gry
xya: xuh
wvm: wze dbf ssg
bop: ckw cam cqa irh iug
kbo: rmq axb hvh yxs lky
eob: xgc
scx: stu etq xjy pcy
dvn: jgc jeo vsn sbh
axg: ial yla lmb
rrx: rnq imo izz ydt gxu
ilv: hyh lcf
smn: ept
bnd: cdp cne lph
lhh: ljd
cxw: ant ykz
sxr: ehg eqp xbl
yxm: lhp
vpf: vpq epg
irj: itm heu ggu gxa
itq: iol lhz gmk
dmn: vfs scz xub
izf: hsa yhm lxi
bxo: ajl ivm iee yps yqb gxd gpb
rbj: crj cvd hix hpb ype yne lxq
gzs: gtz ddv jbu vdb vqx efa
sfe: eby eza xaw xuh
rvw: bhh byr cox apn lfu
ann: yxd
yqq: llb lpu
ckt: cnk aob hkx lrw gyo
ila: ita hcc hqw yee yzr
lnx: gkd
cua: aer aev irr ihr iqq hmy
dam: dxb jye eyg xai pbr
xbu: xlh
edi: xot prm
cos: atl yai yjt ypf lgn
rki: rui ihi yjo yxw
jqh: vdw
jjq: jni xzs
sjx: sut xuo
snc: xtn
bje: chx abw ybe ljl
wgc: drj jfg vmi xed
afx: yss
bso: bpr akn ywg yod gcl giq
eqp: xjk
iwx: hgd ycc ymq gcw gxc
axi: hvy ycw llm
xis: pkl
wpn: sef sxm sfy stz sob xla
eii: exh epk ent xkt
wat: dgl dda dte vxa vql xau
cpq: axk hdl ypi gvg
yxc: yqp lyq lzb gvx
ghy: gxz
lcs: lds gdc gxj
wsk: jfh sxz
svq: exb xro
djl: jlm vsl vmq sfz evh xdv
vke: vnb xdp xuu
wlu: vze ene xea
yup: gsa
xbc: xsq
yga: ygy yvl ynd ldp
svj: eql eoo xyj xvz xoq
ahj: iqx ylf gra
gfn: wzz jnq jok vmo sll egh xis
hgp: ywf ytl
rlj: ruc ico gvq
rkl: rit rei bxl cty
ywg: lxo
dka: dxq jwy vyk vfv spp eee
bka: caq axm ibq hni ypl grj
bcz: cbf aqj ihx gyr gvh
lfe: gyz
sjc: eta eoz
xvh: xmx
hsc: ykm lgi ldm gkk gkd
kyi: cjv cfc alz iex hwi yka lgy gxi
rkj: rlm bkd iyv ieh
jaq: jhe jlv vnh xbb
dre: jfq vip vyp vnc xql
viz: sdk xpe
vpu: xku xeb
brr: cob awh hdg
hga: ytz yui yoj lec
wna: ddk scp xmd xuk xoa
rmx: bed adt ynx yok
rac: rjr rnt ctb awo yri ghm
ele: xhc xsk xmj
kri: kzo rbu rjv bma ypd lhz lwa lzb grd
rbu: czk arh afh hwj hjq ydq
iti: ytc gpt
dfz: jmi slv emb
ivt: lew gyn gjg
adc: hai yrc ytz lxq lpz
eay: xju
vek: stc
cff: aag gkp
ecg: eyg prd
rjy: czh hhw yvk ymk yfn lwj
lum: gyc
cpn: cfp ilx hzn ybs gxc
bco: bwh aku aer hba hmc ggk
ams: azc iuh yum
afz: icy iay lul gcs
keb: kzv rgk cuh inv gsn
hwy: hox yew
ikj: lio
wpl: djr dmv jro vfr sst ern eiy eyy emn
rgm: amv atb izh gkd gam ggz
erz: esu xmr xov pcw
rks: rox cav cfy hji lpg lps gpy
hhb: gbb
ieq: ybd gee
ybe: ybq lqv lqo
acs: adp aop
kaf: azy iuk lzc gyi gws
xbe: xel
dsk: sde xdv xpb xuz
evl: exu emk pcv
six: edg xge xdk
dnx: vax vdm vzc
kkv: koz cuh arc irf grx ggg
xhg: xvk
ryq: rea ale lrr lnh lus
dih: dqg doz jhw vbo vsl sim
drt: siq xyt xjy xvi xqc
dir: dzq vfq sko szf xgc xjq xfo xtv pbl
emu: eqx xpy
dzg: vkh srg syu xxb xmp xzd
vom: sbj sce spl prq
rrp: rcz bap cep amp ymo gra
doy: vhr sdw ssw ers esi xpv
lwc: lqq gdn
jxq: vfe xvz xzy
bnr: cqo ahf idt lhv
izj: hjd las gmi
wuk: dxi jzn srp stv xtm
ddf: via vgk ezk xhq
smi: snb ehs egi xjl
evj: xos
exs: xcr
bor: hvi yam yok
jxe: vcb sae swy prv
xkx: xum
lzl: lqa gis gpe
hrv: ytt
hjj: yii gra
kqi: rik byu bet hwt grd
jep: sav syk edy xww xzf
rfh: cbk cau iur hdy hse lqs
jdh: sdv xfg
jre: jjm vaw vvo saq
ykh: ygm
iwq: imd hry hfa ykr
aaj: hif yff yop lwv
yne: lyd
yoo: lqo
kxy: kpi rbm bsu aiq hgh hzq lpk
ifa: yvj luk
roi: abk hmc hzc lht lln lpw
wcl: way dyn vgh etn xce xmu
kms: aha aug irq lxr
idl: yxu lxs lxn
dzm: vke vzd syr xpp xnn
aep: yxd gbj
ekk: eou xck
wcq: dbd dpr jrm xkd
det: jcs jcu jih jwu jqw vgg
rbl: rzn awv llg ghk
dnv: jtf sdb xkd xdx xqf
iur: hlp hsr ytj lks
cgz: cwl hbd hek yas
che: aby ycg
kgi: aew irp iem hmx giy
wdu: wtv wod dds jbr jof ege
cgi: afo giy gwd
caf: cnp aki ibd
vwv: vqc efz eoy
dfj: skm emr xkj xsv
czm: ltt gyw
gcu: gxa
yfq: lts gxj
ehm: pch
ywh: yup lrk lis lvn
bue: cyt cpm ild ldb gcp
vyk: vtx svl xyw
raa: bgt auy hpb yxk gkj
kin: kgp bkv bih cca cwn asi ggr
hwq: hjf
juh: sbg ejw evi xsr
dzv: jyk vtz spq
vtv: sev snu xxw pkb
lrz: lhh
vox: sqg xrh xms
wmp: wfb jzz ekz emw xcr
ybu: yjs
vfu: shh
iyb: lyy lvs
cup: axc yxt gwb gxh
apy: lto
rkb: bfq anx hrx haf
rwi: cwn ctk ahu lvw
jxg: swn xkf xbm xzp
val: vws vew sqv epo
brm: cea awg ljk glv
irx: hbk hjb yld lpo grv gbk gsb
dgj: dvy deh jop vmr sdx
bro: bbh iac ycm ldg luf
hic: hqp yek
wyk: wmz wft jec ven xrx
rbg: rui bxh bok aux yul
hyl: ymq ymu lnt
wgj: dct vfk ebg eik
gbp: gcz
dqy: jci vgg vut efb xfj
vme: xvi
dll: vql vul srl sdv sql xkp xlv xpk
lmt: ltc gxq
bqg: cgm ayj hkc hnv yha
lrd: lty
ebi: xhs
cva: atk hwh ycm
krn: kci klw kxb bpx bmp hdt lcy lgx
xaj: pbm
rqg: bhb azb isz hrk
ypw: lyr
yhn: lfi
auc: hku lje
inb: iqv hot gcl ghd
duc: jre jxn ekf
wni: vcj ezh etr xhy xxe xmq
juk: veu vtd pbp
cqp: aao aum aou idp ltp
wrb: jix skp swc xry
llh: llp
rtw: bzj aug ijy yjc
iln: hog yun ghk
ast: ipk lwl
ldv: gyj gsu
aoe: hkl hlp yim
kgd: bgn chs cqt ahv
lhr: lmm gap
pbz: pch
yhe: ytb
gkv: gik gpi
rli: bls bub iyw hvp ytp ljo gmc
wfg: dxf vcx vwf vqn sli sso xud
skw: sgh xun
rwv: adq irf yae
ksi: bji aae icp hzm yvr ytr luf
swu: snc env xth
wtg: jpx voo
whb: wlq wwp wtj dyb dyu jyp xwi xve
rkh: rsr acb aix apn
epf: efd euw
xlg: xfs
jso: vdw xgg xnz
rwm: cvc csf hue yux gpu
dmh: dqc jsq exd xri xvn xth
wgd: dcw dxb jpp jua sal esm xcr xhy
ijl: hhk
bwp: ifg iub lpj gce gjt
hdw: yms lei gkk
jjf: vhz xol xod
bpo: ahl iwe ioi ygg
jue: sjk snt pbt
iji: hhl lan
gnv: wxq vhh vnq vuu
som: xft
vdh: vuf sdy
vue: vuz eim xox
bpd: adp hpg ypm yfv
koj: rgj lag gxa gmx
iee: yhw
jbm: jlx ses soc ekw eue
vyo: edh xzl xuv
dqz: dtd jbw vxi xla
bst: anp hmb hfe lop
sxp: sur xcl xgs
erq: eyk xvv
bim: itu gwx gme
dxr: vwp vxn vnt ehs
bdi: aqv iaz lga lgq lxs
wyc: daa dsl jin esq emg xre
gqn: dia jhv skg skv sui eih
htt: lpc
jzz: jty vzs skb xko
jgr: jmp xww
ipl: imh
kmn: kod rae bbm bbt cib csy akr yiq yjp gsf
aaa: iwm gsx
dxx: dpj sqr stm xyy xvo
hff: hox lxu gdu
bdr: ynq lto
lyk: gpn
aql: lhb lup
ecs: epo pbo
bks: bin has yec ldq glu
bll: igo ycm yjy lxz
ery: pbl
grw: gsw
ibk: lfg
dvy: jst vee vqq epj
ayg: iyn hpn lbm gmg
dvz: sdy eff xxc
vrp: vgg veo ecq ewq euh
jzb: svp egp
ala: igz izz lfa
lgm: lqn
gsw: gxv
bdw: bdj ccu ilp idh iqj hqk gjs
yvp: lsc leh lou gyz
rih: aks hgp hof yea yfx lal ldb
lwk: gpj
bhv: aku amb azp ipd
coo: hjj yyq gwg
ldn: lqo
wfa: dsv dql jed ekx ehi etz xvt xxz
ixk: hcu ycc gho
clf: hyl ymq
eyk: eqh eum
hkk: hww lcr loz
sdh: xdb xds pkp
bxb: abm ahb yzb
kjz: hlt hlo hvu ytu gdh
gow: wjk szg ejy enu pcj
hgw: hfz yad yyl ylq ljk
hyi: yza lxp gjb
bmg: alc awj ane hmk ldn gah
ktn: rtp bkz cpe cql lui gvq gpj
xii: xms
vuy: shz
imb: its hbe yib yer lku lcb lxf
cjh: yav yye ldi lpa ggj
cmx: inv yed gsb
yhu: gki
jlp: sre std xyq xna
bkm: bdz ciz apr hef hpg lul
sup: eee eqv xje xuq
ltu: gms
vkv: xdx
wml: dfn jar jqq sau
hzc: yms
cim: aoo yri ljt lvq let lnu gvl
bqf: cfq ipe hjh gxp
vbm: vdr vmu shy spu xns
yrw: yiy yvh
hkb: lwe
cun: adp lyn
khc: rhy ckm lkf gsh
bvl: ayt itn hkb huz
ypq: loq
scd: ssj sof ejw xmo
ybb: gca
rwg: blk abf hha yar gyq gmj
hvc: yya
wnp: vom ech ehr epf etj xiw xok
dmv: vra xiq xjb pbb
efn: xlz xwe
dcx: vfu sxi snl edv eob
xnh: xqi xtt
yju: ldu
duf: jnp sze xlc xgr xqd
bui: cbc awg iyn
jov: vwo sdc ssb
xtz: xuj xon
ioe: lwz lqb lun ggq
crz: haa hii yws luk
vfx: vzp prw
xkb: xvl
hkh: gmy
rcw: riv bdg bfe cfx ifs hdh yyw
sgs: esc
ynd: ljb lsu lon
apz: ict lrd
jpf: sss
iup: yyd ysx
yax: yxu ynr lvs
wcy: wvm dbf ddc dtv enc efh
sxc: exo
stk: edt xqd
jlb: vab san sps esg
eer: enx xsj
smc: evw
isn: glf gec
cle: hrk yup lys grj gpd
ceu: hqy gjt
aru: iro ymm grp gvy
vqt: sfl
wgp: dwf dzq sdh sjv sni ecu
dtj: jde
inc: hbh yxu gbk ggw
wkb: wdl dyw dyz jkw vhj xel xur
ifh: gej
dqc: jnh vrg vsq sxw eil xks
ccv: hto yiy lem gmy
wcj: web dbc jng src eay xfc
biw: asw icl iep yxj ghe gxw
lgg: gdx
apt: yks gaz
akf: iid iwv yld lwv ldv
wqm: dya dwg vwb vmi vfu syg xvz
efg: xao
hws: hnz
vbi: ebo xuk xoy
xln: xjw
rvg: bem cjk hdn lkp lpy glj
rzw: ane azs yma gvg
cvs: hma hok gld
xjs: xjm xxw
irs: ivy yib lqw ltq
czu: aem ivk iob lbv gkt
ykk: yjl ytv leq lqr gvo
rpd: acp alj ybq lhh grh gvx
iwn: iva hka
hsn: ylg
dlo: jjt jto vke vcy vcz vjh vni xxy
btz: clo afl hpj hos
kwu: kjd kez btq ckx ynw
knx: kzl cyk ayq hyv hjx lca
ksw: cae yyi loh gsi
wgt: wju dct scm sjc sjt
dud: jwh ekg eca eqz
cfq: anr iii yjj lwv luj
csz: cul alr avx axb iku gjs
jcc: jcg jct jju jnh vdf evm exc xad
jzr: sfd xfp xth
lse: gwr gjn
jru: jlt jql swn elb edi ent xru xbe xou
bua: cfx aum ixb hht hxg yoy llk lza
cpt: hyg lpa lqo gxr
hoz: gyx
adb: ylm lmf
lrn: gpb
wbh: djg duf eko egq
hih: ygp
iui: iuo hsd yuk yuv gmk
ijm: lpb
gkc: gbt get
lsd: lev lnt gpm
vnm: smv szr xax xuj
lvu: lxg
cdn: cpu aha ipb ggu
cgg: arl abc aqk lgw gbe
ctm: liq
kpi: bij ity hst yka ylx yqs
lxe: gxg
aze: imu ing yuf lcx gin
joa: vvw ssq ecm xnw
rpo: hrx hcv ybr yme gjg gvh
hri: hty
dum: jih
lhp: gwj
sth: eek
dvl: dmp sbj xpx
vyl: sje ezt xvt
rhl: crm atp atn hjd yuz
hhd: yex ynn
isz: hnr ldg
agm: lic gya
shy: sms stj ese efn xma xua
xeg: xus
hld: lnx
dbl: jpf sbb szf sta ejh xhw
cdg: asx ybh
cad: aci adf ytq lkx leh
hlb: ylc
axz: isa ypo lce ghc
bpp: cxe icy iem ygs ysy
aso: ysc lve
gak: gej
emx: xcd xhz xwx pcl
hmn: lmu gik gde
spa: ekk xyh
kyg: rrt ate ybt yma lwd glk
hcf: lbw gck
lvp: gym
yva: you grr gsg
rvh: ckz ilm hvc hfc ypc
joz: vdr soe eri esx xyf
dcu: dsz jgt vqa
elr: efu
dnh: vyq spw xfi
ghx: gvn gxp
vpw: vtc xka
akz: arf adx ifp hxc lsf gvv
dru: dbf daf jas vek xzu
djn: vlo vvg vpn spk xli prs
jtz: sul
vax: ess xqk
agc: awb ihw hfy
jjb: viq vdx vjz vfy epv
jlf: swz szq som xux
bke: imd gjl
kep: rau rlg aee azs izw hbp lvr loe
guz: wkn jka skw ewy xlx xpi
krr: cii aic iqr hkk hal hlp lno gsc
hoq: lzg gif
isf: hht yhh
xxy: xfg
azt: lkh
iou: hyn yib
rpb: abz awk ajq hmq
ryl: byd aad iar hxd yfq lcp lam
smf: snw exm
gge: gja
kws: rzp bgz axh igt hmp hzc yho ltj
rua: bat iag ipw hlt ygv gpo
ekq: eyp xbk
bet: hok yyu lug
hgx: ghd gek
sno: efy xei xxu
dob: doj vxe vtd sag elz xni xnq
dlf: dxo dpm jwo vyo vsw
jlh: vxd svg xof
jen: vmq srz sqk eav eaf
ret: bwi bdk adn yku lhc lzp
bvf: avr itu lyq gar
byf: agq hzs lqg lur
sem: pcv
laz: gen
klp: bwe bwo cgv cps gvg
cuk: hvl hvz gwa
bmb: abp aml ici iia iqd ycu yyj yxb
hdf: lho lmz
blt: ajh axs amy icx iiq low
igc: ixb hnp ynl
ryt: ara isa ydm ljt
ius: ypw
bad: crt iym igq lax lvj gjz
djk: jcb vxf sbe
rny: afm iqe yrl
hpa: yiv lda ljl lxe
jqu: vvq srp smn snr ecc xbt
hek: yjk yjr yfv
xwa: xed pbs
gnl: suv era ehp emp xiw pbb
yea: yxo
vth: sgd ecc epw
hco: ysi
bne: clq iif hey huj ywi lci gwd
xun: xor
yeg: yqk lwf
sko: xqk xtf
wjv: jbm vcj vvt ecd
dgq: dvv vip skk xbw xcq
blb: cmz inw hfk lec
lnk: gsi
ddg: jhu esn xku
dhm: xhp xqu
jab: jjd jms srd sxq xbb
who: vnj vqt eru ehk
wgr: dit jfl vht ehy
srf: sbt xtz
cbc: ilv ylh
aqy: ile iog yka yhu
bxt: bov cbd clr ifm hsa lwx
iwy: ymy lxn
kul: rqu bel cex aye lbb loo
apo: ylb yws gbw gcf
kro: arq ycc lji gbc
vbr: vmm vow ebb xbz xok
izz: hxd luo
hys: yap lbi gds gvb
inv: hsg gbw
dro: dxu jcp jhc vrb eca edk xix
hqa: ysf lkb lmd
cer: heu yjb lvk gah
aoh: igp hdy hxs ler lpk
aqj: yys lef lox
dvh: jki jye vru sah erf egz eqh
knj: rbv apl ibs ghu
spg: eas
dmt: jlc jnz vyn edr xta xtl
dqo: jqv vqj esp xtn
bvj: itw ioq her ypd
gnp: wmg wfe jva sen ebo xfu pkn
wxx: vvq vma spy squ evr xsr
ejh: xca xfs
avg: hjg gpa
epk: xks
vem: vmt xtc
kow: ref bwa iqv hkj gdd
rep: rxd bsh cam grm gcc
app: ign lpn gsz
dvo: vly vjo vok sjy
izt: yiy ydt luj gaq
khv: crq cex anw afp hrw hdp hud ygw
ikk: ykr
lew: gkp
hgs: ywd yng
bce: cbn cyc akq idb ifh lpj gjf
ymj: lex gdp gpp
aux: ixz iop yvm yqf gyo
jrm: ekm eep xra
sim: siq spt prs
szt: exv
dlv: jbs sal saj sjq eyt ewo xvu xmn xtd
cvr: cxb akl hzn ycu gcq gms
jin: jde vez epc xka
rkf: cyr cmz iwl inx lcc gar gve
eqz: xnv
kck: bpu cry chk cfe hcj ykc
vvo: sph xys xuw
bit: bxy bxv bnp yld lba
gsc: gxf
iws: grg
auu: ial hjp hnp ykd lno
vdy: sdj sjm xcz xss xfo
xvp: xov
esk: xxz xqg
act: alu yes grf ggt
cau: isk yay lkj lhe lsj lqf
ria: bbp cmf apo yxy
ivq: lqe
buk: cdz adk hps hoq lvv
wwt: jrc jct ske xbr
dqe: xcl xnn
cyf: aaf hxj lnv lus ggd gdy gxq
cqh: ahm asg aea ibq gag
vxs: esm xad xey pbc
hqg: yhp glu
dho: vre sds xpe xnt
rmh: bjv buk ary aga irb imp yzq
spt: ezv etg xjd pbt
afy: ldr lzm gix
alr: ape ama ixn hes hqb ybm gih
jsb: jtu vlx vos xso pkn
cme: czn asa icg iav hiq ywk lrh gls
aiq: hib yoa
evx: xtq
svd: ezq eot xjf
esq: ezd xbr
dfl: vdh squ xpn
eam: xrh
sib: xrw
ibe: ilz yfq
rci: ben czc ian iin yyq
cju: ibv ibe yqd
ifu: hac
dmu: efj xdc
buu: hri hoa lhk
jfs: eyc xqq
bwz: bus cty htn
xkc: xbl xlg
vxr: vts xre
yxg: yzo
jhy: vyl sjl snw sqq eyk xzz
sze: ewk xre xtf
ctx: yvv ysy
egi: eqx xle xmd
vdx: sir
wbd: wcj wtl dtk vmc vzg soe xlx
kuf: aci acy ifi luh
ipc: hlt gwp
vbl: vag
rtd: ciw amk ama iki ydg yfr gbu
ald: ibm ivt hwr ljw lmp gwp
cue: yxi yuh gie gls
brf: cew cpx iga yjj gbv
jla: sbn eyc eze
ewi: xsx
wop: vmr xrh xhp pcg
lev: lpl gig
yjy: ymq lck ltg
sgc: sun xtj
kdt: aff ibv iie ghc gvm
rtt: ckt ybl lxq gso
rub: bkv ckd hkb hps
lqp: gvy
wme: jov vfy vts slc svs evd xwy
esn: eov xrp xaz
vln: vqw vuu xra
iqb: hpn yxx llk
gfk: wgo vhk skw swm egb xkx xko
cnf: azo hvh yba ybx
kbv: cmt cok aij itb lav lqf gii
bdd: bpz bmp ifb
rov: bsx bzq cnb air ayq ill leo
jco: jxd ssk spn
jbj: jhm vhy pbl
wuy: jhp jvq vex ewj eor xjw
sxh: xar
xjn: xow
dfc: doa jpl sqt xbr
dgy: vdc srn str ejk eoe
eux: xjq pbc
dbe: dam jxu sjf eri xfw
iie: hcd gce
jjc: jtg xcc xac
huo: ypt gcq
vjf: erm ege evf
btl: adk ikp lcv lit
btu: crj iwq yvn
jal: vhd vvs eyf
ysv: lzx
hlj: hjk lig
seq: ewe ejb
dpy: jxm sis etd eup xue
xie: xoc
rxa: ykv yjk yuv
rcl: rna blw yvf lkl lmk lfp
wog: skv erk xlt prv
bis: cwf abi aln agv adz hzd lya lvj lmg lqc
vfr: sip sol xnx xuf
jhr: jha vsn eho egj epn epz euc xfq pkf
bgi: clu aqc iaa ycp lco ghz
woo: dsh dzs sdo eiq emc xmz
rgr: btr csg lnv lfu
vei: eqb xyt
sxg: xod
yml: gvh
lnt: gjj
jsm: xdb
sga: seu xsw
jyx: vid sbw scd sue
htv: htf ysy
wnf: vgb svk eiy epx
bnm: ayd atl gli
cbe: ikb ivb gpy
xey: xoa
cyb: cpg cok gip
bcx: bxa csi ilt
jdu: jjs jox syv
ajl: ava amj ids yyi
vvv: ean xbu xhn
rva: czi igw hng lbm lqm
aqa: izz ywz llu
rrv: bkb als hyr ygz lud
jbr: jdq vbz erx xhv xyl
xbi: xii xpr
eys: ewu
klc: isq imq hbr hnb yno yos gjo
rhn: clr alc aql lxc gbf gxy
xym: xvc xfv
ruc: bre cvm ybm gvr gmr
hyy: ykl yao
cmh: hpc hmj hui lhb
byq: iia hns ydb lpm
vty: syf spw
yoq: lcn lon
bpw: cwg alr idw yve
hzx: lmj
hrw: gbm
ile: ifx ymn
hlu: ylp yzq
spc: epo xqj
gut: jcn vpm sax sld som ewh xyd xgz xet
kxb: cdo aha avm yqb lmr gcy gsq
rpk: bkb bpf ihz lld gkw
vtj: epl eqj
vdw: efm xpg pka
xqo: xoz
ebc: eaq emz
kww: awx ajn htz lvg ltr
rwu: ckx cgt aez isn lcz gei
kyj: rsu byk blu anm ido inn ydx yzh lcl lzl gpj
jve: xcf xhl
xhn: xgk xgv xso
bva: azy ian iio gwm
jhv: jeg syg epv enc xiq
kqy: rby bsx cak cjn aup ild ijv hbn
ekt: ewn
liv: grc
yka: ylg gek
iwi: iqb ydi
dej: vrd vzp enh xpw
apk: gre
dqp: jvk vii vhj
yow: lcy
ifl: yyf lcx gex
hpz: yke ygo yqy lgl
kdm: kjl ksg ruv byg cnb yea les
ljw: gwa
yuy: lit
wxk: dcg dxs jwf jsj jpa ejz
ywl: lgu
ydi: ypl
kaq: czi ajb lgy lea lnx
akn: ajb hsu yna
bfg: ckd awh aqa iwh giw
azh: hhn yjf lbw gji
lcm: lac
jyo: jmm jul xjl xot
aih: ihg ygt ytv lix
ysr: lvq
vrn: swu sfr esa
wkc: wkv jce jav jmi emw etc
wvn: dil jqx etl xan xmx
sdv: ets
lef: gwk
wzi: dqa jge jjg vck vjn sao sxl efv
waa: dyo jhn jyw syb ejp
goq: dpd jhg vdx xws
lvv: ltp
ihp: ldg gbe
cnj: ixe ixo hjd ykk yyo ygb
vyt: ezp xoe
vfk: xqm pbp
cpf: hzo yun lls
khl: kyt bqs hih hsr
wir: dxj jlp vgc vvw
aeh: lsc
ahy: apw imj hcd ybg lgb lpa
dbh: dis dqs ech ewq ezn
hzg: htb ylt lgz ldv gyb
syw: ehz xrr
ynq: lyj ldf gpn
rea: bcr ccc coa abq ymb lff
lgl: lzp
wzx: vwa vqs suf xgx xxo
iqq: iun hzy
lcx: lac
ebd: enh xwd
agh: ajg ixg yeg yej gko
jfm: vxu
azk: ipm
ipm: yya ypa lsy
xqj: prt
dip: jat jsh jxd jpf vkr
bkd: buy coq hnx gas
ehi: ehp etj xyr
bzc: cck cjw
jch: jnj vzo soz xjl
lsr: lzk gbw gyf
bwa: cmc cfz czw ilc igx yio glx
cpk: czb avy apt huk ybn
rwo: rnb czl axb iax hlo ywd
cpi: afj azo aoo hey yhk ysw lxn gjy
idg: yyy
vvf: sgy egp
adn: iyv isu hgx ydt ysp
ezy: xav xne xfr pbl
els: eer xdl xjq
dfh: jdh ski skl edf xes
dcp: dxr jdr jsc xai
bdl: bsh bxv irx ihu yho lvh
ihc: isp
cgn: cwp hul lhr lzg gvy
kwc: rmb yyv yxp lkj
rpy: bbf con haj lhd
yvb: lhd lhs lvs glc
kpa: bey cml isy yqu
xez: xod
vjn: vnc
jwt: vxm vtt swi xvn xsn
jvh: jqw jtt vhf vvs eve xcu xei
ckg: cuc iqt hfm lao
gmn: jww shw szn erh
avx: ims itc hfz yio
ckb: iin hmh lbo
joc: sez spx xxj
bxz: ivz yge
kzr: bxi cmr ihl ybc
lkf: ljg
ebo: esz ezq
lye: gby
kue: bkb ipt hdb hqh lea
djq: dfo jeg jpo vre sxi edy
vhn: vjs vnt sqh xor
dyz: vyy vpo eyd
eig: eiz xbc xex xph
wfd: wqy szb xio xzv
vov: sjd exs
krw: kcp ktg rpk yfg
ybv: yhj
ato: itn gkb ghx
ekf: ebc xgn
ben: hao yyw lpv
bxs: chb chw ade hkl ynp lli llf gct gpz
aie: ano ibg ipp hlw lrf
djt: jtz vxx sbb ewo xfb
wbz: dpn sak epu xks xbb
jhp: shl xbl
kfp: rjo cuj ipm yok
dja: sgd xrs
slf: ehl ejj xbo xac
vjo: skz ekk ery evp
vmx: seb eni
iia: int
amj: yhy gcf
cea: aam axi hnz
jod: slu eec prt
gno: jmj vwv epf xqp
brg: bim bxk icz ini ytz lip gwx
lwp: gmk
kau: rav inl ypr ynm lqp
bir: asw gim gjg
evs: emf
ksr: biv bmz ion hym
ass: ati iif hra hwa lhf
azv: iag iqx hss
bpa: aed yqp lqd
ame: auk lyu lgg gka gvu
khd: rir bpx cxw afa hpi lgt
hhl: laj lxs ghs
cje: auu ikl hlb huc yyd lqf
jqp: vve smr stu egv xkf
kss: kzp cwr cfl hae hhr gai
bqv: cza hsr
sse: szp evu
cug: axu idp ift hfw luh gde
hdo: lgo lqr
jhw: vbw ske ecq ejz
wvs: jml vaz xmd pcb
bsj: ccw cxw cts arg hap
rsx: hbf
abu: izt yjo yme gck
inr: hcu ywv yqm gro
dzl: jsb vwj vpu scn eyc egg esz xpr
kvf: ron brh brs cou agr ibf ixw ygz
izw: hld ytk
lhg: gcn
wzo: dbn dab jfn sic edr enw
ehf: xjs pkz
bil: bgh bea btv cbe yby lza gjo
kav: bed adq iaa gae
but: ynp lyw lln lju
hjt: yac
ryr: rxx cxe cfg gwx
igj: ixy hxw ylh lka
yqi: lwt gdh
ctz: isk ifq gxj
jtf: vwd vdb vdc scq szt xpp
czl: avz irt hyq hlb yph
ajz: amv aoj ira
bdh: asb iju ion htl yzv
chi: cny yzh lez gsr
dkb: dtv vpx eek xcb xgg
iir: hrf hyf ggv
ghc: gvs
gth: dci srf siw xkz xdh
wnh: dju vdn sbr pkc
iex: itv yja gbm
dif: dpo jbg sou ewt ezk xob
wev: jsw vhr soi ekb ekl
jys: vnq xae pbg
vch: saf ecy xqb
wlm: vbo vwh src ekk ekn
wcb: wyd juh vey vzw sae swg sju
yvm: lgi ltv
xia: xsf xug
atx: hpn yzk
jju: evz
jop: srs eiv xcz pke pbf
rng: avy hav ytr gvj gpp
xns: xts
abc: hzf yvi
ajp: azn ywz yvr lae
sxl: esc xsh
xxo: pkh
cif: hdf yxw lqp
hod: ywf yxv llv lnw
drs: jim veq vmq sjs
kkn: kqe rhe clx acw iht izk lze
bin: bdd but lrj gpa
ipb: hxr yri
wpp: woc jlv eaa
jqo: sbk svb snb ell xtk
wqb: diu dpc jeq vpa xea
dji: dzm jpq vvt sxi sto esp xhx
eri: xjh xse xep
kjf: afx hpk hta ydy gpx
aac: apq yhh gcm gwc
epd: xuk
erd: xnp
agx: hea gpc
jzf: vwr ezs
jhs: stu xit pki
bqs: apl ato aos ikr hwy hvy gjl
ioj: hvq hzw ybb yfs lev lmp
dry: snv xam xyk xjy
can: acc amx ikg hyd loj
byr: aau isl
dyq: vzd ski evf xbj pci
vjp: emo
apr: ici yvx ggx
iau: izd hpv gsw
hus: ygu
jvg: vlu sfp xdn pkg
slj: eax
jgk: jti vxv sif xcl xwz
rhz: brt cgm cxq agi gcw
acw: ips lkn gwc
cde: hrs lfd gkj
ygs: ldf
rdk: cwq ayw add htx giw
rox: brh cvj hhw lfp
ydu: lwr geo
kmf: akc gdc
axr: iub hlu gpn
cyj: ajy iry lcl lyy
rpf: cgk cvg haz lre lat
ejl: xps
kpm: rdx akj aig ycc lfc
isl: iew yiw yns yfh
hzs: htd lil
bnw: cdz hyk ypt gcl
juq: vvd eyi
vfb: sbu xzh
rnw: ruw cho hsy hnj
ljf: lep
dfx: sfs eyo xio xxg pko
yhl: ygm
luh: gip
sya: szb
kcq: kzz rei ron acd ipn yhl
avy: hsu
ayh: amh
yxv: ljy
bym: crx cgc itw
ylp: yts lbh gka
gof: jxi shk sxd ezs xvr
lkn: lyp
syz: snw
yhr: lhf lee
afu: hjy
vvl: shl sfg ear
kup: iyx ixh ipr yki lhv
xro: xih
cpo: aal ahl ien yss yom
ygi: lli ldm ljr
wpm: jbb jnu vvo sje sux ecr ene
ytd: lcd ljj
yxn: yoo gjb gjz
rsv: bdn boa cug ilb
igp: ytb lgo
ioz: hei hem yto llc gpv
cti: ikm ybu ymc yog
kju: koo cde iez izj heq huv gsm
ach: ajx yyv ypd ljr glb
kkm: kes rcv rcm aih ybs ggo
vxi: vnu voj xyv
wkl: wjt dcd doh eiv ezi xlp
rtj: bqu aep hkn hvg ywc gam
esy: xbv xaf pbg
whx: deh dzr jsq vjm eny
arf: acq lrg lgq lqd
vfq: vqq sro sdf
jgy: jzd jqh eyr
xry: xlz xtc
dpr: dnt jlp vyt sxo
vze: eby ejb evk eet
snt: ekr ezx xqe
ejq: xlt xqa
wxs: dqp jkg jgq vdu euf
yxl: ypy
xxx: xzk
vkt: vjm vec vmb vux
hev: yem yzi
bld: hgs hwq hjh ymn yft
ysa: lkx
djz: jzi xlb
rqz: bsi ckn crd ika
kmi: ctc hai gms
iuc: yzg gaw gsa
dkt: dsl dtw jxu eei
ryc: cqp igw lnu ghu
hnr: gef
wtc: daa vlk vxt svm pke
acd: ivk iuk hhg
azz: aqf hic lcp liy lqf gpu
hsh: yqt lzu
vda: sll ecc euj eos
dmj: jzn smx ela xrb xzq
rce: brr asm iki iyj
blp: boj ahu hyd yln lsn gcm
aqq: atr hrs
caq: aws hmf hou yny yft lyn
jeh: vcw eoj xgf xfm pkd
wnk: dlm jla sgx xwf
jhk: vnz eze xgb xso
cvg: cqt ijl lgz
cqv: aun htt yrj yni yfi gsf
cya: asf lxm
rjc: rei bvi arq ajg ghb gmd
jli: jgq jvm jqx sld ehn pkt
asx: afj ijg hyx
xqg: xud
ibh: ift hen
smw: eyq eth xip
sol: epv xlt
rmg: cbg cjc hfs yvl
cte: ygg ydq
ysq: lhl grf
djs: dqh skk esg prr
laf: luc gba
iey: itg hxl lcr lor
sdr: ssw sep xcu xiv xdy
rtn: brv ckh ahj yth lay lda
akh: lgw
akx: izm hmy
sxy: xqw
kwi: kjy rew rpu bcy bpu ctc gha gdk
vnf: snu elj
aqs: ijq ydp
bjd: bnr awn ihh
bvc: bop chz aio ysp yth
djg: vsa sxk
pkv: pbp
dfy: seg eoc xlo
xja: xqm
izb: gvc get
iqv: lxi
rrd: ccc cxc afq ycw lsl
sob: eyp xsl xse
hfz: yid lrt
ccy: cqf yew yut
hfx: gca gpr
yxh: lmv gbo gcc
exx: xps xqn
bvv: czc inj lpw
axe: inq lgf lse les
dpc: vvo vps shf
ban: bgk csj amv iax
ecz: ejd xfd
jea: vru sat xga xuw
htx: lmv low
lap: lwg
cxc: arr iwd isj glb
bwm: bvh clq cwl aoh iju ldb ggy
rir: awd hjs htb
cvj: izs ljz
rej: bdw bsi cyh hem yio yse lei gaj
wiu: wvq vzo xyf prv
sdl: epo xtr
jaa: jmu jqs vgc exf
ixc: gif
duq: ssu sny sod ezu
ibr: iqk hlj hje htn lzz
knr: kod axr apt lnk gbs
gzx: wef wxy dpo jra vta xhr xtr
rop: bqo adm ism hez ybd yel
rjl: coj asg apy ijm yna gcf gwg
bqz: yfe lep lma
hfk: ltg
boq: aaj ipd yre yyn
ljr: lnu gwi
vpc: sls epz eof
gqo: whc djt jof shc ekh
jpt: sut ehs
jtc: vsf vnp xye xwp xen
shj: xme
gun: wnl jxv xrh xbx
hmd: yyl ljg ljt
xye: xeo
wmu: ddv dqb jyt vsf eff
hxd: gvi
hec: gpz
jjx: sxz ejo xwb xnq
jvu: eug
vkp: vmr voy
roo: byh bjb cbk cyv cvj cmk aiz auq hdo yeu
biq: bfi yzs gwu
aiz: yqo liw ljc
akk: liz gyj
bvg: cvx iga hbg hlc
syx: suq erj ezr
ini: lxw
ikl: hry lso
ytw: luv
caz: aqh ird lxi gax glw gdi
ryb: byk bqe awb hae grj
yfj: lrd
wpj: jfs vhe vyn vph sqb xdy
yrm: yqb lbz gsb
kew: kzx cta his hoe yad lkv
lvw: lfz
vhb: vyo xap
bqt: cla cox yeo yze
bbm: bdb buq ace ays
ric: rqx bys aml haq
vyu: vzc
rew: ixf yey yfc yzh
csa: aib ant isj had lne
kwr: rvn acc ibu hzh ysd gxn
rcc: bqi avg ics hkw lpo lox gri gxr
wmo: deh jny jti szl
bxq: ipn izj lrm lbn gjk
siq: stn
rnm: bes bnf ifu hxg lcf luh gpj
kye: kwu bch aau auv ynl lcw gkt
dwz: jjz vhp exa
vgu: sya ssv snw xca
kbj: rrt bjd adj apc hks hgn ykw yvq ldl ljd gph
reb: bvp bzn aer izl hvl ypj lwk
knm: rgb rgm hbg yrb
hjy: hfq hqs
gkj: gku gio
ctt: yet gyo
doa: jaj stg
cgy: cgj aqd
shu: sji sqy
spq: sme prp
jsc: vks vnz sbu efi
kcs: kct bop afr yby
cjv: hcf yaj
iay: hdp lrv lxa ltc
ysi: lxy
cyh: aav ayz ilc hol
yjd: yje gsq
wms: daq vea ere elw eev enk xuz
rnz: brm cdx ike ybh ydx yfa gdi
iqz: ghs gpa
gws: gwu
wng: wou jsb sqc erd
csi: aaw hga yxy
sfa: ess
bbs: bsp cxj ahc ipx ypu lqk
koa: rda rjw afd idb lgu lxw
iyq: ykq lyd
vkx: xhl xxs xqn
wff: wfq wzw wzv wuq vkq vdi ebh edq etc
cms: iok yji loo
kaj: bkb cmg hrl ysu yny ytv
cxg: agr ylv lbm ldj
rtu: iei hhf lpu
aew: yam ytz yor yol gyk gdd
ahn: amt ios lhn gvm
xyz: xvh
afn: iaj isc hmw loy
abw: ihh hwg yrg
gfe: gtf wwx wfc vrh vnn sro sql esv xjj
ssu: sop
sae: equ xnl
aca: inf lqz gso
djd: dpq jfm vji xzy
ckm: cyo aot yns lco lva gro
vqw: vuv sdw svo euj xwz
crq: akn aua auv hyz laa lzd
dfg: vyf vob sii ees
bjy: bth cat cnv auw iwp hhq
rgt: rdg bgm awj ash itc hrl hby yfq
syp: eic
gus: dwg jij vui ecp
agq: iaj hok ggv
sgt: ssz exz xio xyv
rvl: bmt bnn cbx avs aug hde yab gdk
awj: hyw ypf gvb
lny: gik
edt: xbx
roe: cin anz hdq hxf glr gls
vkm: sos eqs xyh xqv
aur: aoz iby lxi gcc gpg
sfs: ejg eep emt xcu xnw
aov: ijg ltr loq
juz: eij xby
lil: lzy
smv: env efh
kiw: cfd cty ctd idw idx yrz
amm: atk yfu yoy
vcv: vpm eps prh
kmr: koj rmq ctn azi hvk hod
laa: lyf lth loi
cdk: cut icn hjw
vny: smz xay xvx
jde: jjg set
vzu: xqx
axp: iry hya hve lwh
kzj: bjr bvu cwy igc iei ybe lzf
ddl: juk joq vck voo ear
kgz: rkt bia bgm cjb avr
cvb: cqx iji hfl yfl
kfn: rka bak ion grg
xoz: pcw
hup: lwo grd gyq
dby: dwf dex vqj vtd sbm set sqm eja xdg
skp: sct sej sqp ehe xvo
vrr: vxk skg srn xmo xzr
wyg: vkk vnl skn sbi
bkw: bnt aqs aox hiv lxp
ebg: ecq ewp xik xit xwv xfj
alu: hlg hmg yts lxz gax
vux: sjd
eju: esb eeb xgg
sbu: eus xyv xjp
wfl: dad jgx via srv sop xri
han: hti ynv lxe gmk
dki: drz dov jlt
ryo: bkx cxq ijj yue
slc: sob ezw
way: wad dra dpf dze jol ewg
jsg: vol shu eld
kkc: kwh ree bro blh hci hvu
kmy: ivh hox yly yjt
xwr: xmx xfh
dsr: jya jdl jve jum sie esx
rgo: bpg alo ide ytc
gzz: wqc daj jnw vdu szh eyl efd xiy xyy pkz
inl: gka gab
kno: kuv clh iss huu ggp
byn: cge cuk ahd agt iwy hej lim gwn
vrs: src ewl xpe
rrw: rbv rmb rfn bpc chm
crv: ahz hru hbd hjn lqd gaf gio
wkm: wqt jwy vjn xsq xmm xou
kuw: rkl clp cnk aky apx aqr yev
jqn: sel xke
jmj: ssb eps xdn xnb xub
sfi: eqz xck
hfy: lns
vwn: slo sdt sqq
scq: sog
jcg: jpa xcf
cpv: anb lkp
ata: ywy law lyl gbt
ccd: ixx hwy hqh
awk: iiw hwf yil llf
iix: yjt ysr
aiw: yik lli lgh ljn
ynt: lfz
ckd: atl hyg hwf hev yfu yqp
ija: llg lmb gyq
bzn: atq gsa
cdv: ayd ijm lbc ldl lds
kjo: bey bop cbc hbo hyf ynp lmz
rvj: iso hfj lmx ltn
jmw: jth xcu
kdc: kqw inu ioh geh
guy: wpc vfj vtw svh efd
lls: lwu
cyc: csz hus ygn
soi: xji xoa
icy: lrx las
bjl: cjs ick inf yoh lve
ear: eyo etd xcp
aet: iug ygc
auy: ilv iod gdm
cny: cth ayi ias iii lin
kbe: rwb bnc cnk cqe igm inu yaq yyq
dks: dnl vas
rjr: bvn acy ajg ixx hcw lay
rul: aqi iws hjb yym
lrl: lca gvl
iyv: hjv
aus: aoj lre lau ljo
jub: vdr ewd xte pbf
itv: laq
vrh: vgu vmh siz sgs
klj: kvk clx aak ajr
rgq: rne bba ajr hcm hpa hmi lfu
evi: pks
hgz: hzo gdz
jdz: srr sjo xgn
hnm: yoa lhh gvn
xhh: pkj
izh: iqw
rcy: bie bvm ady imh ymu
wkf: dia vxz ski svx
hea: ysk
lgu: gic
weh: vtu xhk xjg
wag: diw dvx dfp jlu sak sxn ehn emh xhx xlc
hag: hgz lwo
ckw: hgi hej
iqj: ydj ghe
vbj: siz eds epg
jbh: voz srv exk xtx
rsm: bam cjk cmv aaf aqu iav hes ylp gwr
wcd: wvr wmn dpz dza vmv svs stk xym
jny: sqa efo
khi: ktb rka rwo bkq bpy acj gye
kgq: rbz bup bum acq lee lts
hpk: ybz log ghr
rnr: cyg ywz yvc lkw
wvx: djy dmc jje var pbb
djo: ved vzv skl ell xxj
vvr: spm szi xso
eli: epl xiy
ywc: leu
vgg: set xkn xvn
hwm: yav
guu: vfm xbe xha xdi
eub: xsh
kjr: cgl cgo alq hvl hnu llk gid
ywd: yjv lyd
rxb: biu isv hyx hft ywk ysl lea
xnz: xqw prt
sws: seb ewr
dhx: jmn vao ebm ecz
ylo: lif gwd
kyw: rux cgx apv iri ijm lhi gax
ryv: cff amb auh hho yym
kwo: ksh chw cnp abq atj hwg yie luu
vol: sny exh xjb
hcq: ywi ggx
jio: jjs jnl szd squ ety etn pbk
avs: iey hpj ykp yrh ytw lhi gat
hir: lju
jjy: euc
cxn: azk aua lfe
blo: bzk
vps: sym stc xiv xip
rno: ccf iai hsj ygf lug
hte: ypm lcp
isu: yaj
wae: dik vwd ehy xks xwt
gis: gvt
raq: ahl ikf hve lil liq lno gpt
czo: ixg imj gvw
ecq: ewj xub xuc
cwd: awm aeh ibn glf gez
cvd: azs ybm ldp
bmt: irb ihc yhp yyr
kfv: brg bpv agv hki
byz: cec cph cug ycu lcy
rla: cgw hbs hsj lem
bsp: bze aac iyn lae
rtr: bis bmn iod hkg hqt gxi
dfo: ecl eth xvd xqj
jao: jwo vdq vmo ena efi
ycv: yff lko
sqh: xmc
dkx: veo vxk stu emb
cyo: yeu gwg
rfg: chb cwy cxl aua
ram: cgn aom
dta: vyb vgo sbd szb eqf xau
keg: bfs cbv iwz ydd you lnp ghq gyk
jtd: efp xer
bhe: cjv izt yci gsh
aoa: hof ybu laa lhj
sdx: sjl szf xch xts
kpu: alj hjj ymp yqh
bjk: bsm hux yib
jyr: vhd saw sft xqz
sjo: xcj xqr
cog: awb izq lkc
alw: axd aud hsl
bub: cwp aft gdm
dwx: dwt dsx jjr jvn vbq vak vjq vxs sbc ety xtb
vyy: szl xmp xfz
srw: ekb eas prm
arw: apr iin isu hii yvv ljl
epz: xar xxb
eui: xjs
ywe: lru gcg ggp
xcc: xpi
lzi: gke
awp: axi ibh ils iqh haj hzj
sbv: erw ebl ejb etw eoe xbz xpd
kjn: cpc apy iyq hsh lqy gbw
whw: wue dya dym vbx vmy sqw ech xqj
yzs: lvi lun
ysu: lhf gef
kqf: kto rpf bsm cuy iaw hog yuw gpe
ash: ikq
gsf: gei gml
kqd: ktz rlk rpc bbq bwf cpc hnl yxb
xrb: xsy pbm
kzc: cqi iou hax yjl lzs
alj: lyz
sdn: ekt ecp eil
vej: vfm ere xpd
ksk: bxk abq idg lez
rrr: rli rlp bnc bqq cya
shc: snd sue xki xkd xsx
div: ddg dtg jvq jtr vaj vge
cda: agd yem gbp gsj
gjp: gea
cps: ann iut
spp: xgk
scy: snb stc eni xgj
ksl: cbs cem ijl iol yrn ysf
aqf: atf iag hwh yrj
jsj: vwc sxu stv xmy
vyx: erp elr
xfu: prq
ljy: lpn lzf grq
adz: iry ict hgt lyh ltw gwc
dsw: jcs jha jzr jtb viz sjt esj xye xoh
ypa: lpi
vst: vtp xcl xuj
kia: ksy kxp rxb rmp crk cgy akj awd yuq lne
ipa: hrs yjb
hem: ytk gey
buv: aby hmm yss gdx
idh: llj ltg gdm
gat: gxx
eng: xrg xfg
bhg: afn aud imu ifl hik huy lvt
kzl: iwy ins lga gkl
eos: xlp
buo: crf agr iqx hqi
yog: llr
ijy: ish lxf
cza: col ilz
wry: djk jrs jzc vzb sjk
czy: agw hiy lgh
yqf: ggc gjk
wmm: dvk dmx jzz soz
csl: cuk iof
iub: yay
igr: hyw yiv ynu
lxw: ggq gjd
aki: afg hqh
ycl: lyl
bzs: auz aok ien ycj lps gsj
vhf: sfx
xce: xlg
smj: szs eag pbu
vmg: sij eus xac xyd xfi
ezf: xpv xzv
dpk: vvu vtt ews xol pbt
iwk: hnx hfs htq
kpl: bfx cft cqy iri ixk lhy
doh: jvk jxc ehx eyi xyk
aah: lvq lmu gri ghu
rjh: beh cxk aiw aft yth glh
syd: ejt
cjf: cqw ybr leu
aja: hsr lpp
gqv: dhz dmk jxy jpq sgq ssf szd sul etw eun
wmw: jwz vvn vuk xeh
hur: gip
dzi: dql jmp spe sfx stt xcg
vza: scg eyc eee eok xie
bgx: cdy hcu ysx lmw
ryi: cub ill yaz ghh
vzk: evy eqr eqa xhs pkc
sjh: xwn xjn
dlu: dgt jex edn xdy
exj: xnz
eqo: xlb xqu xod
ras: chu csv hdk
ykc: yiq yuv lcd gao gyz
jda: voz xxp xzp
xyu: xeh
bvp: bto ixs img lrn lsl
jpn: sor eyo eqv etg
kln: kjv kxd rxs awc auy iil hwz hfh gso
kcx: cug aga ihs ytt lag
ihk: ixa ifr hcw htz
rsn: idw lfv
jgu: vxc sjm ejb xrt xxd
kiz: asy ljr lvu lxb
dtw: jwe vdd xfu xtg
vzx: sgo swn suo
rbx: ikj iwe lhs lxp
bjg: asz hen ycp ywp yoc ltn gik
luc: gsp
iyi: iuf ysx
htg: ybz lsn gxl
cbz: adg gpy gme
ewt: xmn
dsu: jmy vxu sgt xkr
eau: eit
jmo: vcx vns szv
gjf: gvm
sgr: ssg xtd
sfv: eyd xxa xzj
dhu: dsa jbg jlz vth sel prg
wgs: wja dwi jgb vwd epk
llz: gxf
jvq: vgl ehz ezn
wij: djc jka jst vei slp pri
lrq: gwd
eka: ety xda xxy xta
yzy: gal gmh
iyy: iwb iwc hzb ghv
wap: dng vjl vsp vnc elt
abd: aaq apa hpa ylq liw
vhx: ete
ddc: jtp sfh xro
rnk: apy ime hfz hqm llz gsx
jts: vlj sil esu efx xkl pbi
vjt: sry syl
kzh: cmj avd hyu ynm lny
wjo: wnd dha suo xwm
vai: vsi vma sjj eiu eeg pbc
izr: izt ioh hih yrn yya
wsq: dix dsz des vbh sph eyh
avb: ywn ypf gbc
kaa: kav bxz agp awr gle
ase: aox isz iuy hel
knu: kom rkl bvb hab hok yih lkm
gtd: woh vwe voh ely xkd xui
ghj: gse
hoa: ywk
dcw: jhs
wde: jge vrl vis vqk sei enm
dba: dip xch xao xip
lxo: gsa
dwi: ddj jpj jzw sew szf eky
suj: xhh
kyc: cer izg htz
wej: wzk dxo xrg
irz: ibs gws gdy
cyd: abp irb hdb ytw
kax: caj ivr ixi yfd ljs gpa
duo: jfq jqg sma
dld: jaz jzf vgn vpa xht xtp
jpy: vkx siz xic
avj: yri lri lav
kds: bdw ace hyd ghk
azq: aul inp
blj: ayu ald izl hfw gle
jvf: syf egx xpx
sxs: xcm xwl
ifz: ybo lni
rao: cre ima izn yls
bhr: coe isw hgb hjo hsx lku
hra: hbm yuo yoi lav
vhk: ezw
krp: kjz kfb kui cqi lrs lgj
rsp: rms bzt amk ijb hew hmu hnz lor gvq
wtl: drr dxt vsm sjz enb eta
vsp: snm ekg xjv pkn
epm: xmd xnj xqj
vjb: swv swp sqo enh
yfp: lkk lzj
dyw: dte jcq sxf eyz egj xrs
vzp: eau exy xpn
skx: xto xue
aps: azf aqb get
vyz: skg sfe eze xqa
rhk: rdx ble cob ysq yod lah lyg gpb
yib: ywg gdb
ser: xje xqa
bjv: cgq hjm hua gyi
bzy: ioo yso lip leg lqc
eih: xsc
hno: hoc gcc gcd gdw
brv: ccl akl aho auc ird
dyh: dvj jwd sys svl ema
knt: kzs rpq boy cbq csm lme lzc
kvr: abf ixm hwz ghx
cfx: inc hqt ydu
lhn: luc gsi jrm
dhe: vhm vjx vxo sia
gle: gmw
bok: idp
yuo: lei
hsf: yym yen ltw gxy
jke: jam vct ekt eei
aoi: hpd hmu yne geg
dwo: jwm vla vqi vul sai sng xnn
ilo: hyz yhs llw
rvf: bcs yjj lzi
vph: vmu vzg spf smq pca
kbt: kil rsh rpb hze
sdy: sud ehq xvg
iaq: hge hzi htv yyw
lgk: glx
kdk: rcb bga bxp cmg atz iyq ink hdl yhh ygn
jet: jzb scx svr ekw eeu xyi
jwb: vbj sur
lnf: grp ggj gdx
vaf: vmh sld ebj epv
rwt: imm hzi lgh lgj
dos: jhz vow xqn
rxn: iiy hjg ycy yhe yhf lzm
ajo: hvc ynz yto ldi lvc
hfd: ypx glz
aue: llg gje
aoo: ifi hfd
cmo: arx yjj yxv lpa
wfp: dsp ebh exc euf
edb: xlj xgg xst pcs
iyx: iln inb hgh yhn lbb
joy: vpc svb xsi pkc
sdp: xkz xit
wub: dyy djt vyn sse xwd xoi
ktz: cqx aub iob lwe luq
yxq: lhb ljv lxx gvx
kxs: cey cez ahk ypr yze lao
hvf: ybv giz gyw
sdz: ebh xxp pbg
daq: jge jdt jnj vqz
dnk: dtf jfa sdx eez xfy
jri: jou vrm eam edu exi
ctb: amh ivi ype lxr
lfx: lqc gao
cyw: hbm yki ygu lmk gku grs
hkn: hsm ltl
vby: van evl
edn: xyh xlz xez xzx
svi: sqc
ssz: xop
bhh: crv aii ibo ipz hit hdh yhv gyy
dgl: jbq jfm vuz ssy xya
apd: amy ite
jxy: ska swx eov xvs
wtf: dvn dnr jnt vqd xvh
afh: itr lrd
ktc: bld ccz ipr
rse: czo aiw iib yob
bku: abr ijf izv lsu lns
kkd: kmh knt bln ady idu hpc
dux: jod svb xwo
sxu: prs
wjj: jry jfi jti vgw vwk
loi: gbq
bot: apg yxq lyd lzx
vxu: slb sop xnc xuy
rds: rfa btm crv alx inl yxc
yhv: ypf yfl gxy
jsf: jqh vsl
ikh: ynu lgf lnc lqq gbu gyx
dxb: dfv
aod: lqa gal
bqx: buc cce aue loq gbq
kgl: cvx arm icd hvp hqt yit lvp
hie: gwv gwt
wco: wgw jkk jep sdz sfh xbv xxb
hvw: ybp gho
bgr: aip aor iwy gds
rka: rjw bhu huj yho
btv: cpz aqh aty hwv gab
buq: ivo hdw lhz ggb
rar: rah bkk ccj csm afh iis
vmw: sbm sxw eqy xhd xhu xyd
scn: sfj xoc
xhp: xwo xew xmx
eav: xlt
xrm: xon
rnf: rqe ajw hek hpd liq gyh
hij: gcq gel
wli: dwb jak vjp ebe
hvd: hek
ywa: grr
jnt: juf vsl vuu etb
rxd: heb gbh gmw
str: stq eam xbv xhk
vur: ejh euq xwk xdx
sbf: xkf xdy
gnk: gzi wve dwy dun sax xfh xof
kkb: asq iyp iqa itj
com: hbw hoq yal yge gba
lsm: grl gre gwd
vqn: ehi epl eny xgs xvd
dot: jbb jtw vzl
ikb: ijh
ewo: xkq
ieu: yyw
kij: ksc rlz bnh bfr giv gxq
jvv: jxl vhk vss eqm
kef: ccg izp hxr yxr lax
riy: iiq hda hqb ylj yfc lzh
kty: rng cah ywn yms lrj gdo
jzt: ecl pkt
kwn: ker blh crb auo imy
hcp: hgh ybm yxm lfi
kzz: bys cvu cxo axc irg huc yaz lvx
sjj: xkf
yqk: yuh
jrh: vbi vbl ehw eoi xpx
hre: yif
gna: gfo dcb jwz vnw sog xjj
atu: yxk gjb gpt
drp: vrq snd szq stu ean eqj xph xfs
rcv: rjq rtk hdi hvm yay ytv
ine: gwf
dlz: dwh vwf eqz xma xfe
ajy: avt
jsv: jec szr
sxd: xud
hbf: lzk gwz
iob: huy yqy ljs
wqp: dce jin jxz vuf sui ezt
lde: giy
cgq: cwr azi hal lkb
jjw: jjd sbz eny
hwt: htm
vhl: vxv sda xvs
iqe: hbf lar
rkm: bkq avk aea hkw htv gik
knh: bxt arc ayf aqk
yjk: ltj
jtw: vcz spm xib
kxx: rsx cfw irn hmu gjs
wct: vaq shl xnh xud
lqr: gce
sqi: xxp
vay: spi esk xig
ahh: hwd ykg ygj yuu
gqt: guu dku skk xkm xwz xdc xpv
dcz: jia sjh sup ekm ees
kus: cph iwz yhh luy
wyo: wwo wfc dfh vzd vus sak
gok: wpx jya snp sfh emj xjt
kdi: ktj rus hur ldp lfo grj gpv
int: hrg hsb
dxa: jkk jxg shc euy
hxm: yht
ece: eyt edu
jkv: jmj vrf vqe svh sey sxk xmv
ybp: lbu lnb glz
yhb: gvf
gqe: wym wxa dyp sas sxv xqk
ymu: lhg lyf
gar: gvw
kcj: kzm rob cxp ctg iwh yxj
hjd: hny
cka: cta ayq agy hlf yqo
yms: lpm
ksu: knl ijg hxm ykp ljw glv
wph: jrs ekd evo xod
dtq: jco jim vnl etf xbn
ddn: jkb jry sti ecp elw xrz
hdi: ynp gyu
rij: rqz bzc hil ydh lef
jlq: vrb swz xms
gos: gou wmk jkv jif vup
ivb: hww yuy lol
pkh: pkw
gtm: jqq vpd seh eld eqx
axm: ytg
kje: kvx cwi amz lmh
yhy: ldt lnm lnn gpc
cao: cny coo abj yfs gpi
cin: hvb hup yld
sdk: eww efj
kci: bct cnk ayk iqo lat
ltb: gvz
ejr: xeo
ksq: arq ajv axz lip loo
baf: bde cwo ava hmr hos lqw gxg
jit: vev xaq pbo
reh: irr yml yzv lze
swq: sqv xxi xpl xzg
ime: gww
vxc: efa
jtu: vqz sdf xoj
wgm: deh dnd dzv esr
dcm: dai das vsc ekk xls
wsf: dax dev jvy vir siv egy xmz
ibu: lae ges
dmw: jny syx sxh xwd xun
elk: xid xpn
kzn: red abu apk gpn
jwm: vmt xfc
dew: vyf sjj egz
lqq: gyd geo
vkr: vsp
lnn: lfr gdk gvl
rpv: bfi cnk adw yio yqj
ylh: yti git
wkt: wdd dtb dul vkz vdg efq
kac: ran rvs cwd cva ird ism lsp log
jns: sri sua ejn efi xye
wxn: dya dsb jcr jie vdl
iad: hfl yrv
jnr: vat sbv elj xqu
skd: xbn xyp xxc xnw
kvm: cyg atg hoj lcd
hna: hzi ykw loa
cfv: ikp hau gxu
wrl: dwg jpk vzn xgs
aag: isn hkt hik hsh hmo hom gdy gmw
jqf: jqt vxh sit xgi
jjn: jqt sqz xbr
hkj: hhf
rsa: bjk cge abk afm hhr yud lfd
cyp: hcl hnc yjr gpw
vra: spy smg sfq ecx xkl xla
liu: lvl grq
aip: aiq ash hip
irl: hsr gvf
bgq: idp hhg yhi ldm gyx
bju: yae ynz gvr ged
ism: gwu
ard: aoe iek
awo: aeq azw iae lrh
azx: ija hsz
reo: bvc cyh clm cun hvd len gxb
lfq: lty gge
ysf: lsd gpq
ldf: gyi
wit: srm sxu smc xvn
kwe: bqi cam cpb yko lgz gah
avk: azg ijo ydt
kjv: rde rst bud czr iqh
cak: aeb iqd hrv hun
ler: ltw loh
lpj: gwl
cvp: hbq lyh gbq
vts: ebl
yah: ygl ysp
aem: yxg
woh: dhq jma vep eik
rpe: cdi cxu cqj aaz lsw
edy: xku xyn
rmb: acf awu axe hwa
arb: lzd
cpg: ipo iox lkr
kpn: rnb cdl ivy ipd
jes: vdr vjh svp eop
kmo: bvp aeq han yom
jjm: sht sns xlf
wku: dxi jca jir jts exa xaa
veg: sdt edf efr
kwt: rak bhy yke yqe lqz
dyr: dqp dta jax sfw xkw xgs
vfj: ekq
wgi: dzx jdb ssk ekt ebn xiz
cmk: czc czl hbf
vpb: spc egn exo xdd
jbb: jny vww ekt ego xbo
bmz: aru hdq ykm lvs
svn: ehn xfc
wst: dst dud vxv xoq
jdc: vyv
xra: xqr
xwc: xme xof
wxi: drj drx jfr vvr scf sgs ejh xlo
sbn: ekn efm
yjv: lcp
jhl: jmp epv pbe
kqu: rkf rar brr bxa coa gda
hxa: gvr
xhv: xvg
dzb: vxd evi
csw: czj hid lci gdv
rvt: bns cgf cjd akb aai aji iet hzt lqv
gtl: dih jlw jmh sgq xjz
igv: hnp ycr
vnd: sav pcj
bpx: cye cmy aey hbz hpa
vaw: ecy eln xbq
bkc: hcb ymv lzh gig
eky: elc xog
iii: lcc gdt
jto: swj eqe xny
waw: dch dnz xay xof
czd: axy ijb iej hoq
jka: jyo jwi vxy vou smw eew xny pbr
gty: vmg sxi epv ezx xhc
smk: sqw eog
ymi: lyl lsf gwg
elb: edt
dkh: dch jxp spl sqd xep
cgu: hbh hpd
izk: hkd hvh yiz yti
adj: hvk lgs lsv
ylr: ygc yef ltv
ihw: igz yfz yof
cki: aev
cky: ivb hdt hfv ywx
erm: eao ejc xiy
dwv: egu exh ext
yqu: lbp lek
dwf: jck vci ehn xjd xsh
vae: snd xdg
vib: sry smc
wwj: jru vyn vwt sov xab xlc
hjb: ghq
iaw: iep lky
bcg: ipp ylu
iyg: iei hvd yci
iyj: ghi
deg: vkk syh xaa xeh
cni: ahm aul ill hhc yio lfc
idi: ycs yxb yqi
vgr: vzc sez evv xux
bth: hse yun lue ggn
ruf: igr img
axk: ivn ykg ymf
rrm: bdq bqr box akb icu idq hnq htr
ajj: yfj laz lvk lft
bvn: awb gpz
kxf: ibc yci lgp lmn gxy
wmv: wui dyc vye sdh eut
ysh: lqm
jkd: jcj jsm vcx vmw xfq
soe: ecs enq xkp xhu xsm pbp
cvo: cos hzs
wyd: wqj dhf jbo jmq vhc xyl
eyg: xyq
dfu: dzc jvo sbz xdn
cgh: cpe cuq hnp yzq
wek: wod jre sbo xfb
hct: hfw hou
bmj: iml hlb lem
dio: dgy jiu sra
clj: cxh hyo ypz lzv
vnw: skn ero evh
wbp: jss jqb vjp eoh xrs
der: jyv jfe ecq
jos: vbd vmd vum voi pkj
lrp: liu lyh giu
xbf: xgq xst pkj
wmc: jpe vkg srf sht xfh
yrn: gcn
dmi: via xzc
erp: ejt
hui: yoy ggu
afb: lep gry
cqz: apq amo azt idf ydm
bwc: btl akq asj ihl ygt
azd: hcl llb lsf
stj: exg
elg: eus
cay: aro amm hnr
iew: ims gjr
smr: xni
dns: ekm erf xbq
ycw: lxe
ino: hhd lvi lxw
clb: cvd idm ied yal yhs gcd gef
cwl: imm yib yvj lbe ldu
wov: dlv jgc jmb suj
ezz: prz
yjx: yor
dwq: vdo suu xsf
cpr: iny gkf gyn
gny: jwx vih vfq sri sxf erh ezh xrl xex xfy
krz: kje rrq yco ygd lbu
leo: luo gvi
ciy: csh iee ljm lof gxs
djf: dma jjt vqn ebh
whr: dsx joe vsg syt ezx xvk xsk
ksn: ryt rqd bax yew
jyk: jfz soi exf xtm
yti: ljd
yaw: yyb yyw lle
enh: xcd xik xqi
arj: ygk lkf
jkn: jwu jzz jqf eqs xjx xxx
icj: iti lje lsa
von: snm xhe xws xwf xmf
drq: dea xhq xyr
sdq: xlu
xta: pkj
kmj: riz rqt bxn csg cxw
vle: vzb xci
bwo: hhs ydx lhz
wxd: dzh jjh sye sna
ial: ynl ytg
vwl: vwz sne xfd
hfu: yfm gbh ggt
dxq: jvg jso ehf pba
hyr: ybs lrk
gtt: wzs woh dht jfc jut joz vne
gbz: ger
wuu: efz euz xdx xmk xzq
bng: ckk cmy ihn grc
jtm: etg xee
aje: axv axf hws hjm
dpb: sbs xvg
huw: yhl lhs lna
csp: aaw hdy ymn lwq
lwi: gvl
djh: jiq vty ewe euf xrt
ydr: yea yeg
sfo: eyd ewx
kph: bgi hiw yak ynl lgj
hca: ygi ypi
jai: vsf vev syk eap edq epf
gdp: gjc
hrp: hvt huc hoi yle lps
bpk: bzy itu hcs hdt yla
jgx: viz vdk vxy vxt xqh
xdp: xnv pbx
bpj: cbj ymo lhv
rca: awa ivo hbn lkc liz lgc ldg
dey: jbx vel vqz ebx
jxr: sik szr esw
avf: axq ggc gvn
cio: cfj asv hay lxr lms ghl
ipg: izc hnw
vlu: sjk soq xmg
cov: ico ljt glq
dtt: vee pbb
rdt: bta coa axz ybu grw
eyq: xie xin xgf
wud: jen joc vbx vfd sfo prc
rii: bqv lxb lxm grn
gfu: dgo due val eee
vik: vwr vjr vjt siz eim
hed: hxn ykf yig
aqg: ltu
cmw: col abt ies hpq
yta: lip
aos: imf
iwm: liu
yln: lum
ewd: xyp xux xof
ymw: ytn gve
jgb: jzr vua vug
cxp: hbb yrf lhz
alh: hns gap gdi
dqk: jjc vhd vqs ebx
vbz: xhr
sbq: xgt
bez: cee acz lor
bbb: aer ykq lba lcg
yjc: ypy
wan: wpj dnx jzg ega
ynw: gmw
idx: ifo hgs
ayy: agz asn azk yyd
htw: lax lsu loe glz
bkl: hyf hdp yrb lhz
dje: dst ded dtk dtn jdc xmz
yij: yva
hdt: yya lee
rpa: bqv cka ibq itk ytf
vua: ssf suu xkz
dpd: dtd dof vet sgh eaq evx
szn: stn exx xry
wkz: woy dwn vha exv eza
jph: vdg ean xrd prp
dto: vin eks efi eum
rtm: bae asf iwt har lfz
szx: soe exm xwo xmc
asj: hpn ylm ldy
lke: lew lpn
bsa: ada grq gvc
brq: iay hds her hnh ylq
hyu: yqi gri gjn
byj: bqb boi hct hsn yii gcb
ell: eph xdo pkw
xhf: xda
swv: svc eie etj xnu
lbv: gjh
ixq: hsf yiw yip
ipe: lai gyb gel
civ: apd lek geo
dbi: vxc srj shu sws egd xgi xdy
cry: cht hpb htz yak lky
joj: vnl vnz syp sjs
iwt: itv hca
whs: jrs jla vrs vbh skl slq slt smw
yrz: ysm yzr yoi yow
lem: grd
soy: xif
ici: iee iop lbb
czz: awa aod iyn ixp yws ggd
rhq: ryh rfl ces ymg ytb ldz gjb
sov: elz
bkp: caf clz cww iio ivs yqm
hjl: hoc ybk gmh
dln: dmz vll sll xum pci
lcz: ghc gpj
hug: ylk gbo
jgo: jde vmb sps xec
ivd: hky lxc lms gdu
wkr: dmc jmo scr ses
ani: ykj yau lgo
dpq: jbd jwe ezp xia
jfj: vav sew eaw eew xhy xto
jcf: jjk vxs stg xaz
abm: ahk ihz lxv gru
cso: lrx ghl gwq
iio: ijv hvf yoj lwz lxg gkg
hzl: gwe
eev: xxt
byc: izz
dkm: vhn ekz eqb xec
jxi: vwm ssx snx sfq xdk
lut: gkf
vbp: veh siw soc ebw
hnp: hua
htf: gdx gmg
hka: lsy
hwe: hqe ygq
cpa: idn ifn ybv ldv
yom: gim
kfl: rge akr ytf
hvn: yic ydo yfm yzq lle
rvz: cgz ako hap yda
rvp: bsm iam gwp
jui: esn xph xma
kux: bee yzu ljo giu gga
xky: xiu
hny: lwm
ybc: lly gky
kud: bkg ceg cpr ajv axu yci lnt lqa
bvq: cxr aya iqt hcu yam lub gpy
yls: ygv lnh
irw: yfy
cge: csj iny gyf
yuc: lhy lxc lqe gkr gbm
hwx: yeo ypp gho gvf
wlh: vzm sli xox
hdc: ygv yfh gbs gwe
awt: auj izi
afs: hmp
gkg: gia
ivr: hhx ysh luq
gqc: wak dkw dyr dpb jgx ekq eeo xpr
xsg: xoh
lcf: lzu
jti: jtn sxy snh eoy
wbe: dct jnm jtu xap xfk
dsy: sru scd xzy
vsz: eyr ejq emd xae
iro: yfe lhv
dyy: xmt pri
bwi: cez alo ygl lwy
rjz: rpt boh cfd aof lva
kgm: blz cgk ctu ail alm aol lzg
emn: eud xvh prp
bmv: ipc hli yck ylw glu gvd
iel: hhk ywv lnt
kcf: kvs cwv cvl aqb iba haz lih gso
yub: llm lgw ldt lsh
ida: hgo yfp law lhb
sti: xvc
dmm: vgg skh sht efu pcb
syt: xbs
rvx: rfn bnm lni geb
gol: dgy jje vwn vuc spa enm
hdy: ycb ggh
vih: sys evb xjv
yob: lbs gak
gvw: geb
vsg: vmn sck spa stp xlq
rgx: bsy apb ivp ifu iqm gbd
cdy: cmu icb yih gar
auz: ily gai
ktq: rws rte ccn ceh agu yao ldc
cfl: iwo lae gxi
cwx: iaw haf hox
ynb: gam
jwi: vig vji vse syc sws sop eey exj
smm: ekx evt ezc
kda: rah cgt arr itx hsu
bou: cum igx ien
soq: eut xdr xqw pru
cko: cag cjg abd iiq ixd gys
wtd: dmf swu epz xwx xzn
kkk: kej csk ayt lto
xnr: pbz
hvk: ytr gvw gml
hya: giu
asf: ihb ifm yeg
vif: ehl xoy
ysc: ymp lnr
wys: dqm jiq vkr vkw vdx
voj: sul eeh xhf xub
cwk: hdu hqt ygt ymt
rdh: lho lva loo
vjv: vxe ebz ede efx
xfk: prk
wal: wyy dsh jiu vrt shn xts pcc
iky: iay isj ldh lok
cvc: imb hmu hqh
jvp: sds sxg etm xkr xbw
arl: yro ydo
lnb: ggk gpm
kzw: bvc boh czu izb yyn ylz
xcd: xsg prs
aua: ikp
hth: lic llt
ext: xtn
ion: hxi yog lcn gbl ght
jxm: jmc sss sso egj xvb xss
kfc: ruk bdn bsp afs ypk gyt gpz
jva: joe slt esy ezl xga xxx
hrd: ytp gjl
jyv: vce vjm shb erq eyf egs eob
eci: evo xlf xdv
lyi: lvj lfn
iun: gvx
wtt: dtj jkv vxk srp scb ewt xst xof
boe: cxt ibb ijq yqk lrp ldq ljm ltu
aqc: ydi lkx ldi gbb
bwe: cfb agv awp yvt ypt lrm
ryd: bhb byc yjs
vrt: vnz slv sgl
bwf: hir hzb gro gys ger
lvz: gjh
bhf: coq ihh hdy ytl ldk
erx: epm
sqr: euo
wya: dee jvr jvv jes vnj etp xss pcw
bzh: cki ccb cab iaw ilx hdc laj
gtp: jlm sjp szt
vbv: vay sfj eid xox
lbi: lek
gkd: gbl
yqz: lwa
dkl: dlq seh sfc eji xfz
dbm: del dxr jah jld vyu vgg ezd
bdm: axc ics ixt ytr yog llu
vlk: ewn
wqu: jiq ezh xcq xgp
kic: rla cfe ctn hiy hzf hut lcs
amu: hil huz lgl lxr lut gyz
sis: shm
rxy: cuw irw hkw hxz yge
lwo: lmj ggo
sbp: sdb sss set xem xfr
lfm: gaw
vbk: skt xlk
cna: cof agl had ylk lic
ypc: gen
btk: cca cgw lbm lcr
dnn: jxg stj sum xwj
krg: kyd ktf rdf rsd rqz cvo cfg aio ine
ykj: ytu
jta: xzy prj
yly: ghg
bry: bsn btr cda cqk ari yvf ljy lmj
wbl: wbw wce dnv spf eaz xhg
iqg: hbr lbp lhi lxd gib
ehv: eso
hwu: liu ldw lmc ghh
cet: ikz hgj lxh luz ghs gpx
rog: crf caz cvd ctf ymf
kjt: cey iyf ljy grc
ltv: loy gdn
kza: rfj byl ble bsa ibl iao ghy gjf
cvu: iom lmd
hkw: yyq lcf
kyo: kfj rkr ytj lji lfz lqu
kwp: kqz ryp ryn rti ayc geb
rhe: are asq izy hrc hst gsy
eno: xml
efa: efp
jis: vzh srq scf sin xkq
vbf: eot xud prf
blu: aff iux
ckq: ciu hhh ysy
hfe: gvz
ewx: xig
hbu: hye hgd ynq
kez: cqp arh yfp lkd
xgu: xxm pcj
ess: exy euo xhz
emg: xbw xgu
jbp: jve jec vgd sez xes
kqa: cgv avo ixs hpz yfn lyx grn gjv
jlv: jmo vwt std xlr
ekl: euo
kyf: kqo bmx icm gsq
gtk: wbx dvl ewg esb
sxq: ecw pkv
gqi: god ehs xxw
jno: vbf sha eal
vtm: egw egz emy xqt xth
ymg: gjm
kwy: kvt kqe rbc yfw yta
jkb: jxb svs ely efs xlh
rfu: cji icm hlh yxj yfk gmx
ktd: bis imh hhw hvq yly gsw
hwa: hjt yxi
hbc: lhl loo
sxm: emu
rql: bnv ctb cuf hpl hqi lje gkr
wrs: drd jcn vlz sce xxq
acm: aop iit yik yuj
snp: sod elm emt ens
wjz: wsi xrn xxd xqt
xlb: xpd
byv: alg axg irh ywb ysz yem lox
stx: xiz xxg
wsu: del sru sej evg eup
rsf: rnb bac beg bnj caj hvy hnl
ixt: hio lhp lxx lns gsc
hxu: lwe
yuj: ljb gre
efw: xrl xbl
dgd: jil jwl smp eww
rsr: lml glz
yzl: yqr
shb: ehj eoz
lby: gkp
heb: ywe yvz gdq
wrk: jnh sgi egs xrl pbq
rkw: rlf aiw igq hek hpg hzk lhv gdw
icr: lki lyj
hoc: gsh gxs
hqt: lnu
ies: yyd gbl
bsq: irp ihz yem lco gsd
wzw: dgi jlx srj sjy eds ema xxg
jxh: era edi
agg: ipu izr lcl ggn
icp: ihe hpe lxa
cls: cql anl igl hag yoh
bih: hqd yax yxe llt ldq lsx gdw
kgj: kzf rtf cbg cch ipl yjg
kuq: rol cwv yvs lld
dxl: dph jvl jxk jnl scy edc
ynl: ldt lfb gss
kbw: rok cqk air lim
xlv: xsl xxk
cjg: czh ipd lrj
dfa: jkg jkn jge jzg xvo
cvq: hfk yic ydx yex lwn lfw
yny: yob lkm
blw: abg lhv lva lms
kvu: rxc baf ihf ivh ylr lej
axs: hzo ldu gax gwq
eef: xyv xsl
wik: wwq wnf sss ekc
dgp: juy vgb vvl sbe sqz edd
xyx: xtu
jax: pri
ddb: sgy svp esf exf
wuh: jwx erg xjw xnj
eir: eoy xdc
kld: kod rwv rqr bex cxo axw ixf yrt ydc
etr: xcy
vkh: veh ssf ech xoa
hva: yzj gyc
wsj: jln sdq evv eum xjb xqx
jxx: jzg vfl scq seq egp
dfm: jvn val vjf svu ser sem
ddj: jrg sdr szw xif xql
avi: icb itb lvq
jhm: jea vga sgp swk egl edj xnc
ktb: ill ivu
wxa: vku vqb xlm
hpd: lhr ldt gel
eni: xwi xwv xsf xoc
kmp: kze rom imt ywa ypv lit
vld: vwz vfg exy exw xva
dye: dmy jvt jqz snn erl enz
dtc: vpa vni voc sip svc euz xpa
bdu: apj ime hfy ynu lcb gxm
wam: dwc dwi dvs jen
dvc: jgc jgd jmz vpk ejz xsw
lsj: lov
kat: cih ijs yzp ghi
srs: sop xdn prb
jmk: vrj vsp scd xla
lfu: ggo
sve: suq xix xhu
ydk: ypj lyv
bgy: bxn caw afk hca hnq ymg yny lqg
inh: hzr lii gkv
shi: sjh ewp
iuu: yyj lom
eey: xin xmw xzm
sdf: eod
eaa: xvb
cnp: abb htc ycb gmv
yrh: grc
hbo: yci lxa
iiw: imk lfp lqu
bkn: bzc cua hjv hos ljt gbk
wxw: dcw dtp juv vbo vaw vuq sbh emp
rqv: izo hft yha lnh
klw: rhu rvp cwu hsc
ckl: ciu izc hgl hfv
bwj: bvc bxn che iak glm
wnz: jip jgb vcm vjq vxx xkw
dov: jks vqe shx sne soz
ryw: bjw bun agu ycd yjf gjn gsg
bbw: yoc lxv
eln: exc ezs
bqe: yri ypp lgm
lre: gct
hse: yin lhi grn
hvu: yse lrz lal gdb gvv
ijd: yci
gfy: wok dpj jsg jmk jzz vzo eyy enr xyn
knv: bvy iye ywa yvb
jbz: jvo vgl ekv emw
baw: cph cmz lnv
sng: szv eet
gor: jpo vma vmg sre xsx
rll: ccq cak cps iet ycx yij
wem: dnn joz var eeb xrt xbs
wrm: whh dua vhs vnj ehf etf
jpx: vhj xzl
bqk: hje hxa
ldk: ltj
yrp: ymo
rjj: axo ilk yij yjy yqr gbu
xig: xyn
wuz: dxj vre voo suv ewz
csv: yen lkt gwq
vga: sok
ywy: glk
bnk: buc icb ist hxl hqw yhs
ezw: xjx
rgd: rsk cbu ikk inz hsv gid
jcb: jil jmn vmh eux xew xoi
ixa: hmh ylx
vki: vry skv sad seu
iai: isl gms
srz: elj enc xni
bhk: bqk cac ioh
ewf: etl
rmj: cyn ctv aeq ing lba
yyp: ygl ywr lvh
kmq: rbr bkp iah iif ysu
ccw: hxb gvn
wor: dic dyc jdc jvk jfj eog xzw
iqd: yeo gjg
eks: eig xdc
ivz: iuf lin lmj
kur: rxb bsr cyo cpd iyl yls yde lwq
cdd: aar ihy ypu
gba: gcg
ixy: yat grw gye
stq: xgc xxc
bfu: ayj yzx gxb
wbo: jke stf elo ejt exr
rjg: bre cto iwt ipi gxa
jlj: jed svg ebi ezq
enl: xrw
aae: hmh
dik: dyl sxc snh ejz xpi
sgy: elq
wuj: jza vhc vdw vpq sab sjf xzv
weq: vot ske eqd
kdj: ksn rnn bcw lbu lej
bhb: ciu cgx ari inw gph
aog: glb
hou: yka
jby: jcj spb smx
ezv: xut
vhz: vos sph xab
cok: acg grt
ajb: hbx yih
ymq: lwb lmt gho
dlw: jkh vkl vng svh szp ewr xjm xui
kgs: kuc rdh apr azr hke yhg yzy gjq
vqk: egx ezx xak
rsi: asn gsy geu
cyy: ikv lgs ggn
eps: xev xtq pkc
hhc: hes
wio: dhm jiw jni sbe sqy
dvr: jln sud exd xhj xvp xei
auw: iis hkt ybe yqy lwy gbn glm
rss: bcy bnh axq ijn ioh lgy
rik: rjy rty abq
rqj: bpa cci ifq ioh hky llv
hfr: yxv lgf
lkk: lip ghj
awi: add ymq
vho: sdp xpj prk
vzo: sxw eaj xyo xes
ajw: htn yjl yfb lps lfy
hki: yrq ysg lej lne
cqi: aky apa
cur: apu hgr lyc
chn: icd hix gbi gjg
esl: eqs xln
bmh: ctw avk icq hpa
lar: lhb lmd lnd
aev: ihm gxm
joo: vwe vfb vtf skg eyc
joh: vlv vju soy eaq eml
dco: swh ssf sfo sqy euz
aid: ahg ans iau hol ypw lmx
ehb: ewo edq xxf xfk
vla: sif sqc evw
kie: rfw blm cgu hez yus lsr
bfs: irw ysc lai llo
gqy: wyq wwh vah sod exk xyv
vgd: vem vuj srf spu xwp xxx pki
hjg: lqi
wsi: dbk dpo jlv xwg
vxn: vmx vtn suv edw xog
kft: bml cjt cxc hxh
jkf: vau vld vgg skz ehy
cht: ydg lcs ges
ved: vqc skg eva eew
rco: bcs hlt heh ymb yqn lns
yxj: lfa
srm: sqw end xvt
cqa: ikw ybf yzc lzy
rqh: cqk avb avc glu
bgd: cts ibw lzg
ctp: ahi hwv
irg: ybi
cen: yzk gmy
czw: ylh gvu gej
jyf: vfg srh emf xhp
rft: bqm czu asg igf hqx yxw ljf lsy lxs
jqg: sad xat
ecu: eau evk xet
shp: egi xvl
rpc: ror agp ikg izj hvh ysz lni
bfh: imb hoj yqb loh
emi: ena
vlw: ehm pry
ats: hov lrz
ifv: hkk yri yia
hbv: lka gda
rfa: cxs ikh hnp
ejd: xai pbf
rjn: rtv byq cec abo ief yrh ybw lbz
stp: emx eni
emv: prx
cou: akh ymp
ddz: vyd srs sjd xsz
htl: yhy lhv lnj
cnr: aeb ihy idw
ajq: ypb lwj
dvk: vkf sfj xco
yhj: yjh lio
sec: ezm eoj xqc
wei: wew dcd jws sxc
wib: jmd jqp vfs scg syi xup
hhq: hle yoo lpe
