irk: idg hsn yjg yzz lyv
bec: bex cbz cxt cnz anj
yxv: lks ldo
cyl: cmk ctk ahd
boo: ctw awc
kpf: rlk rqz bim bem ahk
kai: rwp blz csw axg
hiw: hdb hzl yfg
cdm: cjn cmk asn afj
izb: hja yuf lic ldk ldl
aod: ibb ili hac hyq hvm hnn yfq lap
bbo: bqr csn cqy acg
yvc: lwg ldl
hez: ylr ydu yna lik ldw
bir: bns cax cfs ctj
btd: cna aei
cfw: ajn
rxh: rmj bcv cyi cgp csk cnx
yhv: yta
irb: hth htt huy lvs
ypd: lbt lve
lla: lgn
bdh: bnx bfv aws
yro: yge ywl lcg lli
bgy: cwo
blo: bjv abw amz
aor: iwq isp ith hgv yfn lch lje
rsp: rny bpz cia chx cya ctx afp
hxg: hxx yic yhf ygq yvm yth
iqi: hhx hvj
hjl: hux
bfo: cfy afj
irq: iyk iuf hak hsr ykh
bua: cco ctf azu
hhf: hoz yme ynm
rbu: rym rvb bcc alw
rkm: rhx reu bit cit cvo arc anb
iqo: hhf heo hty ygq lbv
cew: apy amo
kzd: rus csb coz afh
iaw: igt ius yai yqi
hxp: yre ynd yfp
knr: kqw rrd bub boa ckf cgs acl
hfk: lic lgv lsh
ron: bpe ckq cbk cvr acd ajs ave azy
bby: bif axn
ahq: alg ajq
ksb: ksx rit bdx akk
rzc: bnw bob bol cjp cvo avk
kfb: rru brc bqd crj cpb cng czy
kin: kpq bfo czk asv
hpn: yex lit
kvt: kzc bhv csq ams
kao: kvx rkv rwj rmp cfd
yfm: lbf lio lwh
kkg: rwr rtt bkh bsa bqi clr aby
bqh: cwg arq
isx: hvo hxx hnw ywm yfn lan llq
ibq: hlg hev ylr yxn llk
ytr: lhp
cga: cgf cfz
bqy: cfj akt awp
yik: ysd yef yxa ymc
rtc: cng avu anx
hmz: hnv hof yfd yuw lkg lli
rti: bjg bej bxj boe clj
aml: azp
cxx: aii
hjp: hzf ypb yzg lrf
klu: rrs rlf bbd bhr bnt ain
rgp: bxa bnj avf
iee: hdj hsn ybm lwt
ruz: bso bmt bnz aii asp
cea: ayl agg adm
bnr: cjj
lhz: lhu lyn lga lsr
hbb: hny ykd ytg lia ldk
kca: kdq rfj rok bgz
bti: cso
kgc: kvr kot bfd cca avb
ykb: yav ysd lbh
hse: hzi ybx yyp yod lbs ljx
hgo: yxu ldw
kti: rhm rjd rqz bkw cif
cql: apj
bzt: ckn cnv
ihs: ilx iot hgf ybu yyd ysb lir lyb
rlz: rjo rxi bol ckp
iic: ifh hyg ycp ymj yzx
kml: kow rmt bzc cpg cuy aki
bna: clw cna arm
hkf: hik hzi lri lay lha lhd
hou: yzj lku lay
kne: kzs rru bpy ayr amv
bws: bnk afn
hxj: ycy yid ypi
rud: bsf bnk cff cti ald
ysp: llj llt
hhv: hhn hmq ymp ytc
chu: avm
ccs: cfj arw acj aap
ica: ijn inv hmy hfy ybi yqk
rli: rnk bgh bso cab cnu arm abl axt azy
brt: bcz ccj cdz csa cmz cth
ipv: hgi hvl ysj yzg yuk lvf
rsn: bxd cbq cpr
iob: hjn hxe hug ygy yug lih
huv: ysy ljx
yel: yuo
rnd: rqs bcd aah aaf aiy
yjo: yxf ypd yqo yuq lrr ldq
ibk: yge ymf lrc lvd lsh
irx: hhn hvz hqu ybh yiv ylc ldq
bub: coy
iou: ydc yel yzq
brj: bce bot cia afd
rrn: cwa adw
cdp: coz
kws: rzm rzt bal bik ckp cmr aki
bcj: bmr bfr cyd avp
cca: aly agl
izw: itl hkh hnz lbi lbl lyf
lll: ldh
hsw: htu yav
kds: kmf rvs rsq roc cir cmw abm
rqd: ruz brb bjc cbo ctq amd afg
kix: kzh rsu rnp rtq bvo beo cka arc
rik: rva rnj ruk bog cro ceh aky ari aag
ycy: yjx yxl yuz lck
rul: bwb cxp akx ask
cqz: asb
hec: ywi yot lrt
yzu: lrl
kmx: ryt rud bah cst cmd awy
ige: ioh hjb yth yuu
cel: ayu
kwk: kvb bfb boq cse ard ayk
rhj: rfs bjf bvj bsp cft
iui: hlw hfd yro ypu lre lvy
bbq: bny cvk aai
cbd: cpb cqb
hkv: hlq hvw ykw ytz lwq
hlt: yxu yfw yuk
hcr: hay hlr yeq
ifz: hsd yuj ljt
hie: hys yhp yeh
kpr: ran brq cas cej agt axo
izg: hsn yzp lbh
cly: csx cnv agl avv
rel: rnn rts rug bbx bun axd
lgi: lvi
rbw: rwd bdb bxs css czz cqr akj apr
iaa: iif hgi hjh hzc hte ytz lvp
ieg: hlb ylw lks lhc
chr: chh cta abj
yvp: yec lbv lli
hoj: yhr yti lcb lwr
hif: ycg ycp yfe
yqj: ldu
kxq: kpl kfh kto rcy rjv rvz baz bhx bdk crg cep cfo
clw: awt ajr apx
rcp: rjw bvx bqx cwb cwq
bdl: cpk
kqx: kon bmc cas cqu
rxe: rfb bwd bxq bqy chm
yrc: yis yjz
ccr: cjv asf
raf: ryx bwa ari avg app
kqg: rgv rjk biv cot amg
bgw: bog cyo agf
cpt: cfv cqj acl avj
atq: aoy ian ivr hge hoe ybj yiz
cyo: cqz ayv anf
ivi: imk hbv yfw lbk
igs: hxj hpk yhr
ima: inu ifh iqh iow ymk yfb yzc
yrx: ynh yzk ldm
yts: ldn
bfj: bos cgi
kbz: kxw rjc rvp bmy
ity: hlk hpg ykp yjg
clp: afi
iqf: huy ygb yzz
iep: hod yox lkc
rwe: bes chp
cxj: arv
rfs: rtu bdh cwg ayk amq
cmi: aae
att: ier hbs yff yzw
bsm: bne aky
yjt: lhv
hzh: hqs hud ycf yjl
bpy: bof cel cnn ama aml
acj: app
csz: cqo alp axn
khh: kei koi bkz byq bti cil cql
rdc: rxi bff cbt cff czv
kgo: rhw rht rvg ccd asd azv
rob: brp bem cjc cnr
bbu: bca ckk cvg
lww: lvd
ixx: hlg yju
cit: clq csv cqe
bcp: cwi czu ctn acs
crh: ctz ayh
ikp: ydh ysv lrr lyt
yta: lwk
rxw: rpf bai bwe bmw css cxn anf
hvz: hqe ybe yow
kjk: kzk rrx rjp cdy apv
kev: bha bty cbr csy coc cot
rqa: rqx bvg aev anw
hwf: hdg hum llc
rhn: rsi crh cdf cmu ain
bqv: crv clk cxy azw
kdo: rrv ryl bdm com
krc: rqi brp cbi cmh cnf aab
bru: bvh cip
yjh: lia
bxm: cix ahy aep
yls: ywt llm lwc
bjt: bvr bex ckg
hpw: htn
rje: cym cpa ast ann
alv: ape amj
hlk: hzq ymm ljr ljz
aom: ivq ifw izs hvr hsu ycb yip ydb lcx
bsd: cax ana
hcq: hhg hys hfc ymi
bug: arj
kbp: kwi kjh ryl rpz bsn cyi
hel: yrf yvy liy
khb: cly cgc cen ame
yqt: llc lwf lvy
ycg: lgj
rsk: bjm bfz csr any
ibd: ipd lrl
lkd: lys
bnm: bql cql
iji: hqh lrg lcn lae
rvn: rpn brb cye cmn cfa aea
bbc: cnk cou ahe afo
yzj: laf
yuk: lyc
ais: anm
hdj: hej hqp ytt liz
yqm: lgd
itx: hfn yld
bea: cwe cxs cxn ajs
kbm: kwo rii bak cge czc coz ane
civ: clz cdu acq
yla: lkf lvd lsi
kwl: ris rjx req bnt ckg cwh amy
kiv: rdg bfc ccg cnv aik
ybr: yhv yex yeq
ckg: ceu
rgs: rxi rty bbc cxr abv aym
yow: lbq lgi
rgd: rek bkz bon act
ckj: ccn aga adm
cpv: aiz ank
hnw: hum ybu lbx
cqj: axz azf
cjg: agb
lkl: ldo
bma: btd cjl cni
kpn: bqf ctq cuf arx aik
aee: ant
cqc: aru ags
hbx: yme yqg
bxv: cft
atp: iat ief imj imq yhb
yxm: ynw
cvj: cxb cqj avw
bjw: bvx bvf boh cog coq axm
ypo: lrb
hcy: hqx yth lil lyf
blh: bec cbj chu cpu coh
ijw: imf hrm hby hxl ypj
kll: kdk kno kfu kud rwu cae cwi cxg cfg
bvp: cko cbl cpb czr add amu anc
hfg: ysz yxq
cnw: asb
iai: idl imo hmu hqs ybn ygc yxf yfq yzq yqe lbz
krm: kdp kmw kfk rbp rsi anh azl
avv: afk
bzd: amx aza
kwn: rwo rut bik cwj cvt cph axb apy
hdp: yhk yhi yxu laq ldw
ieq: inf hgw heo yds yjd ldd lsj
cnb: cok avf
rqu: bgj bpz bmo afd
rfj: bxb bmx
ayu: aew axr
atg: iiv ify hxt hok ykt lhk
kco: kae rvm rsj brm bml
kvg: kvm rcf bgz cpu
hrr: hpw yyj ydt ydu lwy
bzb: bzj cgq ctw
rwo: bck csu acn ajt
cmd: cof
cig: cfd
ixp: izf hbi hmn llu
brd: bbn bpu
csw: ain
kqk: bwf bxx bno bqr cdb cmu acw
kag: ksi kmx rhz rlx bhr btb
yqk: ljm
ipy: hxi ydj yff lrk
cmm: ali aph amc
krw: kwj kex rza cgd
kqe: rrs rna cpj ctt acp aem amu azd
btq: chy cwv cox aby aht
reb: boo cpe
ylo: yge yjx yvg yxo lwf
yok: ldx
kfp: bsb cyv cnq czp
ctv: aje
cwm: cfb
ysz: yzy yqn yuz
yhr: yyr yzz ytu yoz llb
byv: btb cdj cxq akr aeb
ypg: ymv yoc lvu
ked: rrv bfp cvb awf
afl: azp
kzb: kzu rbd bxg bpn bfi ccx
ivb: inb ifk yum lat lgb
rxy: bbd bun cxc cnh cqc afs
atw: auo idg hbr ykz yyl ygv ysk
hbt: hpu yky yay yfz yui lcr
cag: alx aqc
rss: rnu rtt bxv bfi cbn cfv ahf apl
kwm: rzx bpd alu apy
cst: cqg
lyr: lwd ljc
khf: kps rij rly rjs bcc biu bwf bfr apc
ibs: hrx ygg ywj yzn
avc: aps
ryk: clw cgk csi awn anu
kit: kyc kdc kpn bvh cgt
rhu: rph ruj bck ayb axk
hog: ybk yjl
hhx: hsk ykn ywd lyk
rjv: rza bcd bpo bqn bth cwq cxh
bwi: cbv
clq: cst cnp abc aif adx afn
ivh: yhd ysb yss lik
yso: yel yxf llj lvx
ixw: heo hfs htg yah yid yzf lsi
ybk: ywq yvm
rag: cai cyw cdo cpk
ynk: yqs yue
ryz: awm aeb apm afn
rpv: bkc ctq acm any
kqj: rfb cyf cqz awp
caz: aen aff
hjq: hoh lwj
ybe: ldw
cuo: ads ajh
riy: bfb bqr cec alb
kxi: kpa czp aae aye asn amj
ina: hom ymn
ixv: htm ymy yfh yoi yom lls
che: cwa cso cfd cqb
bfp: cef arp aaf alk
ywj: lhy
blg: ayu
hta: hoy lgc lsk
cms: czd
hbk: hyi hjd yim yph lln
hsj: hmc htw ylt lhr ljk
hak: hic ysu
cih: cen ayt
iql: hry hgo yje yok
liv: llm
kct: bbo bhz bew bnl bzl cje ahi
iwr: hcq hif heo yni ljq
ifg: ife hiw hvn ykq ygd yef ytw ldl
rhd: bzv bqc arq adu
aic: adh
kyu: kme kfg aar ala
hlw: hqb yoj lvk
hwz: hsm yhq lbd
yic: yzx yzf
rou: cba cce cdx cvl cmw aiq asg aza
buq: axu azh
cbq: acc
hbw: hzd yyh ypp lle
bkk: cfa ast
bnv: awp
ato: ixy hgx hwn hvz heu hne hua ydj ydq
cox: ajm
bfx: cch cav aan
rhg: cat cxc akr aby ade
kxg: kol rtr bsq cwi ads
bwq: bzq cnp awi afx
cuu: awo
bke: bkn bkz axp
ikm: iiu ife iqk lgk
rjy: bbr bva ckd cdk cvp
yrf: lgs
rrz: rjz ckk apm
rtx: bak biw cvi cuz aes
kjj: kfd kzd all
ryb: rlo rzi cns agq ajz azy
kuv: rkh bjx bth ccm chg aii
bkg: bsh cbp
kjs: kmi rib bln ccc ahc
cbx: clc cvi aje
cji: czz aqr
rno: bgu bss
rfr: bbh byo coc aje avf
ihw: iqu hrz ydp lkn lvk
axm: aqb
cjc: cqq
roc: cik apk
hpr: yvi yoo ldt
ied: ipg hay hjk hnh hub ydw
kga: rrz rpx cpv cfz
ias: iwu ixl ioz hpk htj hul hoh ycv yal yhc ylg ydw yqj yub lym
rkj: bft cbu cnp aeg afo
rta: bzf cpg cfi ake apf
bxi: bpj bmu csv cna azl
kji: rhx baj bix boe clj cwx cwm cez cph acw asr
kyj: rbf rdh rva arw ahy ajq
bji: bek azb
yaf: ydk yvn yum lal
hfi: ykz ybj ywk lib lit
hni: yjx lwr
kan: kir kpj bnc akd alf avq
kgj: ksa rio bnl
bjn: bjz bfj csa
iju: hyl hok yfg lyu
cra: cxn cfe czd
bnu: bfo coo
rtp: bzj cax cma aap ayl
ivc: hvw hew hxy hnn htw lcz
hei: yhn yse yus lio lli ldm lvx
ksz: kms cpw cuz aws adf aet anu
coe: amo
crw: aky anw
hym: hpm ysv yxj lru
kfk: bic byb cku cbm csm
bzh: ckc cjk aip awe
bbf: bgb apf
iof: hig ylt yvk yxp yqt
yjg: yxx yfk yzd yuk ldr
kwr: kpj rcx bwv cgu cvr arg aia
bhl: bfx btt cdf cnj ctc
hhh: hgm hvd hxn yfg
hji: hft lkc lhk
cbh: app
ktv: rgd czb cqd axc amr
krf: bjm bvv cas apl
afi: azj
ktz: rzr rud bhv cqj arz
aar: ayc azq
kxc: kpw bch cek ahb afp
iij: yox lhi lyb
adp: ajj
kfz: kup rim ryb cdt cei aap
kkv: kxr rzh bww bfl
ycx: yaa yqq liy
bze: ajk
ido: isq hhn hxx hnl hnz yrb yev
yvu: lbd
ctq: asl
bkl: bjd bey bny cqg ahg agr
ytq: lrh
ylp: yfy yzk lks lgz
ksw: knd kfi kfw kfj rmv cbr cmg
rzk: bha bwp
iqy: hns yxx ynj lba lhx
cup: als asb
rny: bha byo can
bbn: bga cal cjb col ada ade
yha: ylj ypu lhl lhq
khc: kgf kui rkt rdq cho
ati: hgb hwu ylf ydf ytp yuc
cvr: arx
baa: bps ckp cbl czk amp afz aze
hct: has hzu hqz yir lys
kes: rdi rdo cbm ces cmu agv
ixe: ixm hkc hep hxu hta yba yit yqx
ljb: ljj
rmk: aez
rxc: bty caz cws axe
bch: bym cyj akd
rct: bdc cpj alw aeu
hza: ykg yav yla yda ydu lkh
rff: bbz bck aiq
lkz: lva
lrv: lag
cth: aix
cxd: coc acm add
klm: ktt raz rna bsc bxz cwl arc acm
hrf: hla ycg ycp lki
rww: rnx rqo byt ccy cpu
rtb: crj cft cuj cux ago
rwy: bvo bxk cid cun alt
rxx: cbe cxq cpp
hjo: yub yut
hne: ylv
cjk: cvs cth axn
axr: axz ami
hba: hlg hzk yhc ljg
byc: bgm bnb cms amh
atb: aop hsq ygl ydy
kdn: ryo bse cgf cdc cvz
iwc: ine yhr yho yyf ymh lwg
iza: itj iuj hgx hdj hjx hnm
ibz: hbg hcl hvd hzi huh lvm
rjq: ahl
bxj: buu ckx ccv cym cer akt
yzh: yqg
ijj: hmc ywx yqd
kze: rid byv bdl cls acy
heq: ybr ydv ydo ljm
cqt: arh
kcp: kdy kpd bve cdg abe
cyb: cfs
rpi: bey bzd bog cbm cfw ahl
idd: yrf yny yum laf
yqq: ljg
yky: yrz yhy ypk
bqd: cau aaq
kuu: rcq cqu cqo
rqq: beo bth can cif cfb
keb: ryb rlw rdj rsm bis bgj cbm cqi cqj
bkp: bnj abk agx
rgg: bct blo cia
rxj: cmx cuq cou akj
kyb: rel rzw byy blz bvy bzd btv caw
hzj: ywp lkz lrn lbg
brm: bjx boy aic
bni: bzr bqu aar agg
ypk: yma yme yfv yox
yzr: lir
hsl: hmr hua ytr lgv ldh
kvr: rst bct bnq cwt
kqi: rzm bfk ctq awi
bvc: afa
keo: kpd kzt rcs bxu cak arb ana
rpm: cci cxg ajn aen
adc: aez afl
ifd: yhl lkj lri lyx llm lwi
riu: bwc crb cdg cvw
ykf: yfv
cgg: ahv
cuf: cuq aso
iap: haf yzu yqc lko lve
iyh: ixe hnp ymv lra
bwh: bup css cto arn aix ayb avt
cci: cln ayj adb axr
yms: lam ldq
rma: cax czm aar
roy: rod clp cjf czo
hln: hsx hqr ymd lcl laz
rqs: cdc aib
roz: bsi bze bqk cdw
ydb: yqb liz
hol: yae ypf
kxt: raz rfo cfs
hkb: hxc hpc hum lrd
htn: ygv lka lhk llf ldv
yxk: lyo
ion: hcd hls hwx hfb yjt lhg
ahg: ahe
kzp: kut rbb bnx cih
cap: ano
hej: hev yiv yin ylj
yoz: lce
bhc: can cjz cne acg aay
hsp: ynm yfp yub lsi
ijm: hls hwq hjc
bpc: cah
hzf: ygt ywk yfu
haz: hix hsl ljk
rsv: bko cxm coq aio
hhz: hyd hjc lkv
hmd: yap ypj ytr
ihy: hbs hls hpt ycq yns yzs
run: bxf cvo aar
lae: lwz
ybj: ywr ymz lck
bbe: byk
cby: cgz adv
rpu: rty bkb bhw blk ajc
hdf: huk yaj yfc yoo lrn
hiz: ycr lbi liw
lyl: lle
hyc: yjc yxa liq lyy lvh
rms: ceb cqy aip
cid: cyu cqc alq
blu: crz ahz
hrd: hbo ybl ycx ycq yts
adn: ajj
ruc: cgu
csf: asu
rfn: biz bxm cao czr akb ahz aec
ypq: lbh
aba: ajm
abj: apw
aes: apj
ksp: keg rpp bau bxi cky cku
yut: lhz
adt: ans
ytf: lro
hjk: hnd yak lbn
ckp: clf csy abu
iiu: hcp hyt hws yoy lka lwy
rnv: rok bjg bnz cpz aju
ilk: hle ymg yzg yuy yus lgr lwe
htt: yct lio
boc: cpf cts ait
hsz: ybe yze
hax: hxv how ymm yzk lgf
rlb: rff bki bvy bsc cuj asi
rwh: rfz brg bif bfq cjx axk afz
yvh: yvn lib lva
rdk: blv clk csc ctp
hda: hjx yvj lbw lgl
ctc: aiv avb apv
bxu: bob chx cyl
kui: rlr reo
ram: rma bzh akj aeg
ixb: hwp hnz yhp ytt yoc ldx
aoe: igp hcl yjx lbm lws
kif: khg rxg ckp cpp cts akk adz asj
ivg: iev izm lrf
kww: bst bfr cha cnd aaq
ahd: awa
bhr: bjy ava aes
yfv: yzt laj
yjp: ysc yff lde
kux: rrn ryg brp bci bzd bzn abn
hmq: ybk
crz: cgo cjl
bcz: bai bsr bqq ckx ala axw ami
cxa: ctk alt
byw: bzi all axs
brf: cjh cng
lgo: ldk
csb: cnu cft ans
izf: hbd hzv yvi ynj lhy
bsu: cky cgx afr
bva: clv cjp aat
cvz: cpa apn
rwp: cee afv
iuv: han hvg yww yzm
cvn: csm
yox: lil
bow: cex cff
lim: lly lwm
czz: abl
rev: bkh ciy akq
kyc: rrt bac
hfb: ljc
bib: bff bon cdx
krp: kgb rdl bgh ccy apb
ynl: yte
rsq: rma cbi cmf agd aqy
rcq: rgw bcb biv bzp cro cqh aik azz
bcd: baq cya csm axk
rbk: rwp rwo btl cla awz aeu
rvr: rvm rvn reg adn
kid: kdh ree bvp cij cyb
iip: iyt ivd ixn hld hsm ybr yvh
cxp: aif
yye: ygk ysh lhk
bys: bwn beh aid
cns: adw
his: yiv yyq lhs
yar: lkb lcl
cuh: ayq
cce: abc ajv afg
iux: hst hpo ljn
keg: rfr bkd cdv cse cuk acc adh
ryg: rlq rse bdh bei czm czo cuf
cqe: aab aat
htq: yfc lkb
lkq: liv lgw
irt: isy hrs hap hfr ykc
hoz: llf
cep: asz
ryd: rzx bbf agi
cub: alq
lbu: lle lln
ico: igs hlk hnc hzy law lwx ldz
bff: awv
rju: rnm bcu cks cho cdp cqs ami
bdj: cpc asx
btx: crx cik agm
iwd: iey ite hiv hgd hvt hsu hmo
laz: lwo ldk
yjb: yew lhd
hbf: yjx ljw
hci: yfk lkc lrr lia lip
cnx: ayl
bri: bjd bxx aiv
ioo: hyn
hsa: htn hoc hoe yqu yud lit lgj
atz: ifh hiz hgq hsf ywr yju ymp
rld: bvy
yio: ygh ypj
hkm: yil ynv yop
lrj: lif
hgl: htq hoq ybv yip lsk
izy: hjz hoi ynt llt ldp
kup: rwe bjh bvr bze cci ayp
haw: hmr lgh
imc: hzl
yed: ymu
hfw: ykf yfq lwr
iix: hqy huk yjt yzf lby
bnk: cdj agm
cdd: cun azx
hxv: ypl lyf lyq
btn: abw
hgm: lrm ljr
cvf: adj ajg
ium: ioa hch yfc llv
hwa: hpq yvc
knv: kou rcc bwz bje bvv cgv akj
yci: lyk lyd lsp
ivy: ivm ioz hvq hno
cxv: cfs azh azt
rgj: bvn bzk cee cxm akm avy
cjb: ahr axb
ccu: cgc
itl: hje hqw ymm yuk lck
rhp: rfu bvy ckc afv
lgw: ldi
yrk: yiz
ihe: ijk ijb hyk hvr hou yaf yms
lrm: lgq lsd
rpw: bef bfv azg
hqk: ylj ywh
cij: cyy cmb czk
acd: aeh
kzs: ren bwc cix cjv asj aza
cmn: cft abw aww
ini: iuo ycl ypp lww ldm
ikk: ite ywz liz
ccd: cgg cxe cfm akh ana
ijx: hbr hci hym hen ykg yau ynv lrr
hra: hcx haa lrf lgt lwt ljl
kjf: kov rdo csy
bml: cys
ibj: iln hhn hgv hwr hpr hog lgm
ihk: ijm imx inm hgk hvz hfx lwj lvk
ign: hfp hon yys yxi lyg
ies: hmo ysv lkm
lrh: lap
hfo: hqb ygu ymk lca lgj
yyc: lrm lym lwb
kts: rmn brw bar azm
rnf: bhn chc akh
ycv: yde yep
ibr: iyk hwt hvy hmq htl
yib: yox lgy ldu
hdy: hjc hjj hfc hop
rxd: ccm cmv acj act
ipn: her hzt yul lwv
kxw: kzk ktl rbl bym csa cpj ago
hhe: yjs
iwh: ivm iow iom yql yuj lip
yga: yjn yxf ljf
kjz: kmm rxk rpw cbz ccs cow azz
kya: rtf bwx cjz cxa
bnb: czh axa
lbm: lbu
kyf: rav ril rwd bfp aci aee axt
hyi: ybd yma yzv lyi
rcz: roe bcx blc bjv czf
lrq: lio
aki: avq
kun: ryj rdi req bcy cvb
rhr: rmb cru czz agk
kvx: rrc rjs rem bdg bty cgg
yyp: yez lbr
rhb: roz brz acs aeg
inr: inq iua hmk yra
yuv: lbn lsl
lkg: lct lhn
klo: kde kff bmw ahz
hjd: hqy yxr yuf ldq
ctm: arm abo aag
rot: bpu btl ccj cpo cqm
lcg: lau
rbq: rxx rqg bvq bmf clp cme alt
hud: lry lhf
bve: cvn aan aau
bov: acb
hyb: huk ybc yhk ype lad
iok: hii hsn hor ldy
irh: ibl ilh igh ina ifu hxa yjr
yvw: ljy
krh: ray bhw bsr akm aiq
rlx: cwc cwl azz
hsk: htc hua ymx lad
hko: ycb
bzv: ccf aln axs
cbl: cyd cvt act
ywp: lro
bls: amr
iwx: ifs iqc hsl hni yah
add: axz
kwj: kwt ksu kxt rzl brm ccm
akn: axc
kah: kgd rbv rbo rvf ccd
hqw: ycc ymr
bye: blb
brs: bxq bms cgz csa acx
cia: chp agz
ckh: clm cei
hmv: hfs yhz lhw lgo
ivl: ift iqb hfl yhu ypl
bwe: bmd cie
bgo: bxl chw ali
hjt: huv hok yse ymp lhu
ktc: bid bee asa axr afx
hoh: yke ydl laj
lak: lvu
hjb: hen yhn yzn lga lsg
rjr: blp bxi bfl boz cfy akz
bte: cpx aab aym
rhy: ref rfa boo aaf
yig: lgl
bbm: bzw cec
hnz: yfa lyv ldx
aur: iyx hlg yfu
liq: lhu
clh: cgc cuw aap
akp: arh aay
kqm: rre ble cyf arl
bjq: bsq cza
buv: cgr cdp avl azo
bje: any
cvm: ayf
bwm: cdm cez amc
ydj: yty lrj lwy
cgb: cfx ctj aey
bah: bvo cqc
kmk: beq bfl cfi czq cub anh
kvb: ksc ktt rpb bvp cza
chy: ceb cxc
ifq: hkd hik hwx ygz ysh lks ldf
ryc: rqr bid bnm crz cbu cas axp
ikj: inc izz hat yxt yqo lkg lat
kov: rns bph cbv cch cge cxi
kni: rnj rqr cyw
hmj: hup ydf yek
hnu: hfz hom lac ljt
iqn: hbl yrv yiv ysp yeo ypr ypu
ahl: aso
rak: cgl cdg cef
hui: yds yma yfe
cfs: ahp awn aew
ydl: ymq lkq
kac: kzn blb bvs bxh cyg cjc cjg cfj ano
rnr: ccw cjs
ydo: yod lks lsc
yah: yhi ylx lly lse
hvn: hvu
ycn: ywl yqc
lif: lds
raa: ryk rvv ret
asl: azx
iwi: imz lap ldw
hbq: hss hen yam ynh
byo: cnj cur aaj asl
hhk: hfp hzr
kgf: kma kni rws cdk aib
hqf: yzu lcl
yjk: lye lgy
hhy: hlm yli ytx lsk
ypw: ynw lgi
rfw: con
kru: kxa bki brn cry aiy
kaz: ksa bgu bop ccl aib
atv: ihc hka ysv yeu lvx
rhc: rec cav
yrl: yiv yee ymb yta
byt: bqj cdz aji
kzc: rnq bjy bps cka cpg cmi aix
iny: hhi yab yxg
bgl: bpv als
kat: kdi raa rdk cio cml cta
kkx: krk rdy rui bbv blg bgg cdt cff alx
hbm: hnm yjc yez
kri: rhd rsw rxk bgn bfz agu
kuc: raw rqy bhn
csh: cfm ags avq aek
ycp: yiy ydm lcn
rpa: ckc chu cxg apt
kiy: kso rvs rsa bac blj ccx cgk abm ank
iuw: hbh hjs yag ywb ynm yft
imr: iou hwv htx yky yis ygb yxp
cpk: czi
yit: yyl yjq yjt yfi ljg
ayh: ash
hbn: hxp hmu yxk ypo lrt
hos: ycl yhd ywt
lry: lla llx ldt
ket: ktw rbb rhj rzt aad
chj: cgr akf apz
rjp: btw cbc cdc ayb
bxn: cqr awr axh afp
cjm: aia afn azh
hmf: hog ymu
biw: bll bnm cbh akq arz avh
hva: hea hqi hol hop ydp yvf yxq lgz
rtr: btl cax
kck: khz kyw kny bva btb bun
bic: bqp buy aaa
arb: aih
krd: kxl kmq rkm rhe rnv rzp
ygl: ldr
bgt: bwi beu bmc cig cij cxr afa
hls: hsu ldd
hps: hqd yrv lvn lsl
ybg: yfy ytx ytz
irj: hlq ylg yov llv lgc
ipb: ipx inx ykc yhl ywi ydx
kns: rev cly apw
acq: aat
axe: ano
iac: ier ydg yuc lay
ygv: lbj lyp
ysn: llh
hai: hyb ybh ybl lbx
hzn: huk yyn yen ymw las
bok: crp cbl cxe abv air
yjv: lhj lyq
rcw: bfg cak car arh
hop: lrv
yko: yat ynr ldt
hxf: htt ymn yzi lhb ldd
kgm: kep rkv riv rem rzu bss abu
brw: bat bus chn arm
hov: yin lbe lwp
izd: iqt iuo hkg hkq hlg how ypx ymu lig
kha: bke bkz bnm bok abd
bhg: bgd bwp crh cnh aju
hqp: yxy yfs lvh
hhg: hwg hnh
rdx: rpl blz bnm afz azd
rum: blv blu bpq czl ctb avv apu
bxz: cek aqr
hqx: yhu ywz
ryn: brv bdq ccx
ync: ynj yul lkc
kna: rwk bck bhb bnn cvx cvp
iik: ilu itl iok ywo ljh
yhf: yle
byu: bdq cvx alh alu
iwf: hkt hrj yqn
clt: ail axw
hna: hol yzl lii
imn: iqi hrq hly yqr
hih: ywn yvo yfc lwz
kud: rbo rji rup bch bdu
cmu: axa
rza: bjn bxb bfh bov bos czb akn
ryi: rty cke ads
crf: cli clv asi axq
axf: anq
hfc: hzg yho ymd
rfq: bhq ckr crc afi
hpm: yre
avu: azq
igw: iei iup hcv haw hwl hoh yex yxc yua
ace: ajv
cix: cxf arn
lco: lha
hmc: hfh htk
hvu: hfm yid yjh lll lgh
ywr: yvp yek yzb yzt lyk
clx: cgl
iyv: hrq hay hom yvd
huw: yqw lke lbj
cpw: adc
had: hjo ldx
bsv: cpo ahv aqa
yiy: yil lri
rqr: brr bmr clt aiq
ydh: lwv
atm: aos izc yra yja yvy yxo lkv llk
rft: rqh rtz bpn aid ajx anb
ygi: ywt laa ldd
cke: cjt aiz axv
kuq: rdw bmq caq cgz
cim: cxh cfm arx
ilz: iny ywn ydu yuh lhh lhe lgn lvy
kgn: rxn chs cjm cxd aaj aat
kwd: ked rgr rsm rxi cae cll adv
hyj: yzk yzc
ygr: yzh ldi
lbp: lcs
rgt: rdx brk byw ang
yyb: lya
cgu: aew
iuf: lhh
yne: liy lhz
rvo: rxt rfh bhq ccm ctt ago asa ass
iow: hwp hwo ysy lyk lvm
cwc: csc
czh: adn
bkd: bpq crf cet
yda: lae lsr
krj: kwb bdx cij cyc cpt agw
bpr: acd
itw: hnt yrg ygk lai lik
hem: hqz yla ytk lyc
bcf: bph bzg ctw asz
knz: baw cmo czs axb
aoo: iwz isd hhe hof yba ynp yqh ytl
crq: cex ava apd
bao: bit buk buf cjn ces agj
ksx: kmi bkc cvb aad ahr ayv avr axm
hpa: hzn hqy ysy yug
htg: htn ldm
ble: bon cyv cnt
izx: iqn yhe yma yuj yuv lyw
bnh: bno cwn cda
cgi: ajb
hjz: hew yiy ylb yzt
kpg: rry chp clq cqf aid
rtg: buf cyt asj afz
rgm: bmk
kxv: rxw rmh bjs cud aan
hgk: yks ybb yfu lci lwy
kwh: blq cgf ack asm
rcl: cmi cfu czh awr axb axq anc
asb: amy
ctr: agn asb afb
ktt: rrg rtz bew cbc cla cmg
hfq: ybt ywl ywe ypr yto lrs
cdg: awa
lki: llt
iro: hwa hws yap lai
iph: itr hzw ylo lji lsa
czg: ctk any
hio: huw yol lro
iga: itl hdq hne yke yie
kmt: ris rme rnz bmb cmy cuw alt agy ags aeq
hcp: hly hxz hta lbe
cou: arw
agq: anl
cnv: cqi cor
hmw: htx hom yjw yxs
inw: hwj ygk ysh
bmt: czx agt
bjy: bfp cwn cmb cnm ahj
cqk: aij alf
alw: awx
ldy: ljq
rml: cbd ccc chz cfp
kee: rlc rlv rnz bjd cfc cfx aej
cta: apg
idv: inw ioo hop yyk lhf lvt
ymj: yqb yow lvj
hjf: heq yia yxc lik
cet: asw
yys: ylh yjz yqr
kbe: kym ksq kxq rks rah rlf alq
kom: bhl bdl azn
yjz: yzu
hks: hsj ymh lwn
izr: hfp lrl lhl lvv
cbf: cda cnb
bpu: cvh cqk cqu arr
bfg: ciy
ivn: iex ykb yrf ygd
hco: hwv hjo hnp huo yrc ycf yxx lwl
reu: cbx cnm cqu ape
bsi: bsw cjo cvi api
ifx: ifp yhl yoo
ikl: iap yxo yna yzt lbb
lyx: lsk
rtj: biq ckr cjk cvk ard abf
rqv: cvm cul awp asn
kgq: rck bjj ccc adg asu
kqt: rhb blx cyb cez ctr
bgg: bmm cfe
krx: kyv rmc btb agg asy
kkk: kxp kmr knm rwo ruw bkm bxu cbe chh cgy agh agn axo
cio: ceh cnh akk acg
bfl: cre ayx
kft: cxk ctx axb
icz: iqv hoz lak
rzf: bxk bpk chz
boh: crv afj
kbs: kyb rbp rlh bhq byr byy bvv ckt
iya: iep hoa yyk ylw ydv yjp ldc lvc lvt
rok: bwd bxv bni chr are
hjh: yhv yqx lhi
bou: cyy ajj and
lli: lsd
ckv: cok aad als ade asi axz
aii: anb afb
bjb: bqi czt app
hpp: yql
bfz: bqf cvw
hff: hoq yjf
llt: lwl
ydd: yjb lwn
bcu: caw cqf cty adi
bod: cbz chb agb
aik: aiw
hpl: lic
iwt: izw hne hzn yog
ybv: yyz
rif: baw byy bli bda cpn cqb
ite: hav hnh yzd lkq lab
cno: cqg
ype: yzj lre llq
lrf: lbr lvx
rna: blj buc ccp csn
bco: big bwb akp air aep
rmu: bed cdm awd afu
hao: hns yrc yfu yqv
cre: cbb ccr
rbm: rix rim ckg ciw clg csu
aoz: iui htu ykr ysm lkz lri
yby: ybx yfb ytk lyi ljx
ccl: cve cso cxv
lcm: lih lwj
koz: reu rzi bfs caq cyx afq
aul: hcf hvi hey htg ycw ycj ycq ylv ypu ymn lce lgh lgp ldt
cqw: ary
bck: bce ciz aya asx
cnk: asr amj
ywc: yvk
rup: bos cen
yap: ymj lbt lcs lhx lyw
ibi: ihr itk hrc hhk yhj ygy ygw yxv yqy
rvc: bnv buv cet ctp ain afp
ivx: yip lac lhm
btj: crx cye ajd
iss: hyz hqw yon liy
ker: rae rqq byh
cnq: ctf
kbr: kdv rpw ros btz afo
crv: cwe
hqe: yap lre lbv lin
kua: ryq rgh roi bos cpv
bmx: boq cfj
hyg: hvp hzf yif yxg
hyq: hdr
ksn: kzn koi rfi ala apn
ceh: ayf adn
hoe: yrw
bci: blt cog alg ado
bhj: bzg boa ajw amh
kdz: rch rfp bkg bii bhr bsk arb acr anv
hmi: ljq
iwn: iec hxd yck yau ysw ypt lkp
ygy: ywm yme
iim: hok yco yiw ygv yxp yff ljo
rgx: bbf bal byt boc crz cyo
iaq: hbs hqe yfm yff lvi lsh
iig: ipm hkw hxh yki
kof: bag bhn bun cca aan
ccm: abe ayz
kmb: kzx rzz cjp cmt cno avx avp amr
ipd: hiu hti hts hoy yqi
cza: ack
hnj: htu yhv yga yfz lkn ljm lvg
yxw: lji
hxr: lve
kbc: kwz kmk ral rlh rlf bdo cjy
ymq: las lgg
rbc: bex cvf cte abq
clb: cdw cnn aal
cwq: ahx
bpb: cky crk
rar: rtm brf bjn cai csb
buw: cxd cpj coc awl
hrp: hbp hmu hmo yin yqi lws
rsm: rxm bcc
inm: iqh hdm hxi huw yya lre
ksv: rbj rjs bww bmp bnf bzl cvz csc cxp cza
bda: bun cod ahj
bgj: bek cdi
acr: ahj amz
ypc: llc lgr
irc: idz itw hhs hgq hzy yhj yop
hlc: hvl hxa lwg lwz
bgs: aih
ahf: afk azn
cbi: cdh cfi
bxf: awi app
bfw: cba ajv apb
akt: abk
rvv: boh ckl chn ajh
kdr: ktw rkn rcc bmr cca csu
rlh: bro cbq
hyo: ljj
hwy: yrc yqo
hdz: hfw ybs ygu ywp ysd
rep: azf
kxk: kuo rab ryo ror byu btm
ihb: imv hrf hfq ybh lwu
but: ckb cvq
kgh: kwu kdy kjk rha rnu bhk bxg arw
cxt: cqd
ipa: hcx hyt htf yzl lwd
htd: yiu yfl yqx
idr: hrl hyd hjs yyc ljb
itj: iur hzw hzp ybv yqa lib
ckz: cjx cev axe
rkg: rhg bmr cml avl
bca: cys
cmq: avi
abq: axz apj
ioc: hsr huf yjw lcb lld lvr lsn
yec: ldk ljr
brb: bvb acr
yss: ljl lsi lsx
cte: abg
cuc: aiu avo ann
bgi: bel bxz caf cil anc
csp: czx ahc azc
apy: azu
yce: lae lsi
hcg: hyk hqo lho lgs lva
alh: alo ast
kxx: kpi rjs bhx bvc cob
bmv: cxr
icm: ixp hmw yax laj
bin: cep abo
ixc: hno yei lcl lgg
ybm: yij yie ysd
bpf: ckc
lba: lis
kwp: kuw rwr rvw bpy axv
iii: iih iiz ixt hoa
hjg: yru yjg ytj lis lgb ldm
yaz: yfz yfu yut lcz
riw: rnf rfr bci cyi
buu: cex ctk afd
bre: cno aiy
cmv: abp
avy: asm
ran: rlk rlq bbr cav aid alw
cjj: arg
igg: ivo yct yod lyr
ili: iju hrf hjj yrg yws yzk
yxl: ynx
hxm: hff yti
rmi: bin awc ass
bmu: caq czz are aij
blc: cbx cwo ama
hot: yrl lcx
kps: knf kqt bkd awz
kkm: ker kum rbb bgz bel
cde: ajb
kfu: bhh cca cux
rzi: blc act
hfa: yrp yct
hof: ywa yzv ytj lcb
idq: ist hrf ynh lrp lbb
bzc: cin azf
lih: lwz
byx: bvu ads aeo amh
lrx: ljf
bhx: cdl avq
kli: ktt rvc rzr crw cas
ate: icg iat htr yrs
yrd: yza lyr lys lgd
kpa: kqm rpr bhy
kzf: kuk rzk bha bzd
bdn: bpu cuo abx abu axq
ars: ajy
rkd: rgs rsd rem bwu alh agg
baw: cyc
yal: yep lal lsl
lhe: llg
akr: axm
agu: avs aqk
kdy: kvp koh bvy ccq ahb asj
kbg: rbe bnr cby cpq ayw ave ane
rku: ran rnd roc bqb
hka: hck heb hqm lci lix ljt
yiv: ydx ldm
bcs: bdu bzb aeg
ivp: ipk hmy yir yvw ymg lau
kea: rrx ryr bua cxf asb anv aqa
ics: idm idf ifh hxn
rii: rps rzr bxg cvl ayu
adf: ajw asn
ydn: yoy
knj: kzg rlx rdv rpk bha cgy
iqg: hlz hpr lio
hrs: yof
knm: rba rwk rpz rnw bfm
irl: htw ysi yzl ljl lve
cuz: aja
imx: yxs lyi
kgp: kpm cma cue aaa
hfx: hup huo yel lbq
aov: ict ifl hcq hzo ylf ydy lgn lwq
kqv: ryh rgw rwm bah bnr cud aev
cao: aai aym
yfk: lkl lrt lhh
hjc: hmm htn hud
cwe: ceu axf axt
ypx: lke llv
bbi: chg ail axu
kgs: rlh rth cal cwz cpp cuo air
yxj: yoa lcd lix
ips: inx hof lrb llf ldg lds
bhp: bjz bmz bfl ccc adp asc
ipi: ypr
hjn: hok ydg yxr yzf lrq lji
rck: rqj bkn bwm cva cop aeq
lbr: llo
ile: isq ioc hrc hpf yqt lyb
bgp: cug akk
ijs: hak hjr hvn yrj yvt
cjd: css aeo
cwu: cpe
lad: lys lgv
iau: hwh hxl lak lsl
yjm: ysc ljm lsl
bzn: cny awr
ief: hps hzx huf yci yjm ymv lyi lsg
bog: apx
hxi: ywu lwz
ifs: hpt hov yai yht ylw yfw
bpm: aaq
cha: abd
kgx: kwo ryr bzm ckx cwg czu
hti: yrn ysm yfv yqd
ijp: hht hgz lhj
kzq: rvl ckq cyq cnr
cbr: cik ajq
bpi: bfq akd
ifi: hhw hyw hyx hwn heb yft lkw
amc: ani
yws: yei
cfq: ait ahh alq
lrs: llc
ice: isc yvu ypg lwa
bpq: cvi
cyi: apa azy
lcf: lga
isi: hvx hps yva ljb
rqg: axp azr
hok: ylp lgv
rrj: bbx bvw cdj aeh
crx: ady afm
ytt: lkd lju lvn
rtw: beh crl cdo akv
bxy: boo
kqn: rcx rtc bci blc bvs bfc
izt: hby ykp ykt yyp yxm lwf
ajx: avi apu
beo: cgs ctb acn
ict: ilu hoo ynr lce
iqc: hrr yiy ygf
hjx: htk yxs yzo lrs
cbm: cah che awg
aag: apg
rin: rjl bia bwe ber ahq
bld: ccj cse cqo
krz: kgk kdd rgf clp cqz ajp
yfu: lku
rnm: bnp bfe cwk avh aex
kdc: rlj roe chk cnf avd
cqm: aer
hde: ytm lke
hae: hdu hmy hoq ydf yeo yqm ytu
rbd: rcd bkq ark aik
hkr: hri hhk hhi hnd yvl llb
blp: crl adn aeo
rkb: rsr rpw rtq brk bvg ber bov cbd
rcy: rnh rfp bhi bzt
ysu: yer
rph: crp cmf
iks: iez iml iud hah ykl yfi lyx lsv
bux: akg afr
kec: rea rme bve cap
hic: hvf ysq
hyt: hmm ymr yzf ldu lvp
ree: bzj chh cwo aiy afk
ycw: yon lbu
akf: abz aht awu
cvh: anz
rdr: rec rqw bgk bsd chp abd avc
ajl: aed
idz: ycn ygn lct
hbe: hyy hxa yhj yvw yov lky lkt ljh
kcg: rks ryi bpi chn
rcu: rez brc btu aga
ixk: ifx izh hon ygj ydc yom
rwg: roi bde cgf arl anf
hxu: hqb ync ljh
kim: rwf rfk rqz cir cwe cwt
hep: ysc yux
rcs: rxx bzz cpw
ytg: lbg lvb
ihi: ihy hvj hxc hfu yyh
imi: hsi yce lcc lsi
kno: rll rxa rzr bur cex
iww: iwx iur hxt yve yur lrr ljb lvb
ipc: iog hic yat yma lrb
rhh: rgp rpf rft czy avv
kbv: khw rfb cjs asr
aat: axa
kak: kwm ktj bah cam arm avy
bqs: btx azv
kre: kic rcw brd coa acy
aih: ahs axl amy
bfe: chq
all: avy
ilp: ioe hbx hvo hfs yif yvo yei lss
bpd: akz acl
yfj: lin lhj lld
hkk: hfb yaf laq
knq: rrp ryy bgy bfw bfe boe cie coi ara amv aqc
bgz: bsr crj ahk amn
bjo: agf awn adn
hdb: hes hqx hox lbm
rmo: bba bsy cck aer
ayj: asb
ypj: lvu lsk
bmp: btp ckf
yeb: lcm
ipw: ifr ifo hhe hhx hyp ycf ygv yun yov
iaz: ilq iqx hci hlc hpg yie ywd yzb
kzz: kqa bjh cbx ahz
ivs: isl hee lca lag
ygg: ygm
cdx: cuo
yze: lae lse
ydc: ymy
ciy: cxi
cnf: aca afi
rbj: rfk cxt acc afg
akg: abk
alm: aes
rqj: bqf chv csm
rlw: rvk rop ban bge bvw bfi bqm acm
hfn: lbw lbz
yoj: lku ldd lju
ylq: ywg yxr yzn lri lwu
atf: iyu hcm han hdb hmz lin
hey: lcg lhj
kjv: rtz cek cnj czr czw
bdt: bph bot abr aai
kyh: rgm rpy byg bzi bol aad
bxa: cvi afq
bis: cjf csq azg
cdo: asf
ren: rno bfu ccs caa cwp cjw
kfg: rjr bjv btb
cgc: cnw cfc ahr
hdx: hnh yom lsm
rpe: rnl bka byh bzo cdj cun
kgk: kpn row aqr
yyw: yyf yon ldt
bnd: cat cdc
rfc: byc blr bwr ahk avt
hrj: hul ywq yvg lkf
kkp: cht cee cpd cff agu avv
bkw: bej cqt aio
lkk: lwc
krk: rax bka bbm cxj
iit: ios yni yqy ljw
cdz: afr azj
kpi: rpi rqo ado
ifv: iqc hbo hwv hsu hew ypx lhj
rbe: bvi cwa
izi: hva yax yle lii
ksm: rkp rja bvc cys ain
rom: bed cvu cqr awj
cjo: cxz amx
hdi: yto lkc lrl lyw
hqi: ysr lvw lsj
iuz: hjd hpj yos lsy
bty: ceg
hev: hxt yph
hgx: hmo ydg
kso: rjl ruh bkg bzy cbk
ryt: rog bxl ccr cno arx
ike: itl ycr yga ytc
lbh: lae
aji: axz
bhi: cep ahc adi amd
bgq: btl ayh axs apk
kkw: biv bqi csw aat ajh
kcd: klj kmg rcw rmi rqi cca
rlm: rfc rqm bav bjk cml czq agp
kax: rrv rut row brk bbm bqp
lip: lli llv ljw
roh: cnz cfg cfv cum ahn anw
yur: lro ldh
rca: reh reg ruf bvo akp azr
keh: bgi bzt cks cnr cug ahp anr
yxi: lag
yav: yyy liw
rnp: bhi abw alw
rvd: rns bnr cae ajy ael any
hzc: ysa yso ypx
hjm: hpg hnq htq yik lwx
cov: apy azz
bxb: chb cqw awr
bwa: bfp aiy
iwa: ide hbu hik ykh yxs
khw: rhf rxo bux cre ccu apq
cat: cgj aac ait ayz
ify: hso hoz ydb yxr ypp yzh
bqt: cxx cnz
rrp: rag rxc rtz bcg bzm cao cej
buz: cbe ann
raj: bok cec akz aan aeu
cvb: cxc cqm
rbx: rvt cgn cfs
bbb: bbl bgr
btp: alc
hrh: ypc yov lgi
irz: ijh hau hil hdx hjl
bmf: alq adx asv
bza: bur czj aif aew axs
hhw: hss ylr yed llv
hdl: hjp hez hmy yyt yzm
yhh: yvz lys ldq lvg
iws: hys huj yso ytt lis ljc
cdl: acw
alp: amn
him: hhr ycx yml llq
iuo: hwa ycq yso yff
rnu: rzj czh
bof: cps aix agi
ats: ibd icx iia ihu ijb ijj hsr hsa hoy lbz lhv
yqd: lvo
rkw: rvb bid cdi cpm arp afk
rrx: aer anx
cky: akm
knp: knz rcl crz cbs cck
hbp: yck yaj yvx lrk
aby: ajo
bob: awe asg aqb
kyk: kxp kom rsp rzk coj
hch: hlj hek yiz ygl ygg lwv
yre: yit lbo ljq
hft: ykv yew lwg
hgz: hwo ybn lcg
ywg: yeg yuw
rja: rty ccf cww
rah: rwa rqs bdh buu cyz avz
cii: aaz
cpl: act
kor: rpa brz cji aet
ywe: ysu yuz lgu
yxh: yps lci llw
rkf: ruz bbx byi cxu azs
ary: aew
hlo: hwb hfv yhx yjk ysu
yse: yeb lil
rgy: byn cwq awc ajo
iug: hkw hrb hlx yyh ydz lbo
kjd: kms rgv rvr red rxt bkr bzf
kqc: rbx bca cjq abd abo
lyc: llk
rsh: ahp ali asr
yhx: yev ytx lij
inz: hxw ybd ybn ymc ynq yod lku lko lhm llr
ita: hck hvv ygk yjt ysv
kra: kyp kyf kpo rrn rvd rpg acc
cjw: ayx
ckq: czu avg
imy: hiz hns yvg lbm
hqu: yak yee lkn lvq
kuo: bki bcx bsy coj ahh
kjq: rfw rof bbd abp ahl azo
bsk: bfj cbh cji
kbk: kfy kqy rdt rtj rus ale adm anr
rys: bbt bsh cwy cqo ako art ahi
baq: cts ahf
hrm: hbv hbu hvu
hhc: yin yjq yvp
iyl: imo hmb hmh hmq hoe yje lld
bhw: blp ces
igr: idd izn hfo yby lij
ymz: lba lam
hce: hmi yhp ljg
rpd: rmi bwm cbf clo cjf ayn avt
igh: imd yam yjy lcs lwk
krs: rtr bit byu bmv cct cws cnb
kvz: kty rvk ref bsk cgo
bfh: acv ace
rka: rmn bse cca avj
inq: iqu hnf yxk
lko: lcw
yhp: ydq lrz lih
bgu: csi ctt axx
ryo: bro bec bxr bxz
rnq: bkq bdh ccn csr cme
hsv: hue yrc yst lkc
isd: itg htu yjb yvv yzj yup
bbs: bgf bqo akb ahc axm
bad: bhs bgh bmc bod crs cxq
yry: yrf
kkd: bas bln bxm btt cky ayj
atd: aud ikk iwe hgu hfm
imw: ywd yfe yuo
ath: ied hhr yxj ljx
bpp: cpi
hpd: lhr lhl
ipz: iuq ydi ypw yno lal
cum: ahi ass
hzm: ycn yyu ytn lar
ryy: rtv che ana
lvp: lvm
cfk: arf ahr ada afj
rxn: cbt ctu
hdc: hnk htj lil
bft: cqx
yui: lhx lgb
hxt: hth ysi lbi lld llp
htc: ygm yfi lah
bue: csu agw ajn
cqi: coc ail awk aek
cjs: aao axq
kzi: rho bhg bjg cxq cqn ali
ydk: ydw
abg: azr
rzh: cgn ajf ava
yyo: ynk yow
koq: rbu rdw bec bxx
rrm: rpn rmd bpo cvv azb
cvv: cex cxz
bde: cds csx ayi
bek: ciy avp aey
rkq: raz rir cmu ayd aww adp ajp
kng: rfi ceg cnb aix anj
cwn: ayl
izl: hkr hkz hat hyd hxr yml yng lgz
rya: rfw bcq bao cno ctr azw
ksl: rlb rvy rvv blj ctd aru ach
chx: ayr
ktb: rru rcq rqp ble cyw ara
cui: afy
ceb: cfy
kxo: ktp cch can chp aas aat apa
ygx: yfz
hwc: hdr ygz
llm: lgc
rmb: blg bpp cii asd
bko: blz chz
hap: hsq ywa yda yqt lyg lgx
ivj: hkj yvs ytt
cgx: cgu afy
hzo: yxm ypy lhm
bvi: cii cqp
abo: anp
aoq: iia igm ivf had yyb yga yjs ljz
rgf: bxn crt ayv ase
yto: lvt
rwr: rpj roc blj bnt chf aly
ijg: hbu ypz lbi
csu: ahp azp
cbo: cck cnd
hxc: yai ytd
kte: rvm cav arf ace
hnd: ybc ysb liy lyy
ybn: ydc yzi yod yop lwa
bxd: btw chc cph coq
yfy: yfs
ruo: ceo cpn aju avj
riz: rsr bmd cwp
rex: bsr cqr
cob: acs
bjd: bpm caf adz ajn aeo axb
ykw: yyd lkq
yei: ync yup
biv: ckf ckq akp aah amf
bbp: bws bxr cgi cel
hpc: hmy
ihf: ies hhf ytr lrj
rwz: rdu rvt bpn bto cth
ays: apx azt
isr: iuc yhi yxt lcl
hpk: yae yxt
hnp: yry ynh
czw: adt
cli: cgi cjs agc ano
iid: idq hkx hiz hyq hgm hzz yyy
ynt: ynu lrf
hbr: yai yee
hob: ych yzp lrv lbb
heg: hmb laj ljm
roq: bbh bnn csw asw
ycm: ytj yuj lgk
kfn: ktt bhy cre caz ahd
brp: cpw cui afs
byk: bvc aip aqy
koj: rch rth bgr axr
auy: hzt yye yvv yqt lyk
iat: ime haw hlt hex ywd yfv
int: hgi yjw yxx
bgx: bpn cmj cqw
rxk: bkw byl bnu aey azd
rem: buz azr
hzi: ysp ysm yzp
bik: bpp abq azq
ctk: coe agb avv
ilx: hpj yzm lke
rpx: bte csl csj
rye: bdv cyl cpi arm
rxu: bsk cml alr axy
lys: lsk
ktd: rgp bvj cif ctl
bvu: cnz aax
brl: bey chc ajl ape azm
bmi: cjt cvg afb
bdp: bxf bzo chk
yym: yyu
lrc: lle
hmb: huj yas ypz yfi yua
ksh: kmw rjq rmm rzl aiv
ijv: ije hwy yhz liw
ipq: hmx yys yws lar ljz
awd: apq aff
hvc: yaw yst yti lbg lsk
ywa: ydc llu
bxw: bpd ctz asv
cck: asr
bvd: afy
cyf: cmy avw aps
bcg: cay cye arq
cyk: acm
biq: bwi acd
kkt: rrx rwh rzz cba chi
aeb: axi
hze: ymc lsi
hht: hdz huf yge ypq
rfu: bef bnh cjt cea
ygf: lbj lli lgx
rns: bhv aax
bfq: ccc afw
cuy: awz
hja: yhk yji
kjr: kxc rqk bgv abb ani
ixg: iqs itd hmk yqm ljn
aob: aow igc ipu haf hdr laa ljg
cqg: aal
hmg: htu lhz
rsx: rzy rzt byc cgb cwk cqq alc
cev: cpy czz anc
amv: ame afm
ajj: avs ame
abp: aev
kdd: rpx rnr rnn bfl bts cbn cih civ
ayn: awq
chz: cwr cub cuq apw
bgk: ckw cfr
ipl: ifd hfu hue yqj
kwq: kxl kti rdm rnr bap aes amk
crm: cnf cux aki
rgo: rpq bxu bnj avc ave aek apv
cex: cfc
roi: bnq bqm buk cve
huy: ywu yjr
rln: rja rzh rqq cvo apz
ikn: irz ibt imz itb hzw ybw yfs
llp: ldo
ixi: ino izp hbf hhs hqt ypn
ybh: yjb ytr
crj: cpy akp
ygd: laj
rzl: bah bex cow abe ahr ask
bya: bfh cis cue ary abb asy afr
ibu: ihw iql ioh yvc lgv
ksf: rmd bbl buz
ipm: hhz yjg lcg ldz
kmc: bvf bez aei aes azs
knk: cjo cxb aem anp
iol: ybs yef yzc
awe: apn afr
rjz: rmm ccn cqk cqm cta afp
yqs: ytx
rvu: req rqc box ccc
rze: bdh bvo bpz bny
iue: hgp hst yiy yft lbi
hsr: her hfx yzs lcf
hlq: ybe ywx yfq
aph: amx
hla: hpe
bbt: bwd cwu cng ctv amx
hwr: hxr yrq yzo yqn yok
rsd: rmr cpa cod ala azr
kty: rof bcp bgn bgt ckv aye
cbc: caj cnb adt
baj: ckx adu ajf amo
hyw: lge lwk
ihg: hbg had hhz ybx lca
bwy: cio cdr cec coo aze
aci: agd ago adc afh
rwt: rdy clh adh axg
rzm: bld cna cob akz
hwq: hxj lrl
htw: ysa lke
ctl: cot
ida: hko hdg hfm hzh ynt
hck: hyh hgt hea lwq ljs lva
bcn: biq bqd cig chb cnd cug anc
yqi: you lyl
kgb: koz
brq: bar bog cly ahr
ywn: ynp yor lky lln
csk: aai
hvp: ywh liu lvw
yfc: lbc lhp
kgd: bmt bzq cxf
hrk: hzd hql hts yaz ljf
kse: knw crx aya ank ani
bfc: cyv cfa cfy cqq
koa: rjl bbl cwf cet
hlz: you lhk lvf
hcz: hao yzd yof lva
itq: hwp hdz hfh yvf ymk lik
yuy: lhi
bpj: cts ann
kmo: kfl rey rof aid
rcx: bgl bob adg
kmv: bzi cjk cvv csf adu
yia: yhq yuq
hek: yon
ygo: yet ypy ymi lcb lwn
ipf: ize hli hgd hjb
aqd: iiu iyj ilw itn hgr hxe yis ypa lwh lde
kep: kuy rfs cot axi
caj: clp cgh cdy acy
box: cgq ako acz aiv avi
rmr: rug bkx bhl cvd
aol: aov ixc ixh ixx ybw ycw yix ygk yoa lao
chl: cno agm awb ajf
czn: aen
hhn: yoj lgs
rlo: baf bsb bmk
rbv: bcq baz cty aak agg
kln: rea rtk blo cft adw
rpt: rmu brg bnc bzs cgx ald
idi: hrs yhs yqb ytk ytj lkg lbx lww
rnn: bdb aii agk
kny: rmj bra but asb
ixy: hsd ytg lyk
iiq: iqm hyo yru yhj lyl
yki: yrk yhu lye lgk
lay: lyq
rac: byj bdd aps
bgc: bng btu cns aig
cqx: cts
kbd: kmh bny cwb czr
kzr: rww brz bip agw aje
rxb: bjh bjt ajt
aad: afi
clk: cuo aye
bno: cah cmc avw amb
bbx: bss cvf ail
hng: hqk yzf lih
cya: cew arj axu
ygt: yfs
htr: yji ypo las
ypn: yzz llt lvr
hrv: hde yjo ynq lro lsn
kys: kqv rum bli ayc
cyy: cpt czr ako agm
hig: hsx htg ybf ymb
khv: ksw rjj rfb bys clz ayt
ikq: ilz hdv hqf hof yrc yhf yox
kvn: kmj rio rnh brd bst bzc
hsg: ycb ynf llm
cbj: cuc ago ajs
awk: afb
iec: ioz hqb yfa lss
ccj: cju
hmn: hne hqv ykn
hzl: yrt yvj
boq: aki akm
yge: yeu
ywi: yfl
itk: hvv yof lbk lvo
lcl: lgj
ydt: yqe lws
ark: ayo aem
bep: cgi cwh abf ady
hyx: htb ybz yqa
yxq: llp
rxg: bhn bpw ctl akw
ymg: yzk
bcy: bwm bta ash
ror: bir bvd crb aec apz
lkp: lkn
aie: ani
hau: hxj ykb yad
btb: adr
rsa: rzn bfu cij amm
bpz: bqq
itf: hhd hfs ljo
bhm: bmg cyf cwn ces czr
bur: cfc
ilj: ixj hxc yak yys lax lin lwx lsw
ldp: ljv
cbg: ahm agd and
rec: cbb ars
kgr: kjd rjq chh cxz cpn cmv aic ayr
rjd: brw btg bua akl aiw agp
rsj: aam asp
hij: hes hzv ymp
bwo: cgr
ijq: isi hhh hlu yew yte ljt
hsh: hpl yzl yqj yof
bjc: cwy asc
isc: imu hbx hde yao yyw yvi lav
ckr: crs ciu czt apn
yhd: lwu
cyn: cxy axf amc aqy
hnq: yly lwk
bal: bhx blv bje bzx csg awi
kka: rcr rhp rqm bte btz cgw cjs cow
blm: cab chy cmq asr
ize: hgy ybc ynp
buc: arp afq
kmh: rls rwc rdl reb rzf bsj cyj
yve: ypg yng yoh lig
aru: aho anp
yot: lrp
bmq: bnn axv azq
ibb: icz idl itd htu yyq yvu
yja: lbo
rcg: bls bvr bol adc
bqb: coe arr arb
rjc: bds bde ckf cyg cxb cnw
roe: bvx btm cxf arx avz asj
khp: kzu koh rgv rdv bbu bsv cdw
iak: iva hwn yhh
rks: rox bmy csc cpw ctj afc
bzo: cat cig cvn
ylm: yvz yez
kfj: ray cnk asj
ynh: lcy
inv: hsv hpl hpf ywn lcc
irw: itt hie yjr yzz lga lsn
idh: ysf yxk lga lvw
itb: hxz hui yby
rbs: rza bqd ckn ahx anb
css: apd
cbv: cjb
aku: ajk aeb ann
kwy: bam buy ccv cmt amm
bop: cvy csb aao
aoh: iwi iqg hhe yuq laz lha ldx
bth: cqn
cbt: alo adi adp
rwa: bax bzr crv cwm
rlj: rwb rjp rnz cjs
cwh: aeu
rea: cml acu
yfh: lsh
irv: iaq yci yoe lwp lsa
hri: hlh yca ydl yse
aoy: ibn inp hkl hhc hyx hvq hqb
bfi: czp alb
inh: hyz ykt yxl
iqx: hiw hin hfa ywv
ieh: yrt yvx yzt lkz lgy
lyd: lwk
ruu: bve cbd cnd cfc
rdl: bgr aqa
hcw: hia hya htz yei lkb
iev: hxb hng ygo ywf lhe ldf
iez: haj hht hpz
cjx: cvk aap
ynq: yzh lhr
yyq: ygc lcd llr
cmo: igj
avm: axv
awp: amt
kld: keo bdc aan aer
hvs: yjc yxb yxg ldb
cmz: ahu
iqb: iui hrp hup lbn
cvw: asd
hrt: htl ycu yaw yih
cja: cvm cnz cuh
ilb: izp his yms yno yzv
rmj: bus agz
ybz: ygc ydq lye lgm ljb
yca: yjj
rgn: cgt ced aak
cpc: coe
aps: afx
ipg: ifh ydk yqw
bie: bxc bml cdp acy
cgp: axl amm aft
rhq: rzo bqe awa awt apx
bja: ccm cip
hnc: yie ysl yny
iet: itm hni
hmp: ylh lsk
cfl: abg abq aig ant
aoi: iqm iti hyc hvu ylm lkr lwa
bvn: bqu cvk avt
ril: rhc rmq bkm clw cuc
aqp: ihz hly ykd ygg yqk lya ljr
cus: abe avt aep
kjo: rwf buw cvp cxg cmm alt ajl
ipu: hpd ygp llp
kpd: brl ahf
yzm: lko lct lwc
kpt: rid rvw bye btp cli anv
rpr: cjy cfo arj
iie: ivu isl hbu ykg ylk yfs
alb: avl afd
kkc: kbh ksl rhb rex btw
rgz: red rep cat cfn ajk
cwl: apo
kgy: kwb ksr kul byy buv cmq cni cfk ctj
lag: lwm
yat: ygf yvf yzc lvr
kzl: rpk rnw bwb
kcc: rkj rfz rzy cnv czn
lrw: lgu
hqh: yko lcc
cge: aic
cdv: cui aao
kym: kew rbt rlh btm cvz ctj agx aed ann
ilc: igr ivw yib yhd yvx yvz ypz lld
hod: yrr ymw yfg lis ljt
hcf: hse ykp yyx lan lje
yqg: lro lbl
yeo: ynz yte yua
blb: cmn
yml: lss
cxy: cxp ajw
yfx: ljd
rrf: rzv bxt aro avg
kdq: kqb rvy rsk rok ajp amp
rfh: ruc bxr bmv chq cmt
kms: koa bpb cay cen cmm cuy axt
hoa: ysx yph lij
aup: ijg hsn hpa hot ynq
cvy: awt adn
bng: ahx
lgy: lgd
huf: yrt ydh lky
rcj: ras rpe bsc ctf aaw
ifu: hap hgu yky ldv
csm: cpv ctg aja
yli: yvo yft lrb lag lgq lsn
kvw: kvx rmi rnl rzl byy bjg abz abu
rqe: rom ben bmi btg cyz
idp: hir hsq yei lwl
avl: asd
cqr: cog
byy: cvh
kiz: kup rld cok axb
rrs: rhi rwz byo bsr apr
iis: ihu isv izk hkl hxy ykq yjn yfi
rjb: bkn crt cvm cec ctz acy
cwp: cen abt afe
kzo: rzj bps cbt cff
bkt: bhj cyi cwg
iek: hse hzf yrm yar yam lkp
kqu: ktz bdc bnv cdr
yks: ybe yhk ywc ydn lkx
hkq: hgn ykj ycg lgk
kly: rkt rrl bjp cfb ahq
hxy: yzd
bky: cak asj
ynp: lyn
ife: hkh yth ljc
inn: iug hqk yjw lvm
kqh: rhi rfj rzc cko ccl cfi ayh
ldh: lsd
ryu: bkg brj cpv cqd azp
rej: rfm bes bnq cns alg
cos: adt
itn: lgu
hph: hpf hfz yzs yut
kfq: ryi bta avg apl
cxu: arv alq
czc: ayh
hje: ytq lce lhp ljx
bio: cgp cvg arv aiw
kdt: ksx rso roz clq adj
ylj: ydw llw
kzh: rce rxd blc cgt aaw
raq: rqt bow cmn axe
kib: klq bab bdm bqj cxc
kaq: rgn rwl bhy blv
hlj: yyh ytf
alc: aqh
kro: ksr kfl rri ria rvl bvz cjx
hns: hfm yeq lsd
kpw: koo cdi anu
yka: ydc ydm ymd lkd
bcq: bvh cak awl aer apw
csy: ahl adz aep axl
air: avc
kaw: kwp bfb boa cnl
awu: axp
bmj: cuz ahi
hvh: ywe yxd liu
ywz: ysg yna
kmn: rpa roq bcm bva
cyh: aaw amh
ixr: iow hmz htq yov lvu
hlf: hzd htl lik
clg: abn
rla: btg clo czg
ixf: hrt htz yij
cic: abj
ith: hyy hwd hvy hmq yxp ymh yfp
rdi: bsh bnv cke cck cea amx
cah: chm arj
atn: auo iez ifz izu hkw hcw ybv yqh
hny: ysp
hip: yro
coy: alk aww ama
bhy: beu bmn bzf clu ahw
kwt: kxj rlj rqo cjw alx
byh: bzy boh cgk csg
rey: cpd ayt
clc: ada
kmd: rac rfq bxb cqo
rke: bsc cvw ago aqh
rus: bmh ako
rkx: rjo bmp cdr cjd cox
bai: cip hth
lbs: lap
rrt: rhk rsh rnr rng rtc crv cjq cms
rbf: ret bjy bon cgp coq
cvc: cfc apq
aro: adj
hdd: yhy ylz yfb
hvk: hvm ypg yzs lhc
rfg: bhv cjl cvw cti
aai: avf
ksq: rfo con avx
hby: hli hsm yte lrp lip
hwi: ybs yhq yor lcr
apj: apf
rdj: bsp bmt bzy cbu alf
lcq: lyt llx
yvk: yzi lgq
alr: asf apr
rfx: bsv ckl ciu are
hiy: ygn lac
aks: apm
cyt: aad axw
chd: cjv asz
bzq: cmd azl
hyf: hyu hpd ygo yug
hnf: hzk yhj
atu: ibk ihb htx lyh
hik: hpm hne ylp lwo
yzd: ytf lca
iaf: iya iec yxh yuz lgx lwc
hsm: hmp hop yph lca lvy
ybp: yys yxh yxs lrm lcj
ivk: iqa hkn ybe
hqj: hos ymh yuf lra lvt
ioy: hsd hmr ylo yje
csc: abx asa
cie: ahf
yaq: yiw llc lgx
ibe: hbb hmf hfr yac ypy
kfo: bkw bxw cma agj aza
isy: hjz lgt
ypl: lkr lru lsb
yij: ylm lbb lwt
bnl: cil cmt akr
bjz: bxr cwf ajw amf
kir: kec rwc rvu bzs
rga: rge agr amb
ayt: anr
amf: azn
ryf: ref rfv awh adz ajc
bnp: buu cdb afn
iht: igs int itb ymt lbf lcl
rwk: rvt rep abu aiy
lha: lsa
kgt: kxz rsp ays ans
hdn: hjc hot ljd
cae: csp ahr
czt: abg
kcs: kco blt bgo cec amt ant
ixm: hhd hyz hzi yxm
ybx: ygr
ktj: rdx rjp rjz rmt bri byc bvw bma coj azm
igl: hkz hgi hvg lak lsm
auo: iks hba hil hjd ljo
iuh: hwq hva yhx lkc lsa
yrv: ycs yye ypi
hrx: hoi yio yfw
ymy: ytv lcf lav
ymn: lcv
khm: kon rfn bze cfr anw
cxk: cor
rpj: bbi bbl bua cwd cqq alk
rfm: rff bll cyu cor awy
cme: aqb
rig: rps rfq cxo axd
yet: ypa lga
yna: llj lvv
btw: cig cdn
ysm: yzv lro
hqn: yhp lsv
rgr: bpc ctc afc
hqd: ywb yto lrs lch lau
cdr: cji abb azl azf
yez: yoh lcc lgh
krv: kxn ram rnb bjf acj agj
ksy: kes rbl bas bdf bec ctg aco agc apo
ydr: yda yuu lgy lgf
kbq: khz kyv ktz rga bnw cag
hzr: yas yfo lcv lcn
ilf: yaw yjz lye lgy
hxo: yci yze ljg
yuo: ldz
ivm: hmx hns hnu hut lil lda
hib: hyi hdh hxp hnp yvf
auz: ibd ipu ith hce hdc hjg huy yda
rut: bvc bzy
hkw: yqx lim
bjl: cuz ayd
hiv: hyl hvb huh yqm lyj lvq
rsc: brk bro cwk
kkz: kdr kuy rak riz rgv rsh rsj bmw cnk adl
iom: hls heu ywh ysh
iih: isb hkg has hvr lvv
kyl: kgl kwo rrg ctb abv
hvy: ykh ycq
kbn: byj bmy ciq cdn
ymr: lbe
rqc: rqz bzg bzz clo ajr
ysr: yzz lgr
cxm: cmb
ifw: ioj hju hvs hzr yeq yfm lbf ldb
kba: kms rbz ryd bmu ago aqb
bnj: aag
cai: clj axg
kjm: rpj rzd bso cak akl
cip: cyk ahx
cjh: aeg api
hyz: yrr yin yfv lrb
kzm: rrm rdw bvr clu czh acf ayo aml
iqq: iuf hhu heh htq
hum: ybq ysr yxu
iay: ivp hfz yet yxh lre
kdi: kdf rha rfy bku bds chp cua acl
ylf: yjj yul lsv
knw: rma bxe bms bfd cgx cwx cmv
ibc: hko yyn ywu yzr yqw lsp
yvr: yzy lcg
kjb: rpb bac blr bgx bsf
bps: arp
hyl: hdx yqm lin
kwg: bid bvo bzl cwb
rim: bhf bli bmu aiu awq adj apk
rpl: bdz cho ald
hzb: ygm ymc llv lss
kyv: rgn rjg roj cds com ang
abk: aee
bht: cvz ceq cfl
iem: ieu hbo hyx hlr hdh yrs yxw
hws: hzj htm yrr yip ypz lbp ldm ljm
ios: yxa lcr lja
cgz: cnv aca anp
rkc: baq bwd bwo col
itg: hqy ylz yvt yqk yqu yom llv
kza: rts bcw bhs acw
yjs: ypu yqg ytk
rab: bag bpu cqh aln
iqp: hsm ywc
iqd: itk itu iui han yoj lyp
cvd: akk adm
cka: cri cya cxv cql
kuw: req bfr cks
rue: bsa bmp clw
iwb: ipu hki hyd ysd yzq lkl lyx
rse: rsu roa cbh cds
bju: bvg bqg afq azi
han: ywl ywn lav lvz
bwl: bfw ccg awh
aox: aof icj ijg ifi hvf her lkc
hub: yha yds
rlv: bjc bfp cli cqu ayn
hxw: hth ybl ylk yjj ymc ytr
hdt: hsa yvt
kav: kyb rbi rvj rng bkb cnk cns agv
hle: ygg
kxe: rah brw ccd alr
yhg: yyl yed
bot: cgn aiy aez
rjw: bqh ako aec
kfv: roc bfe cnc czx ctx
yag: lvz
bds: cym avg ast amk anv
lym: lyq
rwf: rst adl
bor: ciz clw
kyy: rmz bjj ckn cat ahj avb
rxv: rqn bda cbt cmx cqz acd
yiz: lrg lie lwu
yxt: ymo yqe lkk
hkt: hhq hgj hog
aak: aal agz
ylt: ynu lyt lwh
bxk: bpt bzm ccl avx ael
ibx: hrm ylg lrl lcy
hnb: ysm lrx lvp lsx
hrq: hew ypk lrw
ytn: lkk
blq: ceu cpl
bfa: ciw abb ahd
haa: hzo yeu yow ldy
aij: axu amq
ymu: yqh lho
htl: yir yde lkm lhl
ybu: yuc
hpu: hfr lkr lhq
hvr: lgp
cfz: ase
hul: yrv yyc yvh
com: awu ajo
kch: ktt rkt rnx bwz bxn bnr aij
rhx: bbw csw cuk alg
kvm: rec rpd
aoj: ycy yag ylc yjn yud lki
bro: bfh cgd akf
kig: kod rmt rty bcx cvs acp
ifm: hyg yme yug lig
rbb: rgm rnj bnt
yma: lbj
itu: hbv yyv liz
kwe: kqm rqv bxo bpg cxi coh
hcl: yke lkt ldy
hnn: yas lrd lio
kmq: bqq chf
kye: kvm rvi rug cxx
ham: huo yvs yny lbi lad
hcn: hun lha ldz lvo
ykq: ywc yss
icd: yff yqx ljo
yji: ynm
kwf: kds kxs kpe kqk rbl cue akv awh apb
bqc: cal cxa cof
kez: rgv rsf bsk ccj cam avk
kxj: rfs bxg boh cne
akv: abn
cmx: cfi
huc: hoh
ioz: hip hhv yvb
ils: hgg hjf hth yqo
khn: kvs rih rog bmx ctu ayy ali adb
icu: iwu imo hfq lkk lbw lhi
bcc: cjj
ino: hzx
kiu: kzc rme rqe brv cjg cot apl apj
ije: iqi hyb yvm yvq lhl
big: blm bpv bzn cia cpr aaj azt
kzx: rbi rgx rnv ciu acq
yvm: ldx
knx: riq rjx bbb awf anu
yrb: ydi
rre: roo cio amv
knf: bta cmz cqk ahj
rgi: cle awv avd aps
bjs: bol cdh
cdw: aav
hcu: ycq lbr ljb
bfn: cre aki apl
kst: rho rpe bvd cvp
ybf: ldr
rir: brn bne adz
rme: rfk bkl bie caj
akl: ase anu
ccn: cxt
rzw: rul cvb
ycl: ysr
ymh: ymt lit
yff: ldy
ywx: ldc
bjv: avy
rfk: rox bae cio cjt cxm afi
idg: ifi hbr ysk lcx ldv
auk: hlf hjz hvc yxp
kvc: ksk bac ccd cye cta adq
icl: iab hlh hwr hvn
kkr: rab bpf cno avq
bsq: cfu ass apq
kqf: rsf rxa bgx bfy bzu buc bor cya ahy add
crs: czg
rop: bgv cyh ave
kil: kyc kph rya rsd rmm cdc cer agy
ire: ixk imh iuk hvv
laa: lla
aqg: ikl iwf idg ixp hlp yla liu
kcb: kao kzm ryw bwe cef
ira: idc hwv hmz hnb yyq yvc
ysi: lcb
yil: yzg
cvo: cnn
ckw: cri ape
lrg: liq
bvh: cii cjn aak
ccx: cys
kol: rbr rpy bng avb afy
lce: lvq
rcv: byj bjz bvk btw cpk
kbx: rpf rfy bvb cbe amt
kku: kfa rgg bzm cpw
ypt: yog ljv
ygn: yts lip
imf: hrt hwc hfp lap
hii: hpu yvm
cyg: cwk
rrd: rwt cwx cxd ajx
bba: cdl cjb cjn
ckm: cic cmh
yqx: ljj ljs
rpb: clz clu
kus: roe bwo bjl cmu age axn
cjf: aka adj anq
rfl: crx ahx aht amq
rzy: brk
yde: yjg ynz yqf lku
ryw: bxx boa cgr cgf apo
bqi: cwa
yqf: llk
hdv: hpn hqr ybk yxx yto
igy: ieo hdt yjy lhh
rav: bei bxv ccz azb
kdv: ktg cmt alg
krn: khh rgo bop cmm
hiq: hgz hsh hpb ygx ymf lyr
ixd: him hxh yyk ygs yjk lws lvh
hcm: hld lia
kon: rzi brc bqg cib aac
bsh: chn cxj cmo asg
iqs: hpu hnk ykp ywt lgq
kbu: kin khk kfx bay ajw
rrg: rcf bnt cyq akc arj ahm
yrz: ygz yjm yef lyp lld
cmj: awc
icv: hlb ytb yuw lwo
ahj: ahf
huu: yce yqi lhe
yvq: ynk yuv lix lsj
bhz: bvy bui cxa cfh aqi
ags: agp
hue: ymi ymv ynl yti
rqz: bgb cdu cog ain ayv
izk: yxo ymu lyc lyo
iqe: hjw huq ygr yui yol
iyq: hjd hml huk ycq
bsz: cpd cog azp
yuh: lwi
aua: ibj ifa hkf hcu hsc hqr yff
rxo: ruh bkz bys cwf ctl agf ape
bjf: cag csk agw
kef: rlg rja bsm cro cbd avm
kou: rvr cbe cdk
aiv: avs
kjl: rjw bru bgs avz apa
rgw: bcu bfh
hvx: yig ldb
rqt: blq bwa bwy cur awu
iea: inb izg hpr yhi llr
abt: axw
rjl: rtu run cem abv anh azz
yjx: yzr lcj
rkl: riu rse bdl bma bfk ads
ihu: ljl
hgs: hwk hsb hsi yst
bud: cyg cjw afk
hyd: ykl lvl
hun: ykb yqy yth yua ldz
lrr: ljl
yen: lvf
kuz: bvr clx csv aks
iha: haf his hhq hts yap ysk ysc yqp
rzt: rqv bbz adw
bvm: bqq bte cam afh
cjq: apq
ytx: lav lwk
hkp: hgr hnp ygl
bme: bmn buo cpt
iff: iux hmd ygp yfv yqn lbk
rro: rma aer azj
csl: cnv cqw ayg
bgf: btr arr adi afm
iyi: iny hff ypq yni
ivq: hfm ymc yqn lju
czm: ans
yoh: lyv lwe ldc ljn lvg
bph: cvp ass
kto: cpq
bcw: ahc adl amw
cdq: cth aco
ktx: rrp bsu bet bms bzt cbv apz
iud: hjc lkp lds
hvb: hvh yif yht ywe lgt lvc lvh
bvk: cks czl aco
ioi: hvc yeg lch laf lwn
bxh: ckn cyb cgc cjs cpd
kzu: kqs
hqr: lid
bsb: bqo cbr cie apy
rzs: rqd baa btu bot ash
ysc: lrk lbx laz lgj
kmp: rgy cbi ccw cps awr
rui: bgy crr
aav: ayb
ykg: ysa
lal: llk
bvs: bej cba caw cii cud
rvs: bxo bpi aam
arm: ane
bzz: cvm cet cqv cqp coi axj
lwy: lsr
ysx: lcm lha lyh
ycs: ylm yfs
yku: ywk yzz llc
rxq: rqn cwu cpc czp ave
ypi: yug yuo llq
cgw: cfc ajq azi
ria: rou bme boy
ipr: hhr yqx lcg ljz
cgy: cgx cei afi
bgh: akj acg awm
kry: kmv cpv cme czs
chw: cuc agg
bku: baf awz apq azi
ypv: ljy
cdb: css
bxx: cel
yog: lct
bmz: awe
bdc: bqs cfn cts
ibm: iwe hzi hup yke ydw ljg
kxh: rcs rcm rxf bya cbt csw
auu: hrj haq hgg hjm lwv
knh: ryd bsg bud aca ass
boz: cbv clr ced acf anb
yax: ywi
iki: iyt hlv hft ybs ybt ycm lio
ahw: alr
avw: azu
aah: afh
cml: czx abc aal
rrc: rmw bal bss bpr cbl cwa avm amg
hox: yrj ywf yqd
cfh: ayx axs
kkf: kkq khd kth rua bfu cbz cig
yqp: yuz lvh
keq: kfn bvi bob cab cdk
kxn: kpz rlt rqx cbi
iua: ioo hcl hcp haa hip ykz yaa yuu
iwm: hca hsa ysg ysu lws
rko: bed cyi cvm acm
bnc: bnf ceu
hes: hxl yiq ywu ydp lie lwa ldl
chs: clz aky aiq aln
atr: iif ilk hyq yfq yoz lhl
ccb: chz agq
bqj: ajg
bmb: arz
ycq: lla
rmx: bro ccj chg arw aha
ioa: hcm yhg ysg yes yur ljh
rzz: cck cqq
btf: ayg afo
chk: cdq cni
rvj: bxs bza bop ais
bgv: bpd bfj bzk cyu cpd ahq
rty: bmj bfa
iry: ivi hxw yao ywd yvy ymu lyn
bbl: bdn cfp cqe
ibg: iqw hni hte ycb lho lvk
hca: hpd yhj ymt ldy
adx: aec
kau: kwl kds rdz bev ckh cju cub
ynx: lcx
rwc: bgd chd agu ape
ytb: lbi
csq: apa
rai: ruk bip cbf ahf
cgj: aai
kja: knl kfx rui bcv bax bdd alz
bpo: ckp crw cps avr aff
cot: ayy aeu apa
ybo: yvk laa
bak: bvw
bzg: cvh cst cem akl aay
yam: yyq
acz: aij avt
aun: itz hev yyb yzs lby lwj
ktm: bpq ckl cpg add
hvq: yht llr
lbw: ljx
ruf: bgw bdm cso cpd cob akw
hfj: yfe
bun: czk ahg
hku: hno ydr ysf liv
ygh: yww lit ldj
byz: bfr ain ayh
bym: bsq cjb ahw
lwg: lvg
kdl: ryi byb can clp ald
cto: ayi
lbn: lhe
kme: kfj rrp bwf bnk bqf cvb ahr ajh azg
hsu: lbq
bul: cho cmb ays ajk ams
hhr: hmx yri ycn ywi yny
cbn: aro azw
ros: cdf coo axx
cem: ctv
bey: cjz cmf cqp
bkn: bwq chj cyr cgf awf
cwi: aqa
avs: asu
cld: axk amd afe
ylb: ysa lbh lhl lyp ljp
rnl: cyp akw
aao: aig
rsi: blq bvi beh akm aci aip
aou: iar ijs ivu isq hks hey ysw yzi yow
bpl: cgy arf adq apy amy
rve: rqt rua bio bmm crf cqg
bqk: col agy
blf: bpm cgu ctp
kcj: kqj rst rxb cqu aaa
cir: cxv
yrh: lbx lbn
ikh: iyi yaj yft lro lyd llr ldg
ivu: hho hpd hfk
iyf: hbk hhu hgy ydd lcu ljt
ceg: aah
hup: ych ylm lis
ylu: yva yqt
rsz: bar bez bxd buz cum ahn avg anm
hyk: hpz hzc yuv llj
yrn: ybd yvf lcv
cej: amq
ksj: bkf bhx bft bux cnq cob agy
ktr: rsr bnv cmu aax
yek: lkl lbd
bga: bjl bsy cin cwu cso cqf asl axf
bqw: cyc coq
ihq: ipx hmn hus ycn ygf yxp
bbd: cry
imk: izq yrb lsk
bxo: afy
kxf: rhp bfq boo cok acb awy
ymb: ytm yob las
yvx: yum
arn: ahg ala
kvs: byc crn cgj cdm axs
imo: huf yrb ysh
rvw: rsd bes cgl arz
bdi: bss cfs ahu awk
aty: iyn iwq idt imi ynw yqh lkk lyg lwy
yql: ytw
bly: bxb cjw cmp awg api
cva: awr
hed: yit lbx
isp: itn hbc hza
kam: kdl rya rym ckn anj
cve: abd
rtq: buw aje
iuy: hic hvl hmd hmo
bso: avf azo
itd: hln hzt lkx lcq lic
bpv: bmn cdz cnw cur adv azb
rod: ckv cmi czj als
ylc: llm
kqy: bah bau bvk bxv
lyu: lgd
brr: bbr cwc abp
kpz: rwm bao bsi bnx cwp ahi
knc: rkz cjx ctc aly
rgh: rgp bto can cpu aes
kkh: kgb kol rky rxy bbh bgl cuv akc azp
rto: cjp ctb acq adj ajf anu
bzu: buh
bvx: aev
iba: iab ilz ivg hul
itp: iue ybx lhm lsy
yiu: yom lkp
bho: bdz bez btu bow cby cic clk coe aip ash aei
iyo: igj iqp hrq ywk lbk lyx
yjj: lgw
ikg: ieu huf yas ylk ytb
rol: bph btw cga cpb alp
yof: llf
kpk: rvu cth acg ahx
rpq: bks csf
yri: yvc ymr
aau: awk
bqu: bob
lix: lip
iyz: idl yjn yzv lkf
acn: aaf
yno: lbg
rwm: rej bym cfq aew apx
ctu: aye
cpn: cnp afe
cfc: arp aaj azv
lkx: llx
iwk: hwy hdh hnn yoz
izs: hqn ykx ycg
kff: bln bob
ilh: hko hfi ygu ynl lkh
bwg: bni ahr
csv: czk
bto: ceg arg alx age
rpn: blu btb bud chq cyd adz afy
yiw: ydn lcz
ber: ctf
kob: rkz rjr rxt bvs cgb
hdo: hpf hzh yzl lhi
bgb: adk
bas: bml cax cud axm
ysk: lwf
yti: yoy
rnc: cjn ark acs aqk
cps: cma
rjf: bgu bxa cvt alh
raw: brs bil azx
aop: hcr hwh hdf hem hzb
btm: boa avu asq
iov: hjw yiq ylt yqi lby lab lgw
hpe: hfq yzh lrb
huk: hup ybh yoo lhf lwb
isb: hhv yby yvt ymb ymz yzi llk
kht: kzm rcq rjd blp cca cfh cum
aho: apn ano
kpe: rxk rpe avk
ysw: yog lhs
byp: bnw btq btt aci
bfr: ays apl
biy: bgq ccm
bxg: akk anr
hhj: yjx ytu ldi lji
aen: axn apq
cin: aim ayo agt
ypf: lht llb
aqu: ini hlb hwe hew hpf hmm
hea: how lhr
ids: isy iuh hae yih yhb ygz yoe
rlf: rvz cik
cku: cre afh
hhi: ygh lht
hth: yqc lks ldn
hsq: hmb
ayc: axj
rdy: rsj bse cbb ccg clp
rek: brh byl bgs bmx cap acg aer amw
iul: hdu ybv yag yyj lrg lyz
chi: cjr cvs anx
adr: aek axv
brg: aba
cse: czs cqd
bhe: bqs ckw akt agq
cab: cej
imt: iuj hdl heh hmn
kqr: rig rzh cyu ayw
bos: csn cod akz
inx: hlj hxd lis liu lyv
yqz: lvh
its: hbc ych ypw lka ldu
rat: bwv chf ayn
icb: hjk hvl yav llu
kod: cpd aky ahp aqc
ylw: liq lha
lgg: lgd
hvf: how yxw ypw lbt
ydv: yqf lrz lbb lvo
bww: bdg bzr crq cop avz
aid: ayz awv
iir: igb iwr hzx ydy ydw yfj
ikz: ilx ims imq hht ymq yuc
hpg: yxz
cvu: csk akm acm
cbs: cpu cul cow aar ajm
iiw: isq ies ieu hql yvd
iei: img hwh ypd yqz yum
hhb: ydm ypw ymb yor lse
rcn: rej rzk bgh ccr acx aji
isl: iox ydu
ifo: hzx yju lhr
kap: kan kgj rvj cbt ctx alj anu
yiq: yha lhc
rbi: rie bul cuy ajq amn
ydx: yuq
rjj: brl bcs bdy bpy cpr
kiw: knz but cop abh amo
ynn: yqf yos lgy ljv
iqr: hav hux yod lcl lyy lse
hwk: ykl yyc lkq lag
bvt: bsr bng buu ckk afw
igo: ixe hrq hbb hde hmw yku lbs lyp
bhq: anv
byj: bgs btf
hgd: hfz ycd lcn
hpx: hfy ynj yov lhu
hab: hpq hup yia yld ydo yqd lcv
krb: kfa rno bne bup cjr afo
rrw: bha axj
chb: ahu
cny: cnx cuu cof ahw ane
blt: acy alg
ifb: hjy ykv yxv lrv
bid: bgg bsv cgh
cuj: ahv
yey: yfr lgm
ija: yks yya lvg
ccq: cza aed
hmh: yjn lcc lsm
rjm: rzi bbi ctx
ieo: imu hpa huo yrq yvb yvc yxx yzh lrn
btu: abw aft
hvt: heq ygw
cne: aci
bil: bgk bsm csv cef cpz
ijn: ive ixi iqu hkj yiu lrn lwa
beb: crv ava aea
hzy: yra yfb lhl lyo
rtk: bii azm
bbj: bju bxk cyn cvu
yqh: ljq
acf: aly
raz: rlc rzv bml cxw
hzk: llq
bzj: clc czh ajg ave anu
ive: iec ipc itn
hry: hcr hhh hun yyq lvl
bev: beu cga
iwg: itr ioq ytc lyq
kzj: koz rcs rig reb bjq
kmz: kqc rkx cgj cto amy
hvw: htr htp hug lcf
bix: byr byu bgo cyf ayg ale aft azb
iwq: hcn hzk yig yei
hcc: hsz htq ykf ygb yjx yvx
kwi: rkv ceb apd amq
hbg: hsu ytn lcj
iqt: hby hqr lyq
ihv: his ywa yqq lbe
rlk: rvy acw awo
iqv: iuk hcb hgi hwr hpx
iar: ivb hmg yhd yfp
ynu: lai lyf ldf ljw
hvj: yjc yvj lil lwm
yhi: ygw lrw lcj lhb lhz lwv
ybi: ydm yjl
cad: cim aeg
kot: rxd rxn bio cgn csv
lgb: lsj
bks: cgg cwd cto akc
rji: rqf bnd bzl ces cpk
cqp: aya aja
rdw: bcx ccb caq ajv
knb: rld ree bea cxf ajg
rzo: bap cro cmz ajm
kva: kpy ray rat rjd bkf bak cic cfb ctn
ynb: ytg ytq
iwy: hkx hvr hnt ysg lbv
hke: hxy huv lbc lap lde
hkn: hxe huk
kyg: kui ryd rjd rex rzf byj bwf cki
iew: ixt ifr hrh hmu ygb yfp lax llo
abs: avp
rqp: bre cvw aam adj avr axm aqr
hgp: hst hqk hou ybz yal ymd lcp lgo
rym: rni rfd
ipx: ins iut ioy hnb ycl
amj: and
rsy: rel baz bwg bmi cib cpq ayr aga
cgl: cjo ayo
rnz: rtj bza cyh
rqh: btw aeq azm
reh: rfa bzp chq abh
rmt: akw
bdo: crj cuw
hzz: llq lvc
awf: axo apd
bav: bii cie ctj
btl: ckh cfn akd aef
ydi: lws
rur: bkf bca bee cct chi cjb cjv
ykk: yst lwr lwv
blv: cij czg
you: lgp lwx
rhm: rdv bvb ccl cge cjm
hnt: yaf ylw
bwx: cel amo
kik: knc ril bdb cyc cja cje aey azo
adh: azu
coo: asp aet
hir: hhk hlb hur hui lwk
icr: iyq hlm hvw hpc hfg lly
ifc: hgm hjy hmh lkl lid ldr
ruj: bjm cgx awl
agm: afq
ikd: icd iox hby hse hpj hnh yvj yzq lwb
ihn: iso iox hhx hqg yko ljc
cay: czc arb apc
aip: alx asp asf axk
ktg: rao rzr bcy adh
yrp: yan ymz
iiv: ixi ixs hrr hwa yfk
ixn: hgh yud lrk lgj lvl
hmo: hfb ytm lha
hbv: yxl yzr lig lgh
kop: rcw rhe byy beq csv
hkj: hbm hqe yib
hal: ycx yid ytr ytg lgc
ixo: ipi iul lkh lyc
kwx: bmt bzu cjl ayk
btk: cyu avp
bel: ajl
rio: rfw rzk rza cgh czu adt apk afs
rvb: bfc cbi cac cey ayj
iup: hbg lvt
hiu: hve ydy yua lcw
yxn: yps yuo
rng: bnp ccz ciq cet cob
yoi: llc ldr
yjd: lav
hqq: lsj
bqq: bow aaf
hid: hhl hvh hni hzn yqk lwu
yrj: yzx yoy ldg
kay: rbe rnn rfo rta bti czl czm
yhw: yqz ldv
bxe: bus crg cll
bap: byg cay ciz cnt czj
kje: rqo ror bht bwu bfw cel
bmy: btn
hah: hzs yrh yab ymx
hgn: hve hut yhe yvc
kfm: rfq bhn bft btx clw cnu avu
ctg: aha avj
klt: rkr rgg bhk bsu cgh aab ayn
aei: anh
yyr: ytr lvd
rgc: rxo bni cfh czo acv
brc: blf chm ahn
ahs: aee azj
brz: bfh
yrs: yfv ytw yog lag lhs
rpo: bbi bcl bmv cla cut agr
auv: iat hie yak ygb ytc lkm lcp ljr
kie: kip rob bti chc cuq cop
hdu: lrl lia lvq
bat: bnh ccy
ian: iiy ipp yme lvj
bry: bcl bac ced avc
yuz: llg
imj: inp hay hif hqk ykn yja
iel: hqa ycz yyz ylm ymg yni lhc
rxr: rqw bwp bne cru ceh ayd asp
ipe: hgd hqe yam lwc
crt: czb abq
buj: cip akf asn
hvl: htw hop yna lrt lwa
bvq: bou cad cfr cof akz acx
bbr: bvd bug cyl cde
yad: ysp ytf llx lwe
rdn: rzn cau csd ahi anr
iqh: ytq yuk
hlu: yih ytk lkn
cqy: ctu alt
ryx: ryu rse ciu cgr cpe
hms: huu ykz ybt ypn yfr
bdg: bni bfi bfs cgg aro
bae: cec ahl alo
iiy: iyl imc inq hkw hbf hjr htc yru yhm ysu
yir: ylj ypn lye
ybq: yyy yux lyg
khk: kho rtg bkh bie bln bgt
iwo: ixs hgb ygg yxb
ixq: ing hwd hno ykg ycv lys
cfn: ajs
kxa: rig cpg czd adn axo
kic: rsv rzo bxy cic cgd amg azg
huj: ywq llc
bkx: cdc cdl cor akv aci
hty: lkf lrp ldg ljo
bzw: cto axk aps
kxb: ktf rmf bjc bzf ctk arp aic ahz
lly: ljs
rhe: rdi bjc bqj czq ang
hux: ypo
rsb: rzp bpz cky cai cxl aax agh
ylg: yqn
czk: cqi arf afa
cfa: arq asr anq
iqk: hwd hxq ywd las lix lhm
ajf: amt
key: rnn bgv ckg clt
bgr: cct coc amr
ywm: ymx
kqd: bjj bsn cmf
aud: ijm ixr hjq las lld
ish: hbj hcx hvh hqx yjo ysq yqb
rba: bkk cks cfp ajs
cis: chc cpi adg ast axy
kmw: kfz bjs acg avf
hlr: hff ygp lhh
kmi: rsg bkk bmy bqh cgl ctn awo ami
imd: iqm ykp yak
ygq: lrv lah lid lsl
afw: aqh
hll: ykq lgs
ipo: har hsr htr ykz
kpy: bgv chu
kfi: riw bua cyb cpr alj
hwp: hzb huf lbl
ayg: asd aev
klf: kso ktm bco bul cng alp
kyo: kuq req bnh cah cui
ysf: yfc yzk lht lls ldz
bdw: bds bqh cyu cvn cxn ctz asw azg
rmm: rui ckf
aqs: icx hwl htz ysi ypc
htz: yzg lcg lhk lls
khs: klu kgw kmq kzu rag rjb bcf bal bgw bsz cmj cnl
ali: aqk
kjp: kfc kfl rto bjr ccp cji csp cmv agl axh
ldd: lvd
cvi: cte
rws: rwq rsz bby bqi arr
yfo: lkl lwd
hpj: yji yog lrm lvx
ixs: inb izg hrx hyd hlh hem
kyr: rbj csv czx abe ach ahe
kvi: rwl rzi rzw cug
kma: rxq bks bag bjq afp
bxc: bfr cbg cvh czz
rhl: rph rpt ron bon cia
kvo: kft rcw cvo apz
aap: adl ajf
iti: ioj hdh hfx
kql: rzk cem akz awz azj
kzt: rnb rqg ruo brg cdo coy afc
rua: blm bui chx
krr: rhx rwu blw cyv cgl akj
iey: hlk hnb lgn lsm
izm: hkm hgv hfo yje yxe lhw llc lsy
kar: kad kjl rdm cjt aej aps
bdq: bxs abr apf
iad: ivh ivs isl ipg
kqq: koa rfx boj ceg agf ajj axr
arl: acb
kci: kcw rhj bpf cgk
ivo: ydx lky lhr lsy
ckk: ahs axd
itv: hsx hfv hzz ycf lln
aqq: atl ick hfn ycg yvs
chh: cgt
bfs: crq cuy ajy
yau: yix ygu
bol: cfe awz
caw: cdp
yzl: ytw
kdu: bku bva btw czb arc avb avn axx
cxn: aef
rlq: blj cgj cnr
hlg: yza yty lkw lws
rtf: bse bei bxj
hwj: hnv hqe ysq ldx
res: ree bra ags awm
hvv: hzu yss yqk
ldo: lvz
bwv: agm ajm avt
btg: ccw cad
cze: coo awo
krq: kbo khr kmj rbo bsx bxe aai
rbh: rzl cgt aab
iae: hit yjo yuv lrv lii lgu ljn
hyy: yxj llg lln
rqk: bii bxn bnj cmp acl ajp
yem: lhm
kfe: bat byv bog csy cul
aep: apr
bsj: ciu clp cdv
lkv: lhk
kcy: ryj bax cww cwz aak
lyn: lsd
ysv: ynm lgf
hxe: hnc ybc yhn yvr
rwv: rfv bhv cpo ayh
yai: yeu
ick: itx had lkz lrz lld
kbo: kmo rwv boi cxr aet
rdv: rpp bla bpl aso
koi: ril rwq
kqs: rla bwt bvm bpf cel cza
inp: hgh ymd
rfp: ctc aal aia avi
ito: hlc yni lae lhb
hzd: yat yyq yxi lrq
cbu: awf ajy asy
hgh: hxp ycm
bqo: cmr aej
ibl: ija ino hwf hxf hfh lyi
izc: hkw hpl hfj htt hud yyr yly
rkv: rgf byp cvh
rpy: bjw bsj
how: ynf yfn lig
iku: ieu inh yox ldj
rsw: ruu bpr cbq cxb afq
iwl: hyj hzx yio lkd
rda: bga bws bmf aaf
afr: afe
ibo: ije hpp yyg lrw
aus: iiv ina hix hyv hja yrv lar ldg
ycd: ydw lrf lbd lvw
irs: izx hao yue lsg
afy: afu
btz: cgo aig
kjc: rcp bsa bpv cxo
btv: cyt cmp ayw axn and
bjj: bfq cwe agv
rcd: cyc clf ale apz
ydf: yzy ytl
bhd: cfn aiu aep
ifl: hkk hnm yzu lyu
lhs: lye
kyi: rgm rmn bhz byu cwt cuv ask
rfy: rqq bai bfn akr adv
kgz: rfa cgy cnw ctk agq adq
hgg: hdv yce
kzg: kou rlt bpx bmx boo cyr cey ayx adp
kcn: cwn abx aae afc
hxz: hoc ybn lrs
rst: rpy bxe buy cke cbu aem afm
iag: ill idg ipm izl yne lrw
cct: cde cov ahb aws
bsf: ceu
aql: ici hut ybp yjc lyb lsb lsp
rdm: bsw als afz
lhy: lyp lsk
hbi: hsa lid
bnw: cmw cnq anu
isw: hsq ysy lci ldy ldj
ryq: ret cpo coe axc
iex: hue hux yxh lyb
aed: afw
rpz: rqx bwx bwt bns caf cpd
rmw: bkh ben bqe btk btg bok
hvo: hxv htd yic ywy
ylx: yjw ynq lvw
ygj: yxi yzv
car: aca and
ccv: ayv aza
iqm: iud hjs hnx yph
bmm: cni aba
yfb: lwl
rch: rnv rux brs cjz
ksg: rrb rmh bcq bjw cwb cqc coo abs aef
yip: yle lht
cwv: cdc cqm aie alm avn
lra: lge
iod: hqm huc how ynk lie
ide: ijo ivg ier hlt yfr lke lyh
kox: rph abn apr
cch: adf
rkr: rfc bjo arq
rni: rfm bxo cau cjd agq
hzv: yih
ynz: yti
rnw: ruq bgs bxy cil ahe asb
rih: rsa bxf cah chs czw cqb
rdz: ckg ady aqb
ixl: hwm hei hne hfr
ilt: ixq hgs hge yys ylk yvy yta lcm lhn
bhb: coc asj afm
hhp: hsd hpp yiq yyv yed
buy: css csz acl alz
yor: lic
hwo: yjh lbh liy
kbf: kyd klc rnm acx anr
rxl: bbb bdc bdw cjr ceq
bej: csp awo
kyq: rdf bry bcb bnb bta age ads
icp: iqd hrs lib
bdm: ccc ccz agz
clr: cqm avb
boy: ccp czg cui
cqa: akx aav axq
cqv: art asr
beq: cxx coz
ywh: yei yuy lbc lgv lvz
bjm: bzk chm aik
ioe: hrw hxl lry
hee: yir yya ydw yxc yms lwu
rxm: bwd cxs abm aft
bxq: chb ctq
hys: htt ygp lhd
kaj: kep rle rnb rtq bqk cat chn awq
bcx: chf cdt cxs alh
idu: hxr yyl yen lrr lrz
rwb: rmk cpg
cgn: cqy
hqm: ypf yub lwe
rrr: rye rdw rqj
hmt: hfg hqa ywj yux
ryl: rmq aqy
cnd: acf
rjo: cev ade axx
rrh: rrv rmx bia cnv ads
kjg: ken rcc bor cdp aiq afv
hfp: ygj yns yun
rci: rag rzb rqj cjr arf
hgf: hmt yhy
bdb: alv apm
hzs: ygj ydh ytf lhj lwd
ypm: yts lwx
htb: lih
cnj: czr cot
yae: yvf ysi ytc
hlh: hna yar yhw yzd
ink: iqp hcj yvz ynd lrj lcu lho
rgq: bru bcg baz boi abk
byn: bzo bqc
kvd: rmb rtu coh awp
cvq: ctj cuk
kju: rrc reg rmx bqu cwz
cmt: cfj
cug: aru acm awx
lrt: lyy lsd
bzs: cco cxy cpe czb ayw amw
bts: bor clu
bhu: byc ber arb
boi: cbl cav cfq aie agc
ksd: ryk rft bew ajm axc
rco: ral rwl bkv bak csf
cdk: ajz
kth: rky rhw bre bbb btp cnn
kyt: rjm rpe bll blv
yvv: yfl
ygs: ymy
rid: bsl ccy coq akm
ich: itl hgx hvn ymx lkx lct lgh
rrv: bbg byi cbp clj
aqw: izh hkw ywo ync
brh: cpv ctv alc
ykm: yql
kjy: kme cbg ccz cuy
bon: cbt cqu coa
hso: hmp yba lsi
hfr: yhw yfo you
aib: aed
kue: rwe cxi ahq ayl ame
cjy: amv
cgk: cxz aal aez
hqs: yqr lrq
lid: lja
yaj: yfh yuw
rnk: bcs bpd bmi ctm
csj: adx avd afq
rdq: byn bpm buh avc
ikf: ipw iog hka ygz yfx lbp lae lvi lvp
inj: ifn het ybb yln yfm yzq llo
bxp: but azx
cqh: abv ahs
heo: ykm lii lsr
rof: clg
lcx: ljl
lrk: lhr
ban: bxm agp
kel: rge ree rtk bez cco cmw
cfy: cfv arv afr
yyl: yvo ysd ytr lws
rky: riy rgf rvc rsf ros bxy
rmy: rfz rub bcr aew and
hgi: hzu yxm yft lja
kia: kjd kuc kuw rqx bsc
hsd: hoy lcz lan llh
kgl: rqm bqx cbp cwg arh aan
kzv: ryu blg chs acv alk
ymi: lbd lie
iyw: ixg lbe ldb
kwb: kxm kuy bfo bzw
isj: hsg hsd yab yyl ygp
kmr: kql bhf boe ctu cua
iqw: hlq htd
kdm: kxz kur koh rba rcg akn aic
yaw: yaf ydq ytl
iop: hmf ygm yjv yni yff yqm
cnn: ctf
roa: blo cfd cos ahw
izo: yls lab llk
caa: axb
icw: iic iva ivz hia hmk hfw htt
laj: lam
kvu: ric rwj rpm baw cqm ctd aph
cqf: apv ana
hsy: hsg hmb lit
rwi: rwl roi bjo ase
hru: yza lbb laz lia
kcq: rnv bjv bey bfy bzo ceq awu
bra: cgf aaq
bpx: csl cmc anb
ijk: izj hlr hfe yka yol ldl
awm: adb adn aen amd
cgf: awy azw azm
rlc: rfq byk bsz bup cru cqc
cjr: cfr ajb
hwl: yxt ypk llz
yyf: yvr
rxz: bzv abn axi
izh: hjr hzt hut lab lla ldp lje
hgu: hdk huc yll ygz yel yex yuh lwy
cxr: cfx abn avx
kej: rxp bca bdt chm cnv
ydm: yzz
iyt: hrp ygk lcl
bgn: aka agz
yea: yxz
cue: aia adp
ypa: ymo yfb lvb
hxh: hur yce ypl
aas: apj azp
bvb: akf aip asl
bom: cah cqx ayt axr
bbk: bhj byc cbs cjh coq arw all
kut: koz bkf bhj bue
cni: cny aap ayy
hbs: hla hxc hua yrs ytp ljw
rbr: clh cep aab anz
khu: rar rxh rza bal cgp aiy
koe: rdk rju bdk abr azq
cey: czr
bmr: cpp
hqy: yjt yqn
rnb: bcc cbw anr
kii: kog rro bqn cbu cqy aal aag agt
bzx: cqa aay adq
bsy: bsn cmc ayc aws
ctp: abm
cks: cef
hge: hje hss yuv lju
yln: yjk lki
kzn: rrw rjp rtn ccr cln
hzg: ybg yao ymy lcm lvj
idb: hqu yit yxj lie
yps: lhw lyo lsr
rjx: rev cya abc ajs
hga: hzy hou yhl ynh
iwu: hwr hdp ycf
kcx: kjp rae cqx aee
yll: lcb llu
bii: apy
yej: yxu yto
ins: hyo hen hxf yyv lhp lwp
igz: hts huc yrc ycz
aqt: aur hqy hou ygi
iva: iny hvo hzb ybf ytf lru
rtn: bgi ctk acs awt apk
klb: rgk rsh rpr bgp bzj bui
kdx: kvl ktq rfy ruy bwu ayc
hbo: hcw ypv
ahy: aem
hkg: hfu
cun: aey
bcm: bjc cvy abd agd asi
yvi: yea
hrb: hyv hpn ykw yhd ywt
rtd: roj bpe buh cel cmo asd
riq: rmn coa
inc: hkm hlh hgj hmw hfn ync yqg lin
rzg: bal bvc akf
rth: bhd bws bmm cjj cxq aqh
bfm: cnt cfb acy
cri: con ajr ajg
rql: bir amj afr
cvp: cfd
hhs: hvl hub huq ysc yst lyj
cty: cou ard agv apq
imz: hkr hrx hcd hjl yls ynn lgy
rlt: rds bcf
bjp: cgf agv
yvy: yfp
hnk: ybs yjy lhj lvb
hpy: hzt ylf yec yul ljf
yjl: yqq llg
rhw: rwi rea rpl big adg anm
idw: hdg hno ybb yet lkh
haq: hyl ysl yml ynv
cnl: ctf aaq afb
lbc: lgi
cll: cmw
bhv: bdj buf aya axb
rdg: crx chu cux ahz
bcl: bwg chj afd
bhn: bvw aqy
akd: apa anh afn
yhb: yzb ytw
bnf: cbc cly cvg ahc agh
ycb: ywh yev yuq
aiq: awd afx aqi
ycj: yiw yzj lje
rzn: csq ctd acq
yix: ydw lju
bet: cye
bvf: ahh
rqn: bye bxg ceu age
ybw: yhx yjy yvf ypf ynf
csi: cuj
lwr: lws
bgm: cvr cvo ahe ajj
kwz: kzl rfu abc
ykd: yrk yhu lyz
yxz: yzz lru
hcb: hnf hqs hqe yxk yqw ytd
bmg: ckd crm
ayb: apf azk
ctx: alj
byq: bej ccu caq cnx
rzb: bgx cbo aec app apn
ctf: ars agq
kpu: rrw bfx bqo ccj cyp cfw
hgy: lac ldq
iam: izi hsq hfv yvj lkx
cxl: czt awv apr
kxr: kzz kox riu rup byr agi
ysd: lrh lwn
rie: bmz cbj arb ade amp
byb: bve ben
hgb: yha yyo ygx yol lkw lvf
yfz: lvz
yje: lkm
ilr: ine yhs ytp yue
kaa: klv kvu rqt bqv bqp cal cdu aks
rqm: bmw
yny: yfa lax lvs
cuv: apv
yni: lif lgg lvv
ras: rmp bbw bhs bsd bmx clr cut ari acp act ahd
hix: hqc yfb
ris: rqz cir
bdr: ckq cdg arv aau adc
cgq: cuj agz
hro: hft hqt yyc yxu lgg ldj
ivw: izk hbi hia hty ymy
hpv: yja ynr lah
rgb: rxz cja cmr cnq afg
huq: lia lyi
ioq: hoy ywp yoc lit lwq
ism: hln hmr yax lvf lsb
kdk: bse bti cdq cqa
bkr: brl bbc cuo aih awj
isa: yvw ymd lkx lrt
hjv: hxj hzf hou yql ldq
khr: rwz byz ary aai
kvy: rrw rti bjw cad avo
byl: bgn caz csw aym
kij: bck bfi ctj aav
kbt: kyf kgb kea bkb bky beu apt
crl: aac alj awa afy
iym: ivw yau lha lle
ask: aeg
acb: alv asu aqc
kei: kqx ryi rde rvz bpc afm
htp: yry ydj yev
bsc: asq
ysg: lyj lvz
rrl: rnp rqy bpf axy
ksk: rjn rmt bbr cbp ciy cfz azw
hus: ysx
ybl: yli
rbp: cks cim cpx ake
kip: ryk rek bkt cbm
ijl: izy iun hpo ybw yjv ysn lrz
rug: bxj bff bzg
bpn: crc cvg abw
rxt: byt ckq
hag: htl hux yhd yvu lrg lwp
rmh: buu abe
lky: lja
rvh: bjm boi cap chg cyh cdo col
idm: iem htj yvr ypi lwx
aqj: aqo ibk hku yxc yoe lhn lgv ljl
kmy: kor rkg rrv rta cau cop acu asy asx amx
kby: bde bsd aii alm asq amo
yan: yxv lje lvk
cph: apt
iuq: hip yhf yfh yqw yob lcw lvk
axk: aqr
bka: ctz afg afu
iwe: itd hco
hvg: hpe ymd yng
llw: lsj
kdf: rey rqi ctw asw
hfm: lcw
isu: hxt hzr ydo yvg yzp yqr lyf
rsf: bal cvl
yqr: lcg
cko: acw azn azo
yct: yyu ymg
kwv: kek rdh bsf cfi ayz ase amn
ykj: ymt lkr lvu
ara: adl
kda: ktu rdc rzu biu cyu cnu
ktl: rhy rlx rtt bna cmd anx
ynj: lia
bdv: bnh
bif: bfq cyz cvx axi
icy: iww ifj itx hwm hdg hmi ysw lkb
ytp: ljs lsp
hvd: hmm yri lkf lsh
khx: kjf kna rab rpt blw bgz bno cbt avk ane
ruq: cif cdo czw ayg
ilv: iqf iou hgf hph yrw ypa
ytk: ytn lcc
bkc: bpx cml apd
rsg: czq adl
clv: cfz ach
lwa: lwl
ibh: hhu hxk yvb lrz
bvz: cdz akf azg
bkj: bgq bwx crw cnh arf
yeh: yxd
yim: yio ymx lam
hen: yrd yyd lrc
rzv: bcv cen
hpz: hfq yhp yyd yvg
cbw: ccp cgk cqt
hit: hll hdf hte yyr yeb yec ypc llf
yht: lly
byf: bns bnz cha cyy cde czd
kkb: kwi kow ben cwj cmj ami
iyx: ile ioc hjp hsf ynw lbn
coj: ahb aex
yyx: yxs yfj yfe yqp
hjw: hvd lam
rdf: bye bxm cay cwy
clm: cwd cwx cvl cpx cfb
brv: biz cxr cpm
cal: abs ajf
rlr: bas ctk
yac: yix ysg lce lvl
kgu: rkm cgp czw aae agr
aay: agc awh aeq
iun: hru hsx hqm ycn lcw ljv
ywb: yuh ljk
cjz: cpa cpi aea
iri: iaj hih hjj ydx
hac: hwo hsm hmt ywt
izu: ybq ywy lhp lyr lln ldt
kwa: kpt rgv rpf baf clu
bqz: aap
ack: ags
hia: hhl hnk
rbz: rep bwl bop crd avf asa
itz: hvg ywy lvr
hgw: hfb hqi ysk lbm lca
hqa: lkw lrj lrn
atx: irg iyq hwl ygs yjs ymj lik lwo
cpy: apk
yzp: laq
yub: lib
czy: avo aeb
cnc: abi aei apo
lhk: lvt
iwp: hdx hec hom lgk
bdd: bth cmk cqo ask
bsx: bma bmf bfx boj ces cxd awj
hkz: yqo lkp lwc lwf
aqe: iqe yiv llt lji
ier: yyr lkx
hlp: hds hvm ykd ybo ldy
adm: aqr
kls: bja btn ags axy
yhu: las llq ljx
ilm: iew hfr yxj
aog: iwc ivk iqc itu hye hvg yns
yba: ljy
bhk: bjy bsb akk
rer: rua bqt buo cvk
bbg: bgk bel cvy cxn coy
kuh: kof ruw bxw bti acc ajl azv
cpq: arm aev
yer: yef yta
kbj: kvq rld bsv bec chl apt
img: ifx izm iqv ius hsu lrk
hxb: hny htw hum ylj yxy lgn lju
ikb: iwi ixo itk heh hnm yjk yfd
ihp: hsn hqo yrp ybd ldj
hxx: hpr htf ymw
ifr: ykd ybi yjv lac
ing: yyo lrc lbm
rzx: bko bbb bpb bpg cqn awe adk
ypb: yzx lbo lde
bnt: bzp
kge: kxb kni kqo rey rzo bin byi bmj coq
ymp: lww
hql: yrw yse yst lwy
rso: bao bli blm bfm arc avx axl aqb
rij: rha rzv bcv bsx bup
ckt: cri cnw agm
rgv: brr bpl
kki: kji rkq brj cvj
imu: iqa hme ycr
caq: clb cmm
ksu: kek bbf chw cms
hly: hup yva yvl
bfb: aru ayo agp
hpb: hzy ydp
bim: cxt cqe ahk
kph: kqg rif reg
bmk: cdo ced cfl aid
yqu: laj ljz
kpq: roi bge bmh cch amu
icx: iet iqq hkp hwi hso hzo hox liv
rxf: rto bif bjq czt
kqo: rfc bcb bjs aww adu ajz
hfl: yjn yvs llz
rei: baj byd bfx cnu
arh: apw
rle: rxa chb cgd
hhq: hqj yeu lbb lcg
icg: hdm hew hxm lrj lgf
cfo: czn ako
hky: hfn hta hoj yei
rhi: rhl rhf rpp rnf bgj
cxw: ajp
yjf: ysq ypm yqp lbd ldf
cfu: czc
hhm: hww hsb htb ygp lhu
bex: boc bou
ivz: ipn hiv hhm hzo yke ysh lhb ldu
iyj: ifk yke yhi
apf: azl
abx: adc asm
hcv: ybh yjz yoa
ily: idf its itf hju hxq yjo ysb yon lrv
ijr: hvi htz ykn yww
hqv: ydk yjn ysj yom las
bqe: bum crc crs cla cob avu
hyr: hdc yeq ypl
aqx: icq iah igm ijp hgl yho lbr
rdu: chw cpy
hxd: htm ydr ymi
kew: rcz riq bbl
rne: blu bws bvu anm
rib: rqw acn aec apf amz
irm: iyw hil hhk yhh yxa yzb
hfu: htz ycx yvn
kfh: kff rsg rte bqh bqj agh amq
rjn: rsl bpd bmg bfk cdt awu
hzp: yvn yti lsm
ilq: ipf hvm ycc lwt
hmy: htx ylx
yif: yvt yxz ymu lgs ljn
ygz: yws ywt laa
hvi: yjc yzb lgc
buk: cgx cso cph
aco: alt
cwd: cvy arj
rdp: rvx cha cvt cfe cfz all
bzm: azz
ymx: lbg
kyx: kwx rkg rwg rsk rox bma bqz ccw ada axl
abh: abe
bhf: bmh cah cnz avn
rqf: bki bep cun
lds: lvt
rvf: biy cdy cma ctp acr awo
cjn: ava
auf: isw ybo yii lvu
buf: cfo
iib: hcm lre lco lvb lvg
kxd: rbs rce rpy rfl bar cki cvq aka
rew: byj agr awz adx asm
kpb: rzg byu bpa bol cwb cqf
hbz: hil hvg hem yvv yxv ytb yuk yop lvh
ikc: iig ilq hcl hsa yfl las
bjg: bmg boa cuy abf
bjk: btd cis ahy amk
kdj: key kqz rjy bwq caq cdd cve akr aic
igt: ijr hyv htf ldq
rdh: cit cjz
bql: btk buj abv
rva: rep bpm clh cxs
iyk: iom hct yey ypx ynh yug
hpo: hzh htz lcx
ceo: cuc cuw afo
rcb: rud bpv bmv awg
kmf: rgp beo cis ade
hnr: yng yqx yol lgz
hpf: yju yug
hju: yjw ypw
bia: bfl cze
bcr: bnv aye awb aef
yob: lie liu
yis: lcc
cwb: cpn aik afx
lro: liw lju
bdu: bpi bza aew
ckn: agx
bwu: asc
cxi: aiv azs
coi: ahc ahj ayq
ayq: avs
hmm: yem lab
hyp: ycl ynb ytl lcu
idl: hal hsw ytm lsd
ycu: ytb lye lvf
kxz: ruj bdp bvu abt asa
crg: abk agk amm azr
awc: ash
knu: kzn rdf rmk cgz czq adk
auq: iwn inb hfj law liz llx
cys: cue aiw
ykc: yhz lrb
kcm: kjc kul bpl cup asp aed
hml: htr yag ysk yeh llf
yqy: yum lye
kpp: rac bdo cdo
iut: hwz hdq hjz hmi ycr lyt
khg: kfe rbc ral bhd bdr cmx cfr czw cqf
kzw: rac cvp aau ale alz
hyv: hmd yel ldj
rux: bmi ckr cup
ihm: ifw iut ygv yxq
rmd: bls bgv bod cyy
aos: ist hlw hpv htv yze
imh: had hyj hyt hgo hwl hvq yym yva
bxr: bmz bfh ajg anq
rxa: boe cbh cix cnh aje ams
yly: yjl yft lbd
yab: lvy
rjs: baj bop
bvo: bof cnl axe
ynd: yzn yuj
yyg: yep yzx yuk
her: ybu yhy ywo lgt
rbt: ckm cww cjc cju ara
boe: cre akq axp
rtv: bok cry arh ajt
rjg: cra cyl cdw afh
hzw: lak llg
bmn: bzo csx
ims: iuv yle yxl ymh
csn: ajx anp
ihr: ifn hpz yht yql
iuj: hmd yct lbf ljm
cgo: csb amj anv aqi
ikv: hgs heb hpa lby
hlb: hzv
hut: lvi
has: yvc lcm
rfv: bmo bns cfe
hho: hxj hnd hfh ylr yjd
rmc: rzh biy blb bfi cxe ayd apu
bpe: coy akr api
rki: rvl rsi bqu cle ctz
rfo: alo adl azx
rvi: rsm bhs bxc
art: anm
ild: izo hlh hqu hol yce ynu
rvl: bkz cgd anj
ift: ylr lbt lii
hom: ykn yeh yfx liq
cry: cct czp cto
iqj: hnr yaz lhp
htk: ywt yjx lsj
kfx: btd clv cvy cqt
ykh: ynj ynp yza
aut: ihu ivj heo hpb hnx yie yfk lvb
cbe: chl cvv anf
yds: ydf lkf
ijy: itw yxy yxe yqy
hqb: yll lrc lcd
cxc: aka aft afu
cax: afy
isn: hci hxh ykk yet
ivd: yyj yqn llo
bpt: bfv boo cvz
cdi: aki
itc: hlv hqz ygl yeb
bvw: axs
imq: iqj yae lik lyf
ljl: lvr
rqb: biz bxh cgp aku adj
bmc: cyq
rbg: bra bwv buy csd
aso: aef amq aqb
kok: bip bdj bsf bfo cuf awc
bwn: cmq axo
iaj: idc ivr iqk hky hij hdc hpm ybu yhr lje
cpo: cmi
kvp: raw rni cuy ant
ldf: ljw
bnz: crl abc ail aps
ciw: chc
irf: ilh yzd lhc ljf
hgq: yjy ldn
rmp: caj cjd
iye: ion hbl hdj hqy ydx lcp
crp: cqx cuk
yux: lbs lvg
kyd: reb cfo axl
cho: cem aby agy
blz: bgv bow
byg: cua
ysl: yot lrz lwf
yhe: lag lhn
rry: rbg rhf bbe bwx aig ait
yxe: ynk yfk laq lhe lhq
hdm: hjj lcz
igv: heq yyc yuc lbr
itr: hfp ybh
reg: bbe bhq ckl
rkp: bmc cwh cpo
rix: byv bgn abn
hoy: ybq ygn ypm liz lyy
hcd: ylv lwg
kyz: kvs rwf bju apq
baz: cip cvw ape
rzu: bwu bvy bzu cej cfg
cls: apg
hlx: ykj yrg yad ygy yvj lru lva
rgl: rer rtz brf chq
cur: aio awd afp
cdy: cex
ywq: yjc ljk
hin: hny hne hfw yjz lrr
kzk: rkh ayo apa
ckb: cyx clt cjc cuu ayc ago
bdf: beb cpl ait alx ajl
crd: cdp cjg cpe
bau: ckm art aym afx
aim: amk
kpj: rih aki ahx axq
iur: yuv lch
buh: cjt ali
ccy: aip apf
brn: bhu bzg aim ayk aym
kih: kqu rlp rsn btz cgb cdk awl
rub: beg buy cki ctn
csg: aaw apb apt
cwj: cfd akt arg
rlu: byi ari abr ahq
cgt: coo aya ajq
ben: bpj btf
lrl: lrd lho
ryj: rjb rvg ban cls abm adn
yva: yee yns
bqx: buc cmy cze
hfv: ysu ype ldo
lcj: ldc
ktf: rjp rod bqq cxk azo
ykl: yfo
rsl: rsm rmt rqe bid afl
rls: rmk rqo blu bqg czp aev
iah: ifb ydm lly ljy
bsw: cbi cus acg awl app
hjs: hsj ysj yqj
adb: aze
koc: rra rfl ccu csd
htm: ynt yzm
yhm: ygt lli
ifp: iza iof hjj htj yyb yyt lsb
ykv: llm lvy
ykp: ylk
csd: ajx
iub: hyc hvl yrq yjt
adu: anl ann
bce: btd cay
kuj: rjw rua blb btw cmq
bkm: cyr clj cuu
kkj: kyy kye kpu rcj rlz cbu akn
ipk: imn yxm ypt yqv
hbu: hiu hoj yrk ywy ymk
cxh: amk
hwh: hef
yxf: ynz yqs lrd
ilg: igj izv iqw hxm huw ydu
yyd: yes
yft: lrm
kos: rtl bwk clu cfw czy
btc: crh cpz awy
yoq: laa lhw
ryp: byt cbe cld akg adn
kce: kix rmq blv ccs cxz cuj abs
kmj: rcd rty rtd
bih: bly bdw bml boy cyk clp abi
hbl: yrc ygt ydn yno llo
cyq: cup acp adb
ysa: yej yps ljk
rfb: cpj ctg cot aqy
yfq: yqy
bsg: bxt cvc agb ajm
hre: hcv hyr heh ycv ydp yvm
bli: cug
hqz: ygr ydo
hwv: hel ydm ldp
ifa: hqh htj lyk lsg
ctj: coa
bqa: cvd cpw cnx acj
iwz: ivm hsv yay yyn ytj
hpt: lri lwc
hxa: ycc yyu ldx
bla: bej cfg awx
bse: bst bpd cly
igb: hkn htl lsb
ajw: ane
hzt: ygh yzi lhy
igu: hhn hex yeo yoh lwo lvq
yid: yyr yew
iko: ifz iqt hcj hai htj hus yfy
aoc: aot ijl hix
aqz: iar iew izu hfb yax lhr lgj
ale: asx
bfk: avu
kbw: ksf bgq cda coh acx
beh: cik cyr czt avl
aym: avo
aea: ank
hzq: yhq ylr lkp lhc
iiz: hzp yih yeg lwm
kla: rty cyq clo ahy
har: huh ywg ydy yzs yqo
rcm: bzc cbp acu anl
aaa: agw
hkh: hld yaj lrj lwc
lcu: ljw lsh
hyu: hdd hvy htz lgf
hss: heu ywe
bez: bps arb
rtu: bvs cwe czi axm azx
lge: lgu
ckl: cah amz
alq: ams anz
iej: hll hmo yvl yzr
izv: hyc heg ycc lhd lvy
ipt: hpz yrr ybt yii lbn lvb
yhn: yfi
cer: cmm cno ado ajh avl
rvk: rmr bec bpc ake
iyb: iyf ieq yot lir ljh
kqb: kue rla rzr rqy bxj cpf asv
yph: ytv lgq
iqa: hbd hhd hmv ytt
rfd: bwt cxq czo abk
cwf: cdp cpc
lrd: laq ljy
lbe: lcu lwp
bzp: bqg ckm ajs
hcj: hsy yiw yln yjh lie
kgg: keb kxm rzy biy ads ama amw
ypy: lam llh lwg
lrb: llb
yfa: lkd lcq lsi
ihz: ido ipz hlr
rht: reg rnf bch bva bzm cpx aep
idy: isf ipc iny iol hyr hvk hvx hsf hqq ylu ygd ywc yqv lbh
ahc: awn azd
cju: ctq alw
kaf: kdn kqy rem roy bdn cgl art
kmm: rmb cbc caf cnw amg
yup: lla
yle: ygs
iuk: hog yll ldc ldi
ksa: bld czi
hwm: hzu ysp yxg yfd
rkh: bzy amf aqh
khl: rvp cid aiz ajn
ykt: yba yfn
beu: cop
bzf: cet cxh anh
hpq: hti yhw yhz yms lcu lyj
hqt: ybc ycs ywj lls
ypr: yoz
hav: hyo hxs hmk hme yne yuo
yrq: yfs
kpx: rxg brj bae bwv
ila: hey htb lyi lsc
yih: ynb
clj: acc asp
kek: rtf ruq bnh cwx cjw anc
ipp: haa hjs yij lre
csr: asn
rvm: bij btl ccp cmv
kjh: kpg rbt rfq aas
kwc: bbs bam bhb asv
yya: ywp ydf
cht: abt avn
ifn: hra yij lhm
yex: lbp
aoa: iwz iti hdx hqv hqq
cgs: cmr cqv azs
cmc: akm arl
hme: ygx yoi lgk
rnt: bky bly cio cmk arh
ylv: ygj ldb
abr: apb afm
kem: kmv bhw aqr
iuc: hkg yai lkm
iax: ykw yrs yab ywh yjh
ixu: ygc ysv lix ldb ldx
kqz: ktg rdu bru bep cbz cob con azo
bms: aad
avg: asw
rmf: bdc buj bom ari asq
ret: rxm rux bba bds cmc agn
kwo: rjx bkg bid bsj cjs aey
yev: lrv
cwo: cse cuh aee
czx: ctw
rnx: cof asl
rra: cyl cyn cws air
cdn: cvc cmx cqd
bwp: bzz chs
rkn: rrq rcq ckn crg
cas: cmk aiw awx
yef: lio
lya: lsb
ciq: cmz akw aim alm axf
hnh: ykt lbc
bwd: cvc akn alu
knt: kqn rhd rgp rto bgz btx avs
klj: rka bda bmt afe
cua: are ahw
cam: cgh amk
amn: aqr
kky: kxa rhi chf cpr cfq ayf
kmu: rvh rqu bjg bpc acu aas
kal: ksv rrj rqp aca anj
khq: bdp ciw ciz cgn coz axk
ccp: csr awz
bwj: cpu awm adz ajo amn
idk: hek ybf yas lrd
cqd: ayh
rau: rin bry bzc ayi
heu: hty yzv ljm
bee: crb ard aag ayi
igj: hbd yle ysw yec lca
rlp: rez bbl ccd civ
rge: rou bzf ajb
yty: lhg
rcr: rgc rvi bya cwp cms age
hnx: hun lki
bqg: cuk ayj
knl: kqd bcv blv cdf
rzr: bta
rmz: rfm rft bnm cbp
iuu: hwe hsw yil lyc
bta: adu ajt apc
bzr: caw abg azv
hdr: hvx hql yrq ljo
ktn: rpm bmo cil cln cga avx
cmp: aiq
bkz: bgk caa cqr agp
bdz: crl aed aqb
kzy: rzl rzq bng
cle: cuh abc apl
bqp: cez cfv cfp
cgh: ayd axg afs
rwl: rwp rpg bir bsa bzt che
kxy: rab rod bst cau cpr cpm cmp apy
iso: hbw har hdl htt lcs lhd
hfy: yle lbo lcf lyx lvx
bbv: bvm cwh cpr
kul: rmu bmf bqp buf abi
hdh: yje
iab: hsj hmj ycd ywt yzy lks
hww: hdu hsn yym lam lgf
ajd: axc
idj: hwc yut ldo
kcu: kpp rsm cum abx
yrg: yue
itt: yry lri lht
rru: rhr rdu rmc bgz bfm cal cnx
abb: apx apt
kdh: ryx buh buj cbm aew
chv: cva akf abz ahp aho agl
koh: rdi buz
bvy: bng
rog: bgp cdb ayp
rwu: byo bma crh agw
idf: hek hpp ykr lww
hrz: hnh yvp yql
iky: ikz iaw ydi yvm yot lry lvo
kjx: ksb bxb cjx cqv
baf: bjw bus abc abj
klr: ruc bjp bmb bmh cqw coo
rgu: rzd blx ciu act
cng: afv azk
bbw: but cmx cnb axn azi
aiz: aei afs
hdg: hpg yye ljv
aal: agb ane
kvf: rnd rod btn clm cod akb alc
bmo: cxw aex apn
bpa: buf ctl
yqv: ljp
rxp: rfk cda ceg adn afj
ynv: lyh
bne: akt apl
isg: itn hdv hzl yqa lba
hte: ljd lsd
blw: bvr bug cxx cpk cmk
ist: hae hxo hzg
htv: hto ypn yot
rvt: rub bpa bop cmv ast
iog: hub lgl
ioj: hyw hyd yij yei
czu: ail ahn azk
iav: iyj hfh hqa hou yle
ygw: yja yuw
yeg: ypx
bvg: bek cbn cdh azz
koy: rhc rdl rdg rqe rtw brz cep
ray: rda btr cad
kog: bwi chf acc aqa
cib: amg
hhu: yrs yez liv
igp: ieo ybx lhv
chm: cdg cpw czl aaa
clu: cdc cov apn
ihh: inq hly hso ych yoe lkn
khd: bth cqt ayp
igi: inw ifj ykq lvi lvs lvp
hfe: hod yec yqa
aui: ikp ipr hyv yln ysd yps
blx: bwm cco cft acv
rfe: rqy cqf anf
rsr: rxv bgf crm cav
ctd: cte coa anr
yzw: lcu
rjh: beg bpb bfz abw avq
hkc: hkv hij hgs hvl hqj
hua: yvd lre
rhs: rnv bnj bti ctv ayn afy
reo: rqq aeo
byd: bnn cli ach ahj
ymt: lya ldd
yhq: yfb lke ldr
cma: abr aco avv
igd: iuj hfl ykj ypw yzw ytz lam lao
imv: hjo hsk yrk ywm yem
ajq: ang
hbj: hys hwb ysp
ric: rts cyc cva ajl
koo: rdt ron clx cxj all
hyn: hvk hql ljd
blj: crk clx ahi
bnn: ckn cck
yxx: yoq
ayy: azd
klx: knu byb bpv bfh cwd
ynr: lrk
htf: yre ljk
rgk: rfq box abi amb
aub: hgh hwt hew hpc hoe lcb
alu: aeh apb
itm: hhw hvm hnh
kas: kvq kpf rqq cby ajn
cow: apw
bkf: cdx cug ajr avd aew azf
rmn: rqm crk ayi afw
hef: htp yru yxd lan lva
kxp: kqy bdy aes
ata: atn iir ija ioj hll hsf hud ydd
axs: amj
igk: ipz hbn hyo hll yat yws yjp
rqy: cnb cuv akx ahv agw
awb: api
ijf: hvg yyx yps lhy
ikt: hgb hpe yky ykx lbt ljx
hwb: hjx hxl ylk lrx
yyz: yjn yzu lkb
yrw: yuz
hsf: ygu
iil: ife hna ytf yuy yow lvc
hug: ynx lby
ruv: brf abm adt azs
ydq: yzc
cpm: cqt ajc
cef: arj
bwz: bvy bxt bta cyk
caf: ack
klz: rud brq ccy cje ars agg agp awv aey afl
kuf: rnr rqz crl csl cnc aax azd
izp: ioo ykx
yld: ytz lht
lyg: lyu lle
bqr: ckq cpq
bhs: bje bfc cai cpr
yfd: llu
lcs: lyd
rjt: bhw bwj bvt bvu akb
abz: aaw azh
ixh: hjf ylo yqs
aug: aoc ijk ixl izb ioo hea yjj yuc
irp: ivr hrl hwf yhc yyi llm
yhl: ywa lyb lgl
blr: cfw aix
ibw: iws ide ioh hhg hve yxj
hwn: yhy liz
kko: rsh ban bos adu
yhj: yyz yqd
rqo: bnd cyr cnu aeb
hnm: ybe yyn lcx lgb lwu
ijc: ivp imw ycx ytl
lac: lao llp lwx
hyh: hxe hph ldw
bsp: bzi cwz
inu: hkc hpk yeq yfs lrx lbu
iyr: ilm itu hrs hpw hpz yhz ldm
ihc: ize hmr hqv yhv ymp
heb: ykf yxk
yes: yqv
bct: bfz chw
ydg: ysu lyy lwu lsl
hye: huz yhm yjd yfj
cmb: ajn
izq: hrz hjf yir
bki: bne bnx
awh: awt
kio: kto rmx bay bvm bqz cbg cpm
hwg: hmi hnu yaq yts
cac: ayd azv
bij: byh bzn cxr cmd
ldi: ldd
cgm: ceg ctq afv
hon: ycl ydl yno lka
hfh: yvz ysf yfx
ynm: lgp
ref: cix akf abh adm
riv: rvh bhy bhm bvn aem
ird: ihh ivi ivg hiy hij
ymo: lcn ljy
ckx: aij apy
bhh: bdi ccb asj
crc: ccq aiv avn afc
hno: htv yll
ced: ajk aex
bwt: bxp aba
ktp: rhf rwd rdo bbe bwn cjl cvz arn aas
yho: llf
cje: akc ajk ama
yxs: lgp
hat: hwv hpw yhq
kpc: kqx rzb bqp abb
ckd: cis
yzi: lbo
kvj: kns bbf bgu cxk ahw
aqn: yjw yfe ldy ljo
ieu: izj hed lag
ial: iqf hhn hei yep yfn lcr
iml: huc yja lyg
yvj: yqj
cmy: aao agv
rxs: rfe brv bqo bov ccn cfk
kab: kjg cet cxd abc abz
rwd: aaz asg
izj: hkx hiq hsp ykr yrt lvs
kxu: kma rpi rql bir bvt bpm czu
ien: hsi huw ypq yob laf lyv lde
idt: ifk hbw hfo lbh
haj: hlr hlm hnt ysq
hxs: hua ybw yhm yvo lki lvu
kex: kfx ric blk beb can cel cpz cuy awz
rde: byg bzw chz cya
ctb: arf abg
ise: hjo hpv yjj yqk lid ldn
crn: ayn ali
kwu: roz bpk bor ccm
hqo: hty lbq
hmr: ywz ydz llb lvn
rad: bwm bdv bqh cir cmi adr
kkn: rch rpu rmw bhc byy csi
czv: czo aax ays ala ajv
irn: ixb hed ydz lch lyf
ihj: ixh ipr itd ybj yqu
bfd: bqm ckx cvt ajc
yjc: ldh
czl: abk aiq
act: amk
rvp: cvj cns anp
cti: coi afc
cxq: aka
rhv: bit ael apg afu
hhl: hpz hzj lah
cuw: ara aly asc
atj: ihu igt ivi llw
kmg: kzr rvr bdm
csx: col aap
kta: kuw rbh ccp cxv
kke: kud bhp cud aaz
rip: bwu cmd cms aeb
ius: hcy hnx hzi yee
czf: agt aqr
ixt: yrp ymj
knd: bej agr aji
bxs: cza asp aqh
kyp: czx ctr ajf
hto: hog ymf lat lhz lds
aux: imc hpg yyb yms ytf
bjx: bfn ckv cbr cgq aml
hwu: hjm yac ydt yvk lww
ahv: alr aju
cwg: abd
lbt: ljf
cnt: axh apq
rpp: buo car cin cqi
ylr: yvq ypg ljv
icf: ily itj hnl hze ybb
ifh: hhh hwl lhm
rov: ckq cxg cqp acp aar aja
ifk: hle ysn
yyk: yvb ymz
igc: ivs hbl hob
kle: rgh rsn brf bgo asx aft
ktq: bwb caz cgi cnj ale
kpo: rfd bdc chv
idc: ime hme hoc ylc yql lda
ahh: adw ajb apv azr
kcv: kgw kpu rrw rlr blz cac ayi
hxk: ykv ycr ycp yqc lsm
rbl: bem bfo akq
beg: bev bmg bnu acb ahi ajb
yjq: ytp lbk
ryh: cer cxp cpl cpq
iyu: hzg hqz yak ymw lvy
ydy: lgi
rtl: bgy bug cbw cvd cnj con ace
bjr: ckv ari are ala ajd
iwj: ivk ipi ydj ysn
cft: awk
bln: cwl ayn ape
hbh: hos yku yvo
hlm: hdk hmz
lye: ldm
rwn: cwt csp cov aah alq
kfr: rkc rvq bhq ckk crv aqh
huz: hov ytu yoa yot lgl
kkl: rji bji bvr ccn chk art
iyy: iqw haj hhh hzn hur yhy yyp yus
kjn: kxv kns kto rss blw cxq czy aha ads axd
iot: hdt hpy hpv hpx hfd ymy
ycr: lyj lsn
bsa: caa cin acq asj
rbo: rwv bxd bfp cpe
lga: ljm
klp: kjl rso bxh acz
bit: asl apw
ahz: ayj amt
blk: bjx aci apu
ixj: iup hgv hth yvb yfp yzx lcy lgr lgz
icj: iyd hra yaj yto
hoc: hoo yyj yds lan
hqc: yvd ymb ynq
bwb: bjg buq cyw
bfu: chd cnc cnt cqk aau
btt: cfz axe
lic: lyq
hoo: ydg lyh lvl
ycc: lgw
bmd: bum ccd
rcf: cvo cfo apk
hsx: yko ypn
iby: iak izc iqi ylu yso yep yxr
hzx: ylk yga yda lda
rqx: bcc agx aso
awg: ani
abl: afa
bzy: cqv cto aay awx
yyi: ygd ytz lkj
kdb: bnt boj cxb cmy cfi axh
bvv: caq cws cmx
rzp: rqa bzp cui
czj: aks
kqw: rrr rry rcf rsb bhs bfa
hsb: ykg ycs yxq ymb ynl
hlv: hnc yhi yln yxw yfg
bwc: czp cqk
rte: cyt asn amc
rfi: cuk akh
yol: lan lwi
bmw: bmp cdd cvs aio ant
ykx: llq
kho: kgr rbm cdu cei abz aim aeg
bay: ckz cwq cos coq aau
kss: kpy bka bli btv
hkl: hvw hnm hur yxn yfg yqb
rwq: rfe bit bol ayo
bar: baw cgb cek awf
aue: iif hbo htd yhv yym ysm yuf lgl
ksi: cvx czi adf adq asc
yay: yif lam lvl
ivv: hpv yrn ycw yzp yos yoz lkk lyv lwk
hqg: yvj yms lvc
iao: iwz yxt ypr yzm lwz
hsc: hfv huf yuj
hfs: ykc ypt lca
khy: kjj rce bdt cvm
bef: bup ccv aeh afe
cdj: afy aze
cyw: ayq
lax: lgp lsl
igf: ipb hcv hwz yel yzn
kum: rrj cbw cqn anw
rrk: rwj bvr bnl bqt cqp
rpc: bxp bfu bof cki cyz cwh aca
lwp: lds
yst: lcc lyh
krg: kco rif bub cby aiz aqk
rlg: rse rso crx
izz: iqm ydl ypb yzm yta yoc law
kvq: ktz rvd bix cex
hdq: ypk lid
bab: csu ahz apr
htj: lrw
kub: ryl rlq rnx bdv bfz cgo cdd
hwt: yoe yon llo lsw
cyp: cdl agd
imb: imz ych yzg yqh lai ljw
ikw: ixq hkb hio yjd yxq lhr lgm lsp
row: bbb cls cvl ain
hxl: yhs ygr ymt lll
hjr: htz yqz lid
awq: axv
rnh: rqo bhr bpp btk alw add aja
aon: ial hen yct lww
akh: ajd asv
kks: kzv kqs boy cyh coc aie
yun: lsb
hve: hnh yrh yeh yzw lse
rds: rdz rth bev bpp bna car aki ahy
hrg: hze yct lru
ysq: yew yoc
yxb: lji
ijd: iee imi ims huh ypt yfu yuf
ryv: ryx rdt rol bba bvr cba
bqm: cdv cth aat
kjw: rgv btr civ
ktw: koc rhq bhq
rax: bdw cdp czs asy
ruh: abx awg adk
hnl: ylg llo
igq: hec yin lgc
aqf: idh iqv hrz yly law lvu
hwe: hsa ysi yos
knn: rrq blu crj cif axm
hwd: ybi yec
hgr: hgw yyf yxp yqt
yhc: ypn yqk
ajz: axy
ibn: icp icn ifu hbr yes llw
icq: ier hda hee hmv yto lao
ceq: ahu ang
bum: cin cvq
klq: kjw bvy cef
kqa: rak rms bkh axm aze
ine: hrs hct hlt lrs
lhw: ljt
yww: llp
aqo: iqm hys hwh hus yzw lvj
yco: yvo lwy
hzu: ytg lcw
cjv: cjn cew
lck: lyp llo
lil: lgw
kae: kmc bhj cch aev
yra: yrt lwv
cmk: avs
klc: kwf rjq rzm bex clf cjv
ygu: yfn lvk
iqz: iok hat yao yyj
inb: haj ykm ygh
lkj: lap lgj lje
roo: ckc alw
ljf: lsc
iyc: ili hin hxb yjq ytn
isq: itl hlc yxy
cfm: avp
bzi: cym ake ajm
aow: hgk hgt ygd lrl
hbd: hvb yrn
aok: hiy hzg yfp lhf lsx
bip: cfx ayp
yoe: lbm
bgd: bjr ali
yru: lix lym
ktu: rlm rgs rnn crn amx
cik: azi
kkq: rsc rnj cxv afz
isz: iel hxd yhb lgn
ydz: yqz
cbk: cov akz
yvd: yxp ymz
bag: bem bqx cet
atc: ifl hbf hdi hod yrk yjo lhk
bew: btc cgm
hma: yih yer ypv yot lyw
hrw: hjy yqr lsw
clz: csb cpn
kcz: kpp kzp rtq bhh cre cwr asn
kfs: rld rsb rta rug bby bna asz
rdt: rok bbw
cfv: abo
iio: hac hdn hsu hom yil yze lrc lcp
arp: amt
ylh: yfr yuu ldo
ijo: iox yca ysm yzf yqf
ici: imv hkg hla yrq ywq
keu: rko big bji bui ara ael
ihd: int hrt hch ycf ywx ldw
ixz: itc hic hjn hnq yph
rho: ryn rtd bab bxv ago
rrb: rby ryc bef buz bot chp avr
idn: hgv ygn yfu ldq
ilw: isl imz inh yqr
cxs: coy azc
yuc: yup ljc
bvl: cid czb akz avv
ayf: aqk
rkt: cdj cje ctp
rzj: rzm bhh caw cwa
hor: yeg ypm lwh ldh
rfz: bpr chm cjy cor amo
bac: axj azk
yyv: lis
cws: cdh asn
rdo: ben ais apz
yyy: ysk lcs
rrq: rod bgl cqa ahm agh
hnv: yip yxn
bnx: cee cxw awi
bwr: bfw clf ave anz afl
hrl: hhk hol llz
ybd: ywd yqm
ijh: izz iuw hqf ybj yun lyz
arg: ado amn
ykn: yhy yee
iyd: hhs yal yig yxf
rsu: bkd bol
iia: iho hfw ykl yse yzr
bxt: axb
bkq: bet bfj czx czz
iho: hpu lco lir
bdy: cxk ayb adk
icc: iyg ilx idk iec ixh hwi
cda: cps abz aey axe
rae: rnm bac bei bns cyv cey
hya: hge hvj lkq lyl lse
akz: asp afj azc
imm: huy ych lji
inl: izx hax lkp lgo ldv lvg
ruy: bgb csc ahy aee
aqv: auz iet iqp hry lhq lyb
clo: cdd cvl
yxa: ldd
aaq: aha adq aea
cla: cec cxu
ksr: kuu reo bvz bse bub
inf: hqt htb huu ycu yax ylf yjc
kcf: kdf kmm cib ahk
bus: aax
yud: lcj
kgi: kpt bla crr cut awt apq
rha: rot cpb aje apn
yii: yit lrz
abi: aam
rce: rdq bsu cxr ace
yza: llt
hjj: hek hep yxt
yke: ygh
icn: icf iij ioq hae haz ypv lcv
cnh: ack aaa avi
rvx: brv ccd chl chv aey
hxn: ydu lwn
bcb: bgq akc
auh: imc inx ifw yea llp
rhk: rxq rqk bxn bmc axi amh afq
buo: aet
biu: blf bed cjk
khz: ktx blv ckc cnq ctv abf
brx: bde cwn cvs cpp
bll: cbz cdd cfx aig
klk: rvt rsm blc cki
byi: bso bqj bqo aya amp
ifj: iog hvq hsr hzk lvn
lbd: lbu
yju: yfl yte lgu
bsl: ckg cfs anc
yrm: ycd ydm lgv
cyx: clq anp
lbv: lvg
rez: rql alu axa
rtm: bam chg cfu
rpk: bbk bvl ccn cfk
irg: hhl hgo yhs ywz
hvm: hun ycs llm
kde: ryr rvy bau bws bxl cys aln
ktk: rju rnl cjh cjp csg agd
hjy: yue lkm lcy lvi
rzq: bkr bqd cut cuo
rqw: bav
klw: kzy rue bkc brg bmy bzh cpf
kqp: kta rgz bst cco cym
bst: aii
bns: bqp cms ajr
yzo: yuc lsk
kuy: rxx cwm akx anj
yqa: lra
ade: asy axm
yeu: yxh lha lgo
ieb: iqw hnr ych yxt ldb
kfd: alg adx ave anc
rpg: bdm aag
cnm: awx aeq
bkb: bja cvf cfa cfm
bjh: bmn bfd cmg alc adn
kdg: kzs rmj bwo bsn cwc cql aad
rmg: rfj byg bqy ciz cll cdh cnx
hkx: hii hoi yre ymz yok lwa
cgv: adz afn
ikx: ise hbo htx yqt lah
kgv: rtt cdu ayv axh
kcl: bwv cck clh cxk
cfg: awj
kve: rbd bof cfq cqx apt
hkd: hsy hzi ypm
iyp: igq ijm hsk hfa yru ybb yca yqq
rjk: rtu bik cvy csb acb
ime: izl hzi ylp yjz
byr: ccy ajz asz
aky: ako avv
cwy: cqf
khe: kgs rvl bba byb aih ava
kfc: rzq aar avr aek amv
apv: azt
bbh: beo
isk: ing ift hhb heb yzv
yxp: ymm lhg lli
cdf: cne awv aes amb
bei: cgf cpi abl ase
bam: bji bof aho agn avy apb
rkz: rdl rvq bhj awa
ipj: iml hdo hpb hzz hql ygi liz lsc
ryr: rvq apm
hpi: ybx ynf ljp lse
coh: aby
klg: boe cfe cox awp
kis: bav cjv cfu cta
cds: csp
ywl: yfi lcb lsv
yqe: yoc
avh: amz
rvq: rqz btn cca can cpa ahl
rfa: cwi cpj col aki act
yyj: lgl
isf: hdg hmy hts yen lju
hoi: yjx
yxd: yzu lyw
idx: iuu hbn hdm hjq hmo yaf ymo lwq
rmq: crx ahi aga agy
isv: iuk hyz hvw
rri: ryr rdl rjh rjj coo
yhz: yeg
kyn: kyq bzr buy cjq cvq czo awb ada
ctz: agm
bax: bqw cje csf adr azj
rkk: ryz rpq rmk roo arp
yxu: lrf
bqn: chr aex amr
bny: cgu cja
yzf: lyq
ilu: iej izx hsk hmy ljp
kbh: bsq clg ceb cpf aab
yyn: ydy lse
ayk: add
ygb: ypl
rit: rov cii aiu ast
kvk: kxq kzj rjg bgl bju cdl cxr
krl: kgq kwp rac cmp cmm agz
ijt: hkr hwe ydy laa lwm ldo lse
hki: hyi hth ymw
rzd: rqj crx chn
atl: ibu icv ijd imc ino ifb hda hpb huk yfv yqd lhq llh
rwx: rdw reo bpt ceo
bwk: bjq clm ajm
btr: cbi cvi
hst: lwx lvl
ayr: apc azl
acx: adg amu
hgj: hvt yls ymg
krt: kbk ryx baw bdj
atk: ipt itc hla yba lkc lyd llm lge lsw
bdx: cnv cus
ivt: hrg hwj hfi hut huu yty lrf
hrc: hat hsg
auj: ipm imm haz hfa ykv lvt
iox: hrr hcn
ilo: inb hcg hzo ywy
ahu: aer amx
lhl: lhd
kbl: kal kfl rre rer bpk bfg awq
klv: kgc rpm bry bbw ckd cgo axe anb
yoc: lvf
agk: ajy
bem: cra cvt cml acv aif
hds: hjf ykw yzt lhv lgz
bge: bjo aah awy
cbb: ciy czv
cyj: cmh aba
klh: reo bgg bpg bqd bqz ain
rcc: rxl ruv axa
haf: yhu ywo yeq lrw lim
hdw: hsv yzu lhg lwp
ihl: iuz hiw hjl yln ydk yjz ysa lcw
rhz: rjm reb rqe bsh ake ayp
ruk: ruq bbk cnk cfh cqx
kdp: rkf rjz roq csi
ixa: imv hhb yrg yxo
bed: cdz
hur: lsd
iyg: iys iwy yzm lkm
ysb: ymx yfu lcy
rhf: rgb bfg cjw ceo cmg
ywy: ywt yjr
iyn: ixx ifg yrb yrj yio lwb lsx
rap: rns rqx bwe cgu
ces: cez
cru: cqd awz
ytj: liz
iwv: ieu izr ioe ybb ynt ljf lsy
hbc: hip ywx ynm
hxq: yzk lcs
rvg: bpl apd azn
kfy: bud cir cdm ctg
ciu: cjq akc
rox: bgx
cxo: cmu afx aqi
yvt: yqy yox
hfz: hty ygv yqr lkf lbc las lgg
hmx: hfj yry yan yqu
rpf: cef ake
imp: hpj htv ykw yje yuc liz ljd
igx: iuf hsa yyh yjq
hgt: hfr lvy
bxl: cjq cfz czc
yxy: lgo lvu
auc: ivt inj ioy hfe yrb ybr
ind: itu hhl hho yas
iqu: itr hit ykx yiq ywc lda
rwj: bpj cpq
irr: iyf inw hue ygy
brk: cca cjb csf czw
ykz: yiq
ytd: ytm lrf lls lsl
yao: lbh
bpk: acj axk
kxs: kmc byn bjz aai
aum: ixz imx hov ydh
kjt: rdi bjb cyu adb aeq ang
hcx: yyi
bfv: bzc
ylz: ylt yji yeh lkt lvj
kow: rhv rzd bed bpg bqm akm aap
ill: hix hnr ygb lhg
kuk: bss ciz anm
hli: ykc lga
ral: rau rui rum cjx
kug: ric boc chv cnh
rdd: rfd rqi bdx amx
hts: yie
htu: ybf ydg lgo
kcw: khf kwa kuz rzc bmb bfj cme czj age
khj: kwd bdl cro cec
axa: amq
hay: ykm yxp yxq ype yms
ymf: yqm lal
ybc: yyi
ytv: lcd lis
rqi: cen czq aph
rtz: bqb btj cbi ajr aeu
kbi: kiy rvp rem bih bvx
rby: rjm bnh cht cpg anx
lau: ldp
rvz: rnl cyw aai
cpp: ano
ych: ynx
rdb: rmq ruc bts ckd cqs
kvv: rwg bam bvt cre aqh
yhy: lrh
bfy: bzn cin abo
yyh: yxm lwn ljg
hil: hig hwr hdq hqd huv ywq yti
iln: hji hxt hpz
lij: lsi
heh: ylz lsl
bzk: cgv adr
kxl: rga bwh bqb
lkt: lac
ybt: ldu
ijz: iem ixj imq hou yyc yji
cxe: cqh aej
rly: bbz bfk cnk ctt arc
aot: hrs hlp yda
igm: hfg lhx
ycz: yjw yzy yzl yoq
bbz: bjz cip cui afa
rmv: rfp czn axg aff
cln: ajz hhz
yth: lkq lco
yck: ylb yfw llc lge lgu
khi: kjs rni bji bjf aak
crr: ccg aix
kdw: buk cku agv ajy
kpm: kfq bix cht aje
aqm: idj hze yck ygl yql ldj ldn
yvf: ysh lhl
iin: ivf hpp hzr yae ygg lbx
lbz: lll
rts: bix ccj azc
lwi: lsy
cfe: cul
apg: anl
rao: bgm bve avz
ika: izy izf yon lbl lhl
bzl: buq cik axk
ioh: htf ycu ylf yzl lkb
ahk: amw
ibv: iwp iqe hsj hun ygr lih
abf: avj
ykr: yfp
biz: bpt ccb clm cgd cve
crk: cyd cnv coe
iys: isr ipi iml hvy yvl ypy yoz
lib: llk lvg
lwv: lju
ywf: lab lyh
hdk: hjh ywb yer lgf
hgc: hmg hog yrx yhg lre
cna: apg
ymv: lke
yaa: yaq ydj ydu ypp yfd yfq
yuu: lbg
hcs: hfd ybi yeg yxo lvk
yhk: yjz yvg lic
hex: htk ygl
hsi: hei yrf ylg llm
ibt: igp iwj ixf hze yam liw
cok: amw
ysj: ypz
kvh: kve kfm rtn byu bpw bqw boo aru
kcr: rrh rck cjo ctr aht axw
bpw: bor agf
cqs: coz aac axl
ivr: ygl
ibf: hbg yay yjq ynu lvp
kur: rwb rdc cox ahl ayr
rll: rtn bix clb
ken: rnj bkp bla bls cqx
lar: lhg llz
kvl: rpx bec bff clc czn
kgw: rtl bih bla
kad: bib bvf bur cyw arq acn
yzs: lkv
yak: yzr yqg lkm lif
lyz: lgz lja
apb: azh
bnq: ceu asa
chg: amh
bdk: bdb crb
yyt: yey yzi yzn llg
rbn: rsk bja bsw bzp cke cqm axt
hld: hgo yco ysw ljw
hrn: hcz yjd yza lsx
iru: ibb yys yxb ymr lyu
yus: lcj lgb
kyw: klj bbq bid cmk
ivf: hrm hfc hqq htr
kfw: rml rtn bet bup akg ave aep
bes: cis
ywo: lbf lyy
ior: hsz yrz yjw ytn
req: rud beq
kpl: kfc riy rqf roe chq cxj aib agg aqk
bkv: cpq cft agp
ruw: btt czq
boj: aae alz
roj: bhg ccd alf
cau: ciq cov ase
ygc: ywc ypt
kxm: riz rpp cud avh
iif: iuu hfd yej yep yft
red: rzb ais
aof: igu iwf iuf hhd yjh ytm lvl
hhd: hxb lhu ljq
kiq: rkb bao bjv cfz agj axl
kfl: rbf rgq rul bjc cck aaz
kpv: kts rrz raa rlb rww rqx ady
bwf: cfu akv aav asr
bha: bfl afs
ydw: ljj
afx: azy
hoq: lkl lbx
yqo: lvw lve
cww: cnj avm amb
het: hxa htr lyd
auw: ifn hqn ykf ynp lgv
ksc: kem cgx cwl
bvj: bej cfv ahm ajh apu
ywv: yea ymk lbs lat lvd
bvr: cmo cos axc
hha: hle hwa yin ysv
hwx: ykh ljo lsc
cwr: coa acd
ahb: asz
ihx: ils iva hzq yvc yxh ldt
cpj: azp
ibp: idk ivx hwv yjt yem
ijb: isx lah
rps: bug ckj cbe cxi aae agi aqr
ikr: hfh hfl ykp yiz yds ydn ldg
cmh: adc
kbb: kly kdy kok rbp rwc czf afx
ccf: akw aqr
izn: iqt hkh ygy
cyz: cly cqd ani
boa: cvg cfu avh
kfa: rbw bde cna ase
