bkg: bbb
kqf: kuz riy
klo: kfn kuh rrv
klh: kfz ktz rks
rzq: rur rue rog
kpg: kzk ktl rbb
rvr: brr bbb bbo
rog: brz bbl
kst: kqf ktg rbm
rtu: brm
rzz: rqe
kit: kgs kdf kex
rec: rxj rnv bkq
kko: khv ker kxn kpv
rsc: rnd brf bbt bcp
ruv: bbv
kwk: kdd kmg rki rcw ran
kcj: kal kib ken kxo kov rrm
rlv: rwt rfk bci
rmw: rzf ruq brh
rxv: rmk rfj rtl roq bbr
rjq: rsn rzf ron bkb bbz bcc
kpy: kpz kng kqd koz rca
kzm: kqf riv
kos: rkq rbx rcx
kvb: ksz kte rkm rar
kri: krd kac ktb rcv
rjv: rmz rns rzz rqm bkp
rye: rgd rja reb rql brf
ksk: kmi kqw kot rct
rhv: rsn rps rmg bca
ruu: brs
kim: kjb kee kqy rae
kcv: ksw keq kxt kni knq kty rid
rqj: rtk bky bcc
kqp: ktq
rzi: rtp rtz bch
kif: kdz kei kxh kni knd koa koe rax
bbu: bcp
rpw: rux rou
rip: rdx rnw rtj bkx bcd
kly: kdb kmc rcb
rww: rxx rxu rpl rfe brl brg
bkx: bbz bcd
rdu: rja rsi rei rmf ruv rol brk brn
kzk: rch
rud: bkm
kbg: khj kfg kqp rrn rij
rve: rvp rxi rnf rtr bcy bcl bcj
rlr: rgf rju rnm rqd rtq rup ros
kvv: kxn kfo
kzi: kqq
rqd: rux
kmw: knp rkt rrq riy
rzu: rzo rui rok bbo
ruy: bkb
rju: rng rqi rtc rtd bkc bkj
kbz: kbu kid kim kst kmv kzy koe rcq
rop: brv bbn
kzq: rkn rri
kcu: kan kat rkl
rlp: rlq rvm rxk rmm bbx
kxi: kxx kpz kfo ktk rcy
kze: kui rbs
krz: kaz kwt kno kqv rkn rrz
rvh: rxa rmp rov bro
rlt: rja rns rfv rzy rzz ruw bbs
krb: krd kdm ksh kpq knz rba rac rij
brz: bbq
ktm: rrh rbw
rru: rbx
kys: kla kdw kdp kzl rck rci
rhx: rho rdo rpn rmu rfu ruv brl
bbk: bcb
kai: kgr kgv ktn koi rra
klm: kqx
kew: knl
kug: kol rbh
rgp: rvs rni rup roq bkm
rfx: bkf
rqr: rut brw bcg
kxz: kpz kmm kzy kqp
kog: rbg rcq ruy
rzn: rux bbb bce
rau: ria
rkb: rrf rbw rcg
kmr: kmc kmm kna ktt
kva: kxe ktx rbg
khd: kgm ken kpg rck rih
rhb: rgi rdm rdz rvk rew roa bcx
reb: rqf rob rom
kza: rcy
kpe: kmw knc kfp
kox: rkq
ksu: keu kfa kfh kuq rka rkf
ksg: kzp rba rir
kbq: kyk kjx kui rbx rct
kmp: kzy
rqi: rup bbn bbf
rwd: rwj rvx rvq rew rqj brd
bkk: bcb
rzx: roe
kik: ksi kso kng
khr: klm kgc kgj kxr kpj kpm kue rke ral
rbh: rcv
ksw: kxw ktk rcn
rym: rwr rsd rsz rxk rpi rmn rqr
rfw: rzj bci
ksq: kzh kow rid
rho: rla rsg rxq rnp rfq rob bcr
kpb: knb kqf rki
kbb: kih kiq kvq kpc kmq knz ktw kuy rrg rrs
kby: kck kcv kaf khc khs kho kwt keu kmh kuy rco
rdc: rjk rjn rpp rfm rqn bbf
rrb: rcc rcq rad
rze: ruh rom bch
rhs: rsw rph rmh rql roh roj bkn
kxt: rcz
klj: kwt ksk kss knc knq
klv: kls knr ktn rap
rpz: rms rnc rzt
rln: rjs rzz brt
kiz: kzb kus kup rrd rcj
kla: kwe kqc rbp
ren: rnh rfa rfh rfw rqh bre bbb
kxs: ral rig
rpx: rnk bkq brs
rio: rjw rmh rnw ruy
rfn: rtu
rcu: rar
bcb: bce
kyq: kvg kvd kuz rbd
rfb: rqx rul bbi
rxt: rtv rui rue bkl brj
kua: ral
rdk: rjh rev rok
krt: kbk kce kgf kxv kqk rcp raw
key: kfc kzm rcg rcm
rzh: rzg rte
kjw: kvt keb kpx kmc kzl kos rca
rjo: rnu rqb rqf
kpr: kpp kmr knu kfy rkz
kan: klz ksg ksd kex knw riv
kbw: kpz kqr kuq rbc rag
rnn: rtt
kzl: rrl rcd
khy: kga kvm
rqu: bbg bbq
rsq: rph rfl rqa bbt
kmc: kqg
rgh: rgq rdd rxg rmc bro
koc: rkl rrk rbt ral rag
rdr: rdn rdz rmx rqb roq
rmi: rnq rqh
rrg: rbv
rso: rmy rml rtf rtu ruv
rpr: rqs rtr bbo
rvy: rvx rek rzc bcy
kln: kjp kfr kzx kuv koz rbc rbf
kii: ksf ktd rry
rkm: riw
kti: rii
kfo: kqp kuh kof rag
kdj: kmq kus rcd rcq
kir: kis kve kes kzj
rnx: rnq
kyu: kwb kwe kdo kvw kpw kzl kqj rbr
kmv: kfh rbs
rhz: ryb rlt rmt rqu bkv brt bbl
req: rzs rqa rqd bbu
kak: kps ktt kuo rap raq
kca: kcf kjh ket kfc kfa
rjn: rsk reh rmf rzr
kun: koj rkp rro rat
rfg: bbc bbm bca
rxk: rnm rnq rqr ruv
bbr: bbj bbo
kno: kfp kop kot rbp rid
kvs: kvf ral
rfi: rzv rtm bkf brp bba
kgx: kwz ksx kfg rri rao
raw: rig ris
ryb: ryd rsj rfi bbr
knf: ktp rbo rcc rcm
kjy: kex kun rkf
reg: rej rnw ruj ruv bcp
kbn: khi klb kvw kvf ksd ksj kzy kon
kgk: kdt kse kxm kfn rcg rab rih
ruo: ros rof bcs
rxg: rfq
ktw: rrf
kfx: kub
kks: kae kiq kjk knb kfw rcq
kce: kle kwd kvv kvs kxc kqw rce
kzg: kos rki ril
rqk: roc roh
rgb: rdo rxj rfl bkk bka
kvx: kxs kpg koa rcl
kpd: kpm rbx
kkc: kkq kih kle kpq kzr rii
rhw: rhq rya rwy rmr rmp rfi
khu: kly kum kod rbj rid
kom: rrm rro rbz
rrc: rcr rcp
kah: khy kwv kvg keq
rxe: rpu rtn bbb bbc bby
knb: kov
rte: ruo bke brt bch
ktf: rbr
kkj: ksz kny rkj rks
rtq: brb
kdw: kes kzh kui rbj rig
rob: brh brj
rmo: rni rut rok rom bkl bkd
rvx: rne rfs
rrh: rcw rcn
kxp: kzc rbh
kmk: knk kqb kqn ktc ktj rcw
rhl: rjf rmr bbm bcc
kbk: khz kln kgk kpl rku
kth: ktd kun koe
rzl: rzj rog
rma: rfh rzd rzm rul rof brq bcr
rpg: rqy brt bbg
kea: kxf kpu ktw kor
kqr: rap
rbf: ras
koa: rcw
rxc: rpj rzb ruy ruw bky brk
rrs: rre rco
kmq: rbd
kuj: rkd
kbr: kyx kxc koj rby
kjs: koc rkj
kmx: knn
kvg: kxr kxn
rfz: rzf bbg
ryn: rec rnp ruo
kqu: kqo rkj
rpu: bbb
rnr: rzj brl
kuo: rrl rcp
kwb: kwp kmn kon
kwi: kjx kmd rkt
rht: rlj rgb rzx ruw
kgd: kdg kfw kop rrk rir
kmn: kzi
rmz: rfn brs
rwm: rmr rnw rzk rtx
kci: kyc kgo kjm kpi
kzo: kqb rkw rcz
rgd: rwk rwz rdb rst rpe bba bbu
ryt: rvu reh rfc rfd bri brh
kap: klq kpn kqy kou
rgn: rvj rsb rmk bkc
khv: kdr kxq ktc rri rru rbl
kle: kji kml kur kot kou rkn
kha: kwb kvg kqa rkv rai ram
kyy: kgg kwn kso knb kzm kqx kun rau
khz: kgy kjk kms kfm kzt rra rch rae
kcd: kay kis ksy rbg
roz: bkr bci
kuk: rbr
rmh: rqz rqq rug bki bbd
rmx: rzv bke brz bbn
klb: kdy kem kna kuz rkm rcl
rpq: rnb bcs
rhf: rlp rsf rmb rmg rzr rtl
rfv: bkh bbf
kzp: kqm ktx rch ram
rjl: rvb rqf rqz bra brl
kef: kzq rii
kyz: kvr kva koo rkq
kul: kov rrd
rsb: rot
kfh: kue rrc
rul: ruf rou
rqy: rof
kym: kla kvk kns kzs kti kur kuf rcl
rhn: ryl rvl rsm reu bkr
klq: kgb kgi ksa ket kxo kfn ktm
kyg: kjo kxp kmk kto rbv
rwr: ref rpm bkx
rls: rpz rfx rzg rux
rxd: ruj rog roj bcy bcl
roe: bku
ksp: kel rkq rct
rps: rmo rzx rqi roy bcd
kkf: kra kav kjj kpw kzj kud rcp rau
rdn: ref rez rns
kwa: kfq ktl rby
rsz: rxp rpm rur
rlb: rgg rjf rxr rfz rzl rqm
rzo: bka
rxn: rtb
kyb: kwm kvc kxr rcm rcq
rxy: rpa rpu rql bkf
klf: kwk kec koh
rfh: rfw rov bbp
rkr: ray
kas: khg khn kyf kzt kob rkx rac
kyn: kgp kjc kjt kxa kmo knp ktv kok kod rks
rub: ruw bcx
kgb: kwl kvq ksh kmw rrh ric
rhc: rtf bkf brg bbp
rzt: brg bby
rhp: ryb rsb rzz rus bkb
rwh: rjg rzk ruy brd
rnl: rnm rtx ror
rgm: rwn rdj rsk bkm
rzk: rto bcy
rej: rpv rpu brs bbp
rbx: rbn
brn: bba
kdh: kpi knt rkm rrn
rex: rpc rmu rnt rqp
kvc: kvp kpn kfd kzi ktl
kwf: kdf kzl kqv rbn rij
ruz: bkj
rdx: rea rfn brh bbl
rez: rmm rum bkz
kmt: kzm kqc rcw rcq
rff: rzy rzg rqe rqo
rdh: rja rpb rmp rtr rut ror rob brl
rjj: rxh rfa rqt rur ruf
rda: rde rpj rmy rnj ron roo
kck: kai kyt kmw kny
rsi: rsz rpb rqf bky
kya: klu keb kpn kpq kfd kze kzq
kgp: kwp kdw kmw kut koe rku rko rbb ram
rqz: brr bcw
rhd: rli rly rmj rzi ruv
kyj: kvr kvm rbm
kin: kgo ksw kpp kng kta rax
rmp: rzq rtj rup
kds: kpb knc kza kqn riw
bba: bch
kgc: kjc rrw rbp
kcq: kyv klc kgj kjd kxn rbm
klk: kve ksl kxt kma
khi: ksa kph kfd
rlw: rvs rpw rnx rqy rtv brb bru
rko: ril
rfy: rqb rtf bre
kxj: kmr rbk
kmg: kfx kzh kom rau
kxa: kfe
riz: ryu rgw rmc bkj brb bri
rjb: rvp rey brj bbj bci
rgt: rsk rsn rmv
ryu: rwl rva rsv rqw bcr
rzs: rtk rtp rtq
kkw: kjd kva ksn ken kpu kfk kfs rcu
kkp: kbz kaq kfq rch
kfc: ktj
rsv: rml rmz bkc bre
rts: bkb bkw
kyf: klv kgi kgl kfo
kda: kdf kvv kxa kpq kog rab
koq: rcg
roi: bcv
kmz: ktw rkv
krv: kcm kwz kjn kvj kmk kzx kqk kqr rcs
kdk: kmv raq
reu: rfr rzi brm bru
kbh: khy kgt ksb kew kes
kpc: kmt kzi kzx kqi
kex: kfv rah
khs: kld kgg kjt kqo
kct: kak kaz kjb kxw
kxx: kpk kpo knv kok
rzy: ruk rux bri
kpq: kzr kqo
kqw: rcs
kmm: knm kzq ktc rko
rut: bcj
kwt: knz kqe rcy rcx
rvs: rpe brr
koz: rkl rbg
rvp: bkh bkp
kwd: kdn kjk kmk kfj rrx
rqq: rtg brn
kux: rkw raw
ryh: rld rgc rws rfp brl bbi
rrx: rbn
rwz: ref rxz rpx rfc rud rux rum
rxp: rts rtm
rqh: rqo rtg bck
kdm: kff kqf rar
kba: kbt kci kag kta rkf
rnw: bcr
kcw: kxi kpi kut rkr rbc
rmq: ruv bra brv
run: bkc brr
rsm: rew rna ron bro
rwb: rqd roa bka brv
kro: khi kwf kxr kxh
rxo: rpp rog bkz
kse: kxa rkr
rol: bkj bbu
rds: red ree rxw rpm bbx
rhm: ryx rwh rsa rua
rpm: rou bbx
kfr: kqq koq
klr: kwb kvk ksj kuy
kjh: kvv knw kur
kic: khl ksf kts
krf: kcu klw kqn rcz
rmv: rfm rue ruq rop bbj
kqt: koo rbi rcy
riq: rhh rps brc bca
ryd: rwp rdp rug brf
kpn: kno
rkd: rap
ryy: rdz rpt rmj rzx brs
rty: rtl bkz brq bbi
rvv: rso reu rna rqy rqu brl
kcg: khd kgv kxo kol
rsr: rxm rpy rmn rqn roc roz
knv: kqd rkc rrp rbi rbm
rpj: rmy rzr rtb brx
rmk: rop bky bbg
rac: rat
kek: keb kpf kmy knr rcf
rjf: rmc
kjc: ksd keg kxa knv knm rcw
rmm: ruf
rpl: ruc ruz bbn
rdm: rec rtq brh
rql: bce
rvt: rmj rqp rug row bka
kow: rkm rrr
kre: kbx kde kpd kuu rre
kuu: rik
ksn: kna
rsx: rpi rtb bbs
krp: kil kyc kdf ksi knz ktq rrl rrj
kpt: knk koe
kwv: kwx kdi kej kzj kzo ric
kbm: kin khq kgu kdk kdr kse kpa kuv
kkk: khx klh kga kwe kdc ksv kml kqa kqf kuc rbv
kgo: kmd kqq kuk kob
rsk: rxk rmn bbi bby
rif: rhu rdq rve rsm bko bbt
rsh: bkd bbv bcb
rns: bkp bbh bbz bci
knx: kzd kqe
ryr: rdn rjt rui bkw bby
kjp: kxd kph knr kfl
kfq: rcc
koy: kod rkh rav
kus: raz
ruc: brb
rcd: rab rag
kac: kmn knu koe rbp ray
rqt: brz
rxs: rfo rzw rud bkx
kyo: klh kly kjv knq kzp rks
kjz: ksd kxu kza rkt
kte: kua rbr rbi
kzz: rkq rbf rct rih
rzr: rud rov bbz
ryv: rlk red rxp rom brg brw brv bbv
rke: rch
rxb: rms rtf
kis: kio kdi ksu kxu rbz
kiv: khk kgc kwi kwt keq kpe kmx
rme: rnl rqi rur brd brn
rpy: rmr rol bce
knm: rrd
kpa: knj kzs rao
rem: rqp rqm brf bbx bcp
kdb: kes kmx ktn
khl: kgx kdp kms
kfs: rau
kdo: ktt rkq
kjq: kuj rrw
kdu: kjv kjf kps ktr
kcf: kai kjs rap
rpd: rpm brh bbj bca
kwe: kst kxq rbr rid
kar: klu kqy rbk
roq: brb
rsy: rsl rfv rqt
ksh: kuz rcb ris
kaa: kau kyx kpn rko
kpw: kqz rbe
rox: bke brn
rhk: rhr reo rmj rzw rqd ruk rov bkz
rjy: rvd rvp rec rum bkh
kmf: kue rcc
ktj: ktp rck
kgn: kpu knt kta rrh rae
kqs: rkf
bbg: bbu bcb
kjt: kvo rak
klw: ktd kuy rbc
kzt: rke
rdl: rjz rem bbs bbt
rfs: brb
reo: rpv rnf bkn bkt
rxf: rnn rza rod bkp bri
kcr: kav kam kih khh kla kzh kof
rbe: rav
rjc: rjx rpv rpp rfy rqe
kjg: kjj kpn kfl kog rct ris
khf: kyj kdl kxb kxf kzi kta rmt
rgf: rju rvi rel rmt rol
kay: kgi kwx kjc knr kzm rbk rbn rce
kab: kly kwt kje kpm kpo
rkw: rrt rcr
rml: rzf bkn bri bbx
kru: kff kzc kur kog koj kom rkv
rlk: rgm rse rpd rft brh
kfj: kta
rwf: rxx rnd rft rtd rto bba bby bcc
rlm: rlq rvi rpz rpt
kgi: rke
kuw: koj
rli: rev rpt rqs brm
kgf: kws kxc kpt
rqx: rtx roh
kmo: kff kzx ktg kur
kwy: kqb rad
kaf: kna kfa kof raa
rhu: rpx rfx rql bbg bbd
rxl: rmq rmo rzi ros
kmy: kuw rat
kbs: kiv kfp rko rro rik
rmb: rny rzl rqu brc
kfg: rki rrt
knu: kfq kta kum
klx: kwl kev kmz kqc
rwq: rdv ree rtp bck
kix: khp kwq ksj kfs rbx
rfc: rfy
rss: rnl rzk rqc bku
rel: reg res rpj rno
kyc: kyv kvi kpt rrt
ksi: kme rkl
kqi: kuy rbd rcv
kij: kde kpx kmp kzv kqm ktv
klp: kvi
rsp: rpn bre
rdt: rjw rfq rzd rzp rqv rou
rjp: rph rpq rza rzo rti rts bkl
roo: bkv
kdr: kvz kmq kzo rrz
rvw: rpo rqn rtp roh
kjn: kum kod rru
kok: rkc rrc ram ric
kcz: kat kye kdy kja kjx ksv kpj kmk
rgj: rwg ret rna
rft: rza
rwt: rdf rxi rpp rzr rqa rof
kae: kim kpv kpx ktq kum ris
rnd: rqz
kls: kjk knd
kkq: kri krm kdi kja kef kxb kob kos
kax: kyo kdh kts rrt raz
rmu: rfr rzw
rnq: ruy
rnc: bko bby
ken: ktf
kns: kts kuz kog
kni: kqy kux rbq
rhg: rso rxg rpt rqa
rvu: reh rnu rfc rok brp
kfa: kzx kom rrr rbn
ksv: kna kof raf
kvf: ktl kod rcf
kyp: klf klz kpq kng rkw rkx
kbl: klo kep ktv kuy rce
rlh: rwt rdy rji rsa rzi
kfn: kos rrr
khq: kep kxq rkm
ryf: rmj rff rft rzn rub
rdi: rvg rfb rfe rze rzz rzo bre
kvw: kpz kow rco
kff: rrl
rdf: rts bki bkm brk bcc
rzb: bkl bck
rqm: bcg
keg: kub koc rkl
kol: rik
kwj: kjj kpk kmn ral
rjm: rvf rxp rug bcj
kuz: rre rau riv
rgq: rdz rsb bkh
rsn: rui rux bbi
ksc: kfe kfo raj
klt: kwe kew knx kox rbe
kyd: kgs kdz ksw kmz kfi kfh ktq
rwa: rwo rue rum brt
kkr: kkv kcs kct kdi kms knj kqg kua
kpm: rbw
rtc: rua bbn
kvh: kvd kei kzu
rak: raf
kgj: kef kqc
rsf: rey rxh ruw
kjk: kzb ktc kup rkj
kfi: rce raq ric
rkk: rap
kyi: ker rki rku rah rad raf
rzg: ruy rov
rok: roa
rgk: rev rxs rnp rox
rxu: rqu bkv bbf
kxn: kxq kzp koe rcc rib
kra: klw kwx kpw kft
kkt: kdx kfk kuv ray
ryx: rgp rwg rxk rxm rfc run bkd
rsl: rsd rfl brk
kss: kxf
kvp: rcx ram
kme: ktj rib ris
rle: rwb rtk ruy ruj roz
ref: rez rxw rpk rpl rur
koh: rkk
kpp: kne rke
brl: brp
kdv: kmr kmb kzs kzf raj
rix: rgt rdg rdn rsa rqe bkv
kig: kdf kdo kjg kxb kpo rkl rco
rjg: rjv rsk rsm rfg ruu roz bbj
kvu: kfe kqq kok
rew: roz bbm
kql: kux rko
roj: ron bky bbb
kdf: kjv kza
krj: kal kjq kvf kek knf kqn rij
kee: kpe kzn rrb
krl: kam kla kpp kqt kui
kie: kin kgi kwt kxk
rqb: rut
knj: kfu ktl kum
kqv: kuh rkm rbb
rlz: rgj rwl rjn rex rfk rfp rqv bcp
ryq: rzm rtq roi brc
bkh: brk
bkn: bcg
roh: brr
khx: kvx kxo kqy kor rrk
kfm: kzx kqj rkm rbv
rjk: rjd rsh bce
rwg: rdk rjh rqs bbt bcw
rpv: bki bkt bbq
rzd: bkn brg
rpt: rza roa brf bcs
khj: rch rcj rak
kbu: kao kle kfr kzz koj rrz
kpk: kmr
rxq: rff rzn rqk rqf rov
rtr: roi bbk
roc: bkf
rga: rjh rfv rzf bre
rsd: rmj rnh ruw roi roy bch
kzb: rrs
kxg: kne kft kqa kok kou rbz
kbx: kcs kik kzd rbb ras raq
kad: kap khi kln kss ket kmu kze kod rab
rqa: rqq rol
kja: ksn kmz kqy kud koh rko rro ric
kyx: kxw rkh rkt rrq rby rcf
rcq: rih
ruq: bbr
rbu: rch rcl
ktv: rkq rrh ril
ret: roh bkv brf
kvj: kqk ktm kud rck
rva: rpx rny rtn bru bcx
rly: rdr rdp rol bbp bcy
knr: kqf
kwm: kdn ksm kzh
rur: bki bkv
kml: kqm kov
kbv: kca kwj ksc kfd kuu rkk rby rcg
rdd: rjl rew rnt rzr rzn brx bbl
kag: kdr kju knt ktk rbt
kqe: rbp
rgy: rgn rvj rfh rzi rzu ros
khw: ksu kpj kfj kof
kia: klg ksp kpw kfx kty
rgi: rgz ret rfq rtd brn
rbi: ran
kge: ksa kpa kph kmm kzh kqw
rlc: rlz rfg rqm rom
ked: kmx
ktr: rak ras
rug: bro
rwo: rjt rxh rpu
rhi: rgp rgq rxo rnn rfi rfs rfe bke
rre: rbq
ksm: kqj ktl
kqx: kul rrh rci
krg: kiz klp kvc kqw kux koo rce
kfv: kun rcb rae
krm: kit kwc kmh kup kol rik
knk: kfe kuk rbf rcd
kwr: kwd ksb keq kzc rby
rgx: rmz rnb rfn rzx rtp bcl
khg: kju kqz rcq
ktz: kop raf
kdl: kvz kmf rkf
kgs: ktt rkt
ryg: rlg rgs rpd rpp rff
kqj: rrj rrt
rrw: rbe
rtm: bkm bbu
rvg: rnx rnt rzf rux bbm
rwu: rfk rfv rta bky bru
rha: rys rll rjt rfr rty
knd: kff koi rae
red: res rfa rzt bkq
kat: kii kie klz kgq kwo ksk ked
rlx: rjp rev rnn rqf row bbv
rtt: roi bby
klu: kgq kvl ksq kni
rhy: rwa rjm rpl rpj
khm: kdn kxw kfe kuh rka
kcx: kad kvc kph kpu
ryp: rjo rvx rzb rup
rpi: rmj bri bcx
rxz: rny bkc
brw: bro
rzc: roo
rfr: rqh rqu run
keq: kqe kuc kod
kju: kei
kwo: kxe rrj rck
kgl: kjt knk rbs
rcn: raq
rnh: rfd rtu ruk roe bkw
row: bkn
rjx: rxr rpc rmd rnr bcy
kez: kpy kps kqu rcc
krx: kya kxj kpq kzc rkz rbq
kbf: kdx kvd kmr kfz kql
kvi: ksk kmw rbq
rxr: rpa rzv brq bbq
kbp: kcy kfu kqg ktk rkp
rfd: rqv rtl
kwz: rkw
rth: rtq roo bri bro
ryo: rjw rsr rpr rze rtg bkc
kyl: kwr kpz rkj rrc rry rce rcp raj
kzd: kux rai
khe: kwy kmd rcd
rrd: rrs ral
kud: rkd
bkr: bkm brr bba
rtl: roj
rxi: bcv
rgg: rey rxy rmk
rqe: ruy
kcn: kha khw kll kdm kvr ksm rkb rrw rcz riy
rtz: bbk
kso: kpj kzs koy
rrq: rcz
kkx: kbw kaz kzf kux
kcs: kjj kjs kej rrg rcj
kps: kzm kqb rkk rky rks
kdx: kjp kfe kuf riv
kfw: kff rib
ree: rfl rzp rzu ruz brl
kaq: kgo
klc: kps knl rkm
rsw: rpx rur bbv
kdd: kpj kpx knr kzg rrf
rtb: rtw
kmj: knk knu kfs ktp rkc
kaz: kdg kml
ktg: kou rkc
rwj: rwn rmg rfs rtn roe brc
rlj: rdw rvx ruk roi
rei: rxz rnk rod bca
rep: rfa rfx rtk ruc
kec: kfh koq rrm raw
ksj: kxx kxt kfi rci
kcm: kdn kjm ksu
rlf: rjr rpq rnz rqq rta ruh bcb
rna: rtw rum ror brl
kpf: kzm kqs kth rri rcr
rdb: rvz
kjv: kex kfd koc
rek: rpe bkh
rgs: rxy rmp rto bko
rgz: rsw rmz rue bkf
kjx: kvs ksf kee rkx
rti: rts bbz
krq: kbi kvk kfy rcd
kvm: keh kej rkt rru
ryw: rln rwy rvz rsw rxd rno rzc rqj
kod: rkg
rhe: rdb rvl rem rfr rfj rqh rto
rpc: rzb rtz bkz bbh
kxq: rca rai rii
kku: kar kyg kdh kxr kmc kmu ktb rci rad rik
rmc: rnc rfy rtg brw
rnm: rut
kgz: kjd kzt kqw kuy rcd
rkh: rrp rbg
kry: kiw kyk kym kxd knv kqk rad
kwx: kde kxf kfa kzb
rgo: rdj rxd rxf rxo rzj bbw
rua: rom bkx bko
kkv: kct kcu kgf ksc kma kfq kqw
rct: rad
rws: rda rse rmg rqn bbr
kil: kyp klt kdt kev knz
kxl: kfx kon rrp
kzr: ktj kox rrv
kwq: kei key rao
kaw: kva ksb kzr rbo rcx rak rir
rqw: rub bbd bbm
rkc: rbh
riu: rlm rdb rdz rvc rqo rui
rtg: bks
kfb: kuk kui kut rbf
rkf: rao
kyh: kjk kvq knx rrp
rkz: rkq rid
kxw: kxq kzk kuv rcd
kel: kml knk kfs kum rar
rwl: rvk ree
bkm: bcw
kuf: rkd
bbc: bbl
ryz: rzv rqj rta bcg
rfe: rtz ruu bbt
kot: rko
rim: rhn ryn rgl rwm rds rjo rsi rfi bbz
kje: ktr
rdw: rvd rem rnb rfc bry bcd
ryc: rvr rql rqf rtk bbl
kts: rku rrl rbf
rgv: rdo rxs rtk rtc rta
khn: kla kdr kty
kiq: ksx rkk
rhj: rfv rft rze bki bku
rbs: rat
kpx: rke rbq riv
rtf: brq
rev: rxa rfz rtt bks bko
kmh: rry
rxj: rfv rqb rqt ron
rqo: rtu
rki: rbc
rvl: ret rmi rmg rtt rup brx
ruf: bkt brr brp
kgm: kjg knh ktf
rnk: ruw bkc
kmu: kzf rkj rbw raz
kli: kwx kde ksy ktl
klz: kso kxl rrk ria
rpp: rmh rqc
knw: kqr kub
kjd: ktb rbz rij
kej: knf ktr rrb
kmb: kfz kox
rsa: rel
kqc: ray
kvo: kxp ktg rcf
rtj: bbc
rah: riw
kdg: kfn ktv raz
kqq: rkr rct ric rig
kpu: kmo kze rcn
rrp: rbi
bke: bbd
kvk: kmc kth koj
rdo: rfj bkd brp
kib: kic kfq ktt
kgw: kxy kmn kzf ktj kua rbv
kid: kjr kec kfg
kwc: kfw kum rky ral
kjl: kfg ktx rro ric
kty: ktg rbw
knh: kub rro rbt
kjr: kje knm rbl rbq raa
kdi: ktq
rtp: rop bbp
kxf: kpv kpn koa
rou: bkb bbk
kna: kua kut riw
rqc: ruy rox
rwx: rjb rmy rqi roi bkk
kur: kuw rcl
rer: rew rev rqf bbg
kyr: kds kdn kjm kvc kza kzg kzo kti koi rkl rcz
rpk: rpz rzi bkk
rnf: rfg ruc bcg
brv: bca
kvl: ktt rkb rby ril
rgl: rmp bcj
roy: bbz
kkd: kgm kxr kxy kqh rka rbc rbd
rlo: rde rpp rua bbv
kcc: ksq kxu ktt rbh ris
rms: rtz brm
kbo: kcv kab khk klt kpv
ktd: rbi ras
kwl: kex rkp
kny: kqu kol koq rac
brt: bbi bbt
keh: kph ktm kui rbd
kwh: kjf ksx keo kqn rag ria
rje: rsj rsq rpl rzz rqj rtm rtn
rde: rmj rzb rqx rux
bki: bce
ksa: ktr kon
krc: kgv ksb kxv kod rrt
kgy: kdl kjd knz kze rbi rig rid
kor: kog kov rrn
kdt: ksx knh koh
rup: rod
kyw: kdi kpp kpn kuj rry rcm
kkn: kvz kvq kfb kqz rcc
kms: kqz rcj
keo: kmp kzy kuu rco
rey: rpg rmw rqm
kqd: kta ktw rce ran rij
rof: brc brd
kip: kly kdo kee raj rik
rya: ryw rgg rjo rpg rfx rzy rqy bry
bku: brz bbp
kih: kll kfy kua
kvt: kez kxs kpk
keu: ktc rka
rsu: rxq rnj rqr bcr bce
rvm: rxb rxi rfa rqk rtf bks
kzv: kqo ktm rcc
kxy: kmz kzo kts koo rcr
kxr: kqv rkq rrl rbh
kau: kwq ket
rnp: rzk rou
kxe: kfg kqs kub
rno: rtf bbq bcv
krh: ksw kxp kzl kzt rax
kga: kdc kxq rbx rak ray
bkw: bra bbj
ryj: rwa rxr rmz rng rfp roo
kvr: kvx kxf kpd kmp rcm
kgt: kgu ksh kfq kuv
brs: bce
res: req rtw brc brm bcj
kpi: kpd kpp knu kfh kqc rad
ruh: bbs
kdn: kfy kzy kqy ktb kui
krr: khd kgm kwa ksb kfp ktx rbo rak
rdp: rej rpr rpi rmv rqv bkz
rfo: rqp bro bbl bcc
rfa: rqe brb
rng: bbd
kcp: kys klk kme kqr rcr
kqh: koe kof koq
bry: bbc bbm
rqs: rup bcx
kfu: kqx kol kom
kdc: knm kfc kfl rkg rap ris
kxm: kzk kzo kod
koj: rrb
rfl: bbr
rkl: ral
rny: rta rtn bcx
rwe: rjs rsw rss rxu bkg bbo
rgu: rje rfl rqt rup
ksb: kei kzn
bra: bbr
kho: kxw rbl rbt
rfj: ruw roj
koo: rck rcn
kwn: kxp rbe ria
rja: rto brg bck
kzj: kuq
rse: rmc bbh bbe bca
kka: kwi kdh kzo ria
kww: kjy kfq kfo kzp ktx
rcb: rag
rvd: brn bbe bcj bcv
rdg: rxe rfe rqk rum
rza: bkd bkq
kxu: kfi
ktn: rbt
kmd: kud rrk rcd
rhq: rll rdd rvm
kqb: rcg ran
ktc: kul kux
rmj: ruj
khp: ktm rcf
rtk: rtb bce
kgq: kwn ktw kto rib
ktp: rky raz
rit: rlh rdr rjx rnh
rfp: rze rtd brx bbc
bkj: bbe
reh: rmv rff rfo
khc: khv kss kxv kzf riv
kvq: rrj
kht: klg kgr kvb kph kmi rcp
kgr: kdv kxd kpk
rkt: rbk rch
kiu: kjv knv kzd kqf
rla: rlo ree rnt rtw rud
rba: rbp
rwn: rja rxh rxn rzc rqf rtn
rdv: rsb rpw rfo roc bcw
kep: kpg kpo kmf kth rku
rfq: rfu rzx rul bkk
kbc: kys kvb kti rik
kkb: kgi ksn keb knb rru
ksf: kxh kqv koh rce
rmf: rnv ruj bkz brz brt bby bbe
rbk: rce
rvn: rtx roo bkg bks
kal: klp kxl kxq kuw koa
rwy: rxr rmm
kio: kjm kvp kvu kuf rkx raa
khh: khn kjp kew rky rbx
kem: kzw rkh rch
kne: kzk rko rbt
kdz: kxg kmy kom rkp
rxa: rxx rmj bkw bre bbf
kkh: kyg kxe knf kqa kqh kup
krk: krt kdr kdb kjl kug
kma: kfu
knl: kfa kop rwu
kkg: kyv kgb kdi kdy kdg kdf
kgg: kgj kwa kmr kus
kqm: ktp
kpl: kfo kth rry rcx
rfu: bra
rku: rrg rrx
rsg: rnq ruh rok brs
ksl: keq kpo rrk rco
ktu: rky rrr rrx
kxc: kpy knd kfy rah
kfp: rkh rbj raa
rxh: rnr rfy rzu rqh
kll: kjx kqn ktg ray
ksx: kfz koq
kch: kha kwy kwj kvk kuh kuf riv
rhr: rjf rpw rtz rov
kub: rbn rbu rcp
kjb: kst ken kxj kte ktf kua
khb: kdr kpy kqg ktt rrn
kye: kst kzw rkn rku rib
kzc: kox rrn
rst: rxr rxl rmi rmj rnl rnj
rgw: rfr rum bkl bbm bcx
ran: raz
rmy: run
rrm: rbd
rpa: rmp rzf bkb bkf
ket: kmq rks
kji: ksa kxu kqe
kkz: kcw kau kii klb kdr kpp kqo
rvz: rqx bcs
kam: kjr ksy kpw kfz
rlg: rlz rsy rpn roy
rrl: rav
kbt: kwz kja kti rro
rdz: rmw
rbc: rbu rcf
kgu: kdu kvp knl kti kte
kvd: ksq kmj riy
kgh: knw kft rbc rbd rcd
rnu: rqw rqx rqz
rsj: rsp rmm rng rtg rou bkh
knt: kty
kco: khv kpz kmf kqh kok
ryi: rdq rdo res rpk
rjw: rek rna
ktt: kot
rwv: rjz rmx rzz brz bcp
rjs: rvu rpk rqq rtd bkr
rqg: rqs rue bba bbg bcj
rvq: rsp rxd rpa rne
kzu: kqx kux rbi rcs
rin: rgl rnb rqm rtc bkj
rra: ria
rlq: rxw rza rti bcv
kcb: khe kwn kds kje kpm knb kng kzz kqs rki
kyk: kgx kve kfn kqu rrz
kei: knz kuu
kcl: kcn kco kix klm kjt keh kpy kng kzs
kbd: kvh kql kqx rrz rat
rbo: ris
rpe: brq
khk: kvb rak
kft: kto rrh
ror: rof brs bcl
rjr: ruk ruj bka
rwc: rds rfz rzs rzu run brf
rmd: rzd rub roh bra bce
ktx: rai
kdp: knj kqj rrq
kut: kos kot
kde: ksi kxq
rji: rjm rsf rtd ruq
rni: rnt rzy rum
kav: kwg keo kug rck
kdy: kvy kfw rci
rnz: rzm rtx rop bkr bri
rus: ruu rox bbw
kke: kra kgc ksc kqu kuy rra
kao: kia kgb kxk
kky: kgz kpc koy rcb
rwi: rsc rmr rfr ruo bcr
klg: klp knc kuq rrr rcv
kxh: knc
rtv: rul bcj
kiw: klz kwm kmx kfj rck rai
kjo: keq kuq rbl
kto: rbu
kwp: kwm ked ktc ktg rbx
kxv: kpe kzw rkp rih
rdy: rpc rzk rzy rtn ruh brm bbh
kdq: kej kmk rkv rbz rcb rcs
kjf: kqj ktd ktu
krn: kls klm ked ktx kug rct rii
kxk: knq kuc koz rih
kyt: klv klo kwu kps
rlu: rgf rdr rjw rvk rex rxe rpi rtc brq
rjh: rvt rfp bru
knp: kfi rak
bky: bcj
rbg: rbj rcv rax
kqz: rae
rui: roe rot
rne: rzp bkw
ksr: kzq kti kos rat
rvk: rez rzm bkx brr bbw
kvz: kep kpz rkf rbv rcx rcf
kkl: kad knv knq rkg rkp
bkq: brp
brj: brm
rzj: rqg
kuq: kuu rrs rbw rca
rvj: rsr rsx rxb rzo rus bcg
kiy: kgh kqb kut rcl
kfk: kov rkn rrp
rvb: rsb rew rnd rfx rzu rqr
rjz: rxi rnf rof
kxb: kov rrq rbz
rgr: rdj rvc rpq brq bbx bcd
kjj: ksx kmh knt
rvf: rsf rng bcv
kbe: kvz kxu kqq rkj
kzn: kqs kuf
kzw: koa rrv
kes: kzd kob rkk rkg rbt
rvc: rvi rvo rsh rxg rfj
kui: rch
kkm: khy kss kfo kof rig
rkj: rkx
rxx: rfu bkg brq
rzp: rqi rov bcd
kvy: keg kpg knx
kki: kbn khp kdi kvw kxq rkj rkf rcu
kgv: kvh kvv kzy
rvi: rvn rek rpi rfz brv
ktl: rrm
rge: rdz rjm rjn rvv rnj brq
rtd: bch
rxm: rxn rfr rzu rtz ruj brj
rot: bru bbi
brp: bch
rqv: run
knc: ktu rba rbn rce rcn
rdj: rdp rmg rtc bkt brq
rjd: rvh ruw ruz row roz bkh bcb
rll: rlm rwj rvv rtj bce
rmr: rnx rff roq
kuh: rrr
kev: kma kzd rrt rah
rzw: rtb
ksd: kxe rrw
rjt: rsk rpr rpv brd bce
rie: rht rwf rvb reo rxc rxg rxo rnn ruj ruq bkl bks bri brl
rvo: rxb rnq rog
krd: kaq kek knl ktq kue rky rrz rco
kfl: rrw rci
kfz: kzu kqc rrg rck
kwu: kpi kzd koi
kqy: rir
rod: bbt
rph: rfj
krw: kis kgr kfn kuj
rfm: rqi bkr bkl bkn
rys: rgh rwj rme rff rot
kbi: kha kyv kgs kgu kdp kuc kuo rcj
kuc: kud kux rid
rgc: rfm rqa rof
kue: raf
krs: kav khs kju kzw rrf rcu
rpo: rff rqd roq bca
kxd: kot rbb rar
kqk: rkt rci
knn: ktt koe
rpn: rnh bcb
rpb: rpv rnv rtw ruh
rdq: rnv rnn rfg rtc bre bbp
kjm: kvu kpa
ryk: rgg rzx bkn brf bca
rar: rav
rwk: rws reb rtb bkx bbh
kbj: kdk ksu kti rcs
ksz: keh kmb ktc koy rrd
kws: kxz koh rkm rrn rih
rmt: rqg bkd
ryl: ryg rlv rwp rfs brw
kzy: rrb
ker: rap
rwp: rvr rxn rzh rqv rup brf
rpf: rzl rzv rti bkl bby
rry: rcl ran
rld: rqj ruw brp
kve: ker knt rkx
rxw: rzh rqp bki brt
kmi: kmn ktd
kop: rrv raj
kaj: kli kwt kxs kmx kqy ktz rkp
bks: bra
rmn: rtu
rea: rxl rfc ruc
kwg: kpd knf rkv rcc
rhh: ryi rjv rsv rpk rnz bcc
kvn: kxn kpr kmi ktl rrs rru rbc rax
ksy: kpn koh
kld: klt kjq kvg ksb kne
kcy: kaq kwq kdp knw knn
kxo: kpw kfi kzk rkh
rfk: rzr rzb ruz bbw
