al: ir
bl: cx ak aa ax
hm: lk li ga gz
rq: ci cl ce cx ax
ah: iw
yq: gj
kx: bs ce aa av id
cb: cn il
lc: ld gm gn
lo: gl
cy: cx ar iv
at: ik
kz: kt ko bb bs ce
rp: cs cm cn al ik
ai: id
bw: bo ca cj al id
hv: hf hu ya yo lq gk gd
bn: ig
yt: ll ls
cd: ay iw
ys: ye yu yo lp gv
lv: gi gy
ip: ha yh gc gs
ro: bg ci cu aj iw
ch: co aq au
yn: lk lb gl ge
ax: ih
be: cn aq iv
gr: ga gm
kk: kc rl cd cs cz ar ig
gc: gv
lx: gf
bq: cr il ij
ha: yu la ly ls lx lm lo gd
rv: rm bi bu cj ap at ii iw
lk: lv lf gg
yu: yo
ll: gw
lg: ld lt gp gf
hk: ya lp lz gj
km: kq ci cg ce
io: hy la gr gc gw gp gn
hb: hh hl yq ga gy
ks: kx kf ku rz ag
yf: yz lj gh gw
hc: yl lk li lj gl
iq: hj he yl ld gs gm
ab: ay az
hf: yi ym lr lh gv gm
aa: af
yg: yq gk
yx: lk lv gb ge gz
cg: ai ik ii
ly: gz
lp: gk
az: ic ii
cz: aj
kb: kw rk bu iv
iu: hk hc yk yr ya yh ye
hr: ho yc ld
hg: yc yw lb li lg gr gg gs gp
cj: co
rm: ca cw ii ih
an: at
ih: yp
yi: yy ys
ho: ys yp yt
lr: lb
hp: yr yg yn yu lp gv
bh: ag aj ii
ad: ia id
cr: ca cs ao is
kr: ki rs rm ac ah ae ik ia ih
ga: gd
yb: yj yf lh gv gz
li: ls
ls: gj
bc: bo cb cc cg ar ae ia is
hu: yw yt ly lp gb gs gm
rh: cj ag aq ib
rs: cu ay ae
kc: ka ry bs be bx cs
kp: kq rj cv cu ao ic
ca: ak ap
cp: at ih is
gk: gx
co: az ir
ku: rc rx bz cq ig
kd: kx ku rk bv cl
ya: lk la gy gw
rx: bd
bi: bw cb cz aq
aw: ad
br: bp cj ak aj
it: hr hx yg ln lt gl
ie: im iu yh yd ym yz lh lw lu gv gx
bg: cr ab ax
bd: cz ar ah ag au
hi: hf yi lp lm gr
bk: bd be bm cr ap ic
ba: bh bm bn bt co
kq: rk bu ah af
hh: hy yp lr le
cu: ia ih
yo: ls lu gz
bf: bq ca cs an az ij
bp: bm cb
re: rf ai ao ib
hq: ho yr yy yj gx
ka: ko bz cl ct au
hs: yl yt ga ge gp gn
cx: ii iv
gh: gn
ao: is
bx: ab aw
yk: yt lr
gb: gv gf
ix: hz yk yi gr gh
bt: ar as am
kg: kq bh ai ib is
kj: rk bk ch cg
rj: bh cv cz
yc: yg ys yp lr lx gd
au: iy
bz: bt ac ig
kn: rd bs be bn cf ap at au id
ic: ij
cl: cf av
cw: cu af
yv: yq lh lz
bj: bf aa aw ad ib
ap: iy
ct: cu ih
yr: ll gf
ck: cz ab ib
gg: gv
lw: lp gp
kh: rl cr aw ax
ae: az at iw
la: lu gg gn
hl: yu lh ld
rz: bo ck ig ij
rc: cv ad aq ib iv
ye: gc gn
hw: hv yv yx li lg lt gf
le: lz lq gp
rt: bh ce cf
yy: yo lk lj
bs: ci cl cd ar af
rr: ri rw rm ch cx aj
lq: lt ga ge
ko: ci ch cj cv cz ab ai av
he: yw yx yq lo
hd: hx lk ll le lq lo gs
ke: ry cc ca aq
lm: lu
hy: yk ll ld gi ge
rb: ry cc cw ai
yl: lm gx gm
ac: ag aw
in: yd yp yn gn
ri: ba bh bu cg al au
ky: kj by ae ik
im: if hp hn yc yu
ra: ri rn bv ca ig
ce: ct ac aw am
rk: rt ck ci cf cq
kt: rb rd cx ir hk
ht: yz lb lj lm
rw: bz cn co aw ir
ia: id
hj: yn yu gs
iz: yf yz lw lz gr
bv: cc cp
cf: iy il
yd: yv lx gv
cc: ay aj ik
rd: rj bp bu
ci: an iw is
cv: af at
lf: gc gg
lh: ln gp
yw: yd yf yo lv lp lz gi gh
lj: ln gw gz
bo: ck
ki: kq bt cl cw cq
kv: rx ru bs cj cp co az ir lg
rg: rz bx as aq
iy: iv
yj: yo lc gh gv
cq: ay af ib ig
ln: gj gv
ru: cj cu aw
cm: ab av an az iv
ry: bw bs bf cy ae ig
rf: rq br bb bv bn
rl: ba be cy cu ag aq ir
aq: ic
as: am il ij
yp: yq gn
bm: cw
bb: cv ah ae
ar: ig
ak: ac
ym: yz lf
yz: gy gv
kl: bn bq cg cm ad au ao ia ig
gw: gs gx
rn: rf rz bo at
hz: ht yb yv lv lz
if: ys ga gi
hx: yb yn yq ll lz gk
by: bs bp cy ih
hn: hu ls le gx
yh: yj yf yz li ly ln lf
gy: gf
kf: rk rx bc am
bu: co ic
kw: ca ag ik ii
