kkc: kwa rbu rcj rar riu rlk
kzu: ktl kof rbq rvu
kyw: kwv kpy kff rhj rgl
khk: klh kmq rby rbe rvf rso
ryv: ryn rlf
bpu: bmr bzg bum
ruo: bha bhp bdd bjr btx
kef: rcg rdm
bhk: bhm bwd bff box
kij: kxv kpe kmz rjo
rcl: raj rsn rxy
ryo: rvp
kwq: rie rhl
rgc: rjv rvk
rfy: rtz bkd brq bar bwc bdd bpo bfn bql btt
bpl: bpt bzm bqv
klg: koz rbh rbv ryz rgy rsn
klm: keq kfo rby rwt
kqb: rkf rcc rcy rwe
kgp: kvv kma ktd kuq rwp
kdh: kvf kpm kzs rag rih rpy
bde: bns bqb buf
rgw: rdt
kpy: rhe rvq rmy
ktx: ktf rbi rcm
bxh: bxp bme btn buq bok
kvd: ksm rac rpm
bwm: bvh bzw bqc bug
rri: rrn ryq rlc
kvm: kxp rbg rsm
bek: bxg bzu bot
kdo: kvv kew rcv
rlt: rdh rdn rjb
bre: bdc bsp bph bfg bup
bne: bnn bzm bqn
bhy: bwx bpa bux
kcm: ksy kpf kfo kuh kov koe
rob: bbr bbc
bjh: bxn bnq bza
rog: bhv bul cke
bwv: bdt bvk ckl
kmj: kzw rwa rjs rju
rtd: blg bgi bju bvg
bfd: bqg ckj
rhv: rwk
bno: bzi
kpv: kqn ktl rsm
bjf: bmk bft bop
bsn: bet bxs bzt ckm
kfc: rbd rez
ket: kqk raq rij
rkb: rrc rcy rvi
big: byf bdn bfr
rrm: rck rye rvr rpc
rmn: rzf rqn ron bhe buu
riy: rmh
kst: kfa kua raq rpj
kxl: rcm rdt
ryw: rdr rxt rmk
bkq: bcw blw bwh ckl
ksz: rkc ryh ryu rsq
bmd: bqo ckw
biw: bdu
kzj: kuc ryt rdt rvu rsz
beg: bfh btn
rvd: rpk
klh: rhc rwd rdj
ksb: rkp rgm rer rpd
kbv: kbn klb kmt kqa riz rgg
kwf: kus rhi rho rjs rvr
rnm: rfc ruu rox bgw bsr buo
koo: rcu rae
rif: rht reg
bgh: bel bog bos
knh: riw rhf rek
khn: kpf rcx rju rer
rdx: rjn
kuq: rja ren rxr
rmu: rzt bkg brd bgf bvw bed bxv
rar: rag ryt rmc
kot: rco rlg rvt
kbd: kgb kwx kvr knz kue rkx
bix: bwq bes buo
kok: rwq rdl rjc
kjp: kea rdi rjd
rjl: rmd
kmf: kfj rcw rco rvv
rnc: bht bwy bpc boj
kkr: kah ktn rcg rap
kzn: ryf rwg
rle: rjc
bkj: bkn bwu bvx bxb bnv bzg bum
rqq: baz byd byu bdp bxe
rlu: rjk rxs
rxq: rmr
bpt: btz ckg
bvm: bej bto bux bob
bgd: bde bjy bvt bsh bsx bfo bqg btw
bwh: bnv btc
bww: bpn bor
kwb: rrr rrq rgb ree
kzm: kqp rhd
ksv: kpu rmd
rav: rih riy rsu
kyf: kpg rcv rcu rlo
kso: kxq rkg rwt rjb rpw
ksi: kov rki reu
kbc: kim klm kph knu kqq kqu rhb rgu
rbw: rhs rwz rvf rme
ruk: brg bzg bqa buk buq bom
bea: bzy bqk
kkb: kbs rkp ryv rjf rez rma
kds: kej kpy kzq kut rje rvt
bmg: bzx bzo btg
kxp: kui rxd
kae: kdk knx rkz rpd rmh
kww: ksb kpd kne kfq rku rrs rvp rvz
kcf: kdg kqq rkr rdu
kld: kqg kui ran ryc
bmt: ckk
kkz: ksq kff kzs rhr ryr
baa: bho bxr bfi
baq: ckn
bnm: bfx bzr
knp: rjr rvo rxi
bti: bty boh
bxu: buh
rjx: rxz
ktl: rdy rei rmh
rcs: rwc rvd req
bsv: bxw bzu ckm
rbu: rgc rwm reg rxv rpb
kpl: kfm kzp rrb ray rxj
kun: rkn rll rdr rep
kyp: ktw ryc rgz rvw
kyq: kmb knt kfn rbo rhi rsc
rnd: rzv rtd ruq brf bbt bgk bwy bxf bfj
bkb: bhs bef bxm bfg bzg
kqt: rao rwl rpw rms
kmo: rev rpp
ryy: rge rsf
kzd: rmc
kbb: kbt kbo kca kia ram rdf rxy
ksg: knk rwu rjk rsv
klx: kjd rhx rvi
rcp: ryh rls rgd
raw: rpm
rok: bkx bjr bjq bqf buq
ksw: kzr rpd
rhc: rev
rbp: rbq rec rpx
raz: ref
kxq: kne kfo rkq rbw rce rgh rdj
kno: rhg rhp
rym: rvm rxg
rot: bcy bpy
bxd: bxs bpy bzl bqh bqq
khy: ktp rwx rwt ren
kuz: kog rch rag ret rpk
byy: bwj bsf bec bnx buu
rkk: rlf rpl
kuc: reo
kmv: kzi kzw rdl ref rxs
kiy: ksw kqr rrq rgu rpv
rig: rga rsj
kwh: knb rhf rjp rmy
kgg: kwe kvu kzh kzn rls reu
rqf: bkm bbc bbh bgu bmi bzm bus boc
rcr: rat
knr: kqg rcu rlq rsy rpb rpn
bpf: bfq
kfz: ryh rwe reo
kca: kdv kqb red
kog: rhw rgj rvm
rfz: brd bat byc bsz
rlv: rdu
bsp: bzj
keo: koz rrh rxj
kvh: ked kqu rrm ryh ryo rmr
klq: kgp kev kny rvz
kiu: kjr ker kpn knm kqt rab rav rie rvk
kyn: koz riy rlq rvn
bgl: bwc bzg bqp
rmt: ror brv bgk bdh bjc bfv
kmr: kmm kng knv knt kzl
khj: kjx kpe kml kff rrx rbo rip rhq rdu
kmq: koe rjx rem rmv
kvk: kmb knk kzp kua
kyz: kdm kvm ken rpe rmr
rcy: rje rpv
krd: kre krp klt ksh ksg rkj rad res
raa: rpw
bzf: bul
bks: bcr byc byf bda
rho: rgm rjb
rmz: bcd bhy bhx bmk
kns: rbj riv rgi reu
rio: rgt rxk rxp rpu rmi
blz: bec bok ckv
bym: blc bpf bnp bzq
bfa: bfu
ksk: kqd kqx rid rlq rvs
koz: rao rjg
riq: rhj rxg rpf
bpn: bpt
kxa: ktg rky rby rle
bhq: bjt bfs bth
rkn: rku rrs
rai: rwg rvp
kib: kvu rac rap rpz
kjb: kvq ktr rrs rlh rwe
rrb: rbd rsp
kor: rre rhs
bkx: brz bds bzj
baw: byz bwr bwp bvb bsb beh
bkw: bkd bja bjg bvq bsb bet bzu boj
bbu: bdd bjh bet
kkk: kaz kmd kfc rcc ryr rdi rsy rpq
rwe: rvo rpz
bxx: bmc
kyl: kgc kfs rcu rgc rvy rep
kwp: kqc kqm rga
bnj: bqj btt bok
kqj: rlz rxh
bnf: bzj bou
kks: kxe kzr raq rhm rsd
kve: ksp ktk rgw rvs
kto: koi rae rhn rju ree
rdy: rsr
rod: bkp bpk bpz bmc bfd
rfp: rzd bra byj bvi bej bxl
kkj: kix klq kox rgz rjb rpx
krt: kcl kah kvz ksq knc kzs rxo
raf: ris ryr rln
bai: bis bww bpa bom
blu: bsh bxn bpl bum
kgh: ksy kxo kms riz ryf rdw
kfj: kty rli rgz
byd: bpk bpw bun bop
rvb: rpl rpo
krq: kez kom rvv
bmc: bfy btk buk
klb: kxh kfc kfg rcy rga rdj rvn
rhn: rso
bfi: bum
kxy: kzr ryb rlv rwp rvp ret bco
kyv: klo kgs kow rrh rca ryo rpf
bvw: bfp ckr
kar: khg kxs kpm kqw rha rxg rxv rpj
bbq: bhw bmd bti
bwd: bxf bzw bqa
kqp: raz
kkm: khd kdg kpj raf rio
rfb: rzr bcp bvj bpx bno bzy ckw
kof: raz rvy rer rec rxo
knx: ktm rkb rvp
bik: blr bgc bmn
bab: bil bwv bsc bsw bmf bmo
bsr: bey bza ckx
kbj: kci kjt kvi kve kuo rcf raw rsm
bfl: bzz
raj: rsq
bcv: bsu bpz bmn bqo bon
kru: khg kja kjd kok rbe
kdf: ksh kze rbs rlf rwu rpr rmd
rhy: rlb rxe
bex: bxi bqi bum bov
rgx: rst
kjl: kpg kfa rrw rlz rpv
rlb: rlu
rlr: rgn rjj rvi
rbv: rht
rks: rrv rah rhb rjh rjt
rgn: rsp rei
kwg: kxg rii rlr rgo
kdk: knq rki
bup: bum but
rzl: bcl bgy bse buv
bui: bue boa bov
bsi: btr
bjd: bxt bpr bmm
kep: rrd rvj
rhw: rgb
rnt: rqe bsc bxy bqw bqf bts
bns: bfq ckp
bwu: bpn
kuv: rdq rjd rjp
kit: kud rkb rsh rse
rkl: rix ryy
bco: blp bxt bog
rab: rmd
ryc: rgb rga
bza: bur
byr: bgw bgv bvg bso
kzv: kom rci rlx rgx rez
kdd: kjf kuz rck rak rsl
biv: bjk bxx btn
rhk: ryb rvs rsv rxt rpm
rfa: rzm bco biw bio bhd bgi
bly: blq bep bmk bqk
bit: blg bxw bmi bnq bow
rkx: ryw
byg: bjx bez cky
bht: bsd bxa bqr cky ckj
kvv: kxd kul koj rhn
kyk: kex kmd kmz knz knq rvl rvt rxy rxp
rop: bbq bsg bxk bpp boo
bwj: bdh bvl bnh bzi bua
rcg: ray
knm: kql rbp rcc rxx
rfj: rog biv bej bqz boc
rzu: bjn bvc ben bpw bmy bnd boj
kzo: kqo rej
bxz: bnb btr btl boi
rgr: rvm rpm rms
kow: ryt rgr rde rew
blv: bxv bmq bfw
rtq: bkc bip bpj btg bud bup
rzb: rtc roj byh bja bqy boq
kpg: knf rba ryz rlf rxm
kpp: kub ryu rje
bju: bea
bya: bsv bms bns bqq bup
kvb: rgh rde rvj
bsf: but boh
kyd: kga kdy kpe rct rcu rik rii
bgm: beb bmv btt
kfa: kfy kor raz
ryh: ryd rwd rsl
rmm: bbo bhy bec bep bnh bur
rtf: bbp bcm bmp bzf
bwt: bjr bsn beb beo boe
kco: kvs kzl rdj rxi rpx
rni: rtk ruh bab bhq ber bnf bqz buv
rbl: rhb rgc
bez: bnh bqs bqu boh
bir: bye bsq bxu bmx bqy btb ckx
kcd: kgn kdu rgq rdr
kpi: knw rke raq rha ryg
roe: biy biw bye bdi bjp bjq bfh bzt btb btc
kah: kqa kuy
biy: byi bgo bdy bfc bfy bts
kcg: kaw kiq rcr rap rha
brq: bbh bdo bnv bzr bqd buc
kql: ktv rjy
kbp: kya ksh kev kxt kpc kzx rih ryt
kbg: kaa kan kix kit kxd kxx rey
rhb: reo
bkm: bba bih bgr bdf buw
khs: kpi kfn kqk rcg rwf rpj
rns: rfd rth rux bwm bse bxm bfx bzp bqc
kkg: kzz rkm rrb rbu ryu rgd rvp
keg: kpk rkv rkx
bpz: btr
bdo: bsi bmq
brz: bbe bao bsv bxx bou
kxj: rkj rbw rip rgo
bkt: bcy byl bxm buk
bsc: bml bnr
kvn: ksl kpe rdn
rud: roc bsn bxv bfz
rey: rmj
rnb: rnu bbn bgx bne bfm bod
kkd: kvw rkg rap rau
kvy: kpr kzr kus ral rlv
kxs: rcl rct rda rvh req
kwt: kdg keg kev ric
rrk: rca
kcp: klg kph knb rpp rpf
knd: rcg rao
kgm: kvg ksr raj
bpo: bmh
rrn: rca ryg rla rwx
kpw: rbp rab ray rwi rjb
biq: bhf bvt bmz
bvb: bmx boz
bhz: blr bgx bdu
baf: bvb btj bog bon
rhd: rwn rvf rpw
ked: kuo kog ren
kaa: kjk kjy kve kuo rcd ryz
rny: rqr bho bwp bda bqj bow bot
byv: bgc bvf bqm bun ckv
bfx: boc ckh ckd
kob: rip
rhx: rep
kjv: ksx kfe kta kth kue rsw
beu: bxr bza btl
blk: bsf bxk bqf
kbu: kep kxf kqg kuh rrj rdz rxi
rzx: rod bwe bsg
bli: bgs bqr
kls: kma kfp rae rhg rwd rsh
rfr: bkn brg bdz ber bus
kdv: kpo rrd rxw
bsk: bqm bqz bor bol
rwt: rjo
kvz: ker kzf rro rgg
rza: bcz ban bhc bxd bms bfl bfg
bji: bnk btw
bmr: bzb ckp
kuo: rkl rib ryb
bar: bww bee bul
bel: bph buz
bha: bll beg bum buo
bjs: bpy bnz bnu bzl ckl
kod: rgl rvs rss
kgn: rcr rav rsy rsl
rgy: rxk
ruq: bag bgj bfb
kne: kuf
kcj: kaj rre ryu rvz rsb
bii: byu bnc bfr bzj bts bto
bkk: bre bin bhc bsc btk ckg
rah: rgz
khl: kwq kjq rho rvb
kyy: kgm kwl kfc kfe rpe
bjj: bjo
ber: bnk
rwk: rda rss
rit: rli rjf
bdl: bew bph bql btu buc cki
bze: btc buz
brg: bhe bvd box
bwi: bej bqa cks
rkm: rac rgp rvp rvu
kfn: rcp rjs rpx
kll: ksx keu knf rcc ryv
bnb: bor
kvt: kxh kmc kfr koq rrn rbq
rrt: ryx
kpr: kzq kuc rry ryx rwg rwz
bhu: bln bgy bvs bng buz boh
kbm: kiv klu kur riu ryn rla rju
bbx: bld bww bdr bjj bsf beg bfa
rup: rop baz bjp bea
ktn: rkn rck ris rgr
kuk: kub rdl rvn
kem: kxh rag rlp
bhx: blw bgy
ksd: kef kxa kmw kts rjq
bef: bti
kzf: kop rat rej rmy
bcn: bhn bgz bop
rak: rew rpo
kxe: rwq
kaw: kvd knx riy
kqv: rct rlv rlq rsk rek
kih: kha kwu kxm knt rii rdo
rxk: rxt
rmo: rzx bim bhh byv bxp
rax: rvn
krp: kgj kzk ktz rgl
bbl: bcc bif bgv bwn bza bux bov
kki: kbx rcv rat rgt
rfi: rfx rfo rus bkm bkt bla bld
bpd: bmc bfm bqp
rnq: bwg bwx bvh btu
btv: btz
rzk: rqk brh bbn bpo bfh
kxo: rpm
ryr: rps
krr: kiw khr kvz kfk kue rbr rjv rxv rxo
bme: bqv
kgq: kxp rrl rlb rpd
bsl: bxo bor
kya: kxb ryp rli
rsx: rmx
rhe: rwu rml
krx: kcq kfd kul rkz rca rlf rdf rxz rpw
bbf: bys bgf bsm bms bza
kqx: rra rvs
kup: kum rie rgc
rtu: bil bym bzv
rrg: rrn rix rga rgd rwk rjw rey
roh: bri bdx bjl bsy bfm bqq boo
bft: bzi
rin: rye rdv rpw
bam: baq bgh bvy bxo ckk
rct: raa
kse: ksq rpv
kzz: kop rvg
kjq: kxj kmx koc rrt rdi rjq res
rcb: rdk rei rep
bky: bca bvz bny
rrr: ral rye rpz
bwk: bps bno bzy bux bun
bzn: buy
bbs: bjs bpe
knl: kzo kqf rkl rlg
rlo: rwn rst
rfq: rtg bhs byr bmg bzj bzs bus cke
kvs: kxs kpl kfm rpz
bbv: bfi bug
beh: bpp
rww: rvk
bnu: bus
brh: bvu bqc
bqz: bti bud
rqk: blm bez bxj bmj
biz: bpa bmy boe
rao: rin rly
bxr: bpz bzr bqd
kjt: kzk rbb raa rys
bdu: bfk btc
kgr: kji kjq kzc kzj rck rcy ras rhq rsw
kos: rls
kbn: kdq raf rat rvn
rkd: rll rwd rvt rei rxv
bew: bmw bnj btf buh
kpn: kzg rrh rjd
rqv: blj bdf bjv bft bqa bqs
ros: bhf byr bwb bee bmn bnr ckh
bkr: bhp bdz bjg bmx bnr
kjw: kpw kzn rsc
ryq: res req
ris: rlg
kkp: kgc kgm ksg ksf kmz kzl kqu ktm kto rrb
rem: rxx
bds: bsv
ckv: cks
bfq: bqw ckk
bbj: baq bik big
kua: rpn
bhj: bvi bsh bsu bxc bps ckr
kzc: rko rhp rwj
kec: rlr
key: kzq kqq kuy rin ryk
bll: blv bgk bsr bqc cks
bgk: bgx bdn bsc bnt
kvw: kuw ric rhn rgj
rfm: rzx bhe bwg bwu bsq bzb bzn boc ckv
bce: bho bmg buh
kxd: kxo kzz
kys: klw kpa kmy kth kub rya rgy rxt
rky: rdr rec
rth: rub bbr bcc bhp bdm bpt
kpx: kqn ris rgb rss
bca: bcn byz
bjm: bfi
roo: bgm bdf bsb cke
bmn: btc
rtt: bfp bug
ktc: rgw rwm rxs
buf: buz
rpe: rpf
rwm: rsy
rrs: rli rmj
ktv: rls rgd rst
rtl: bhe bdr bdb ber ben ckc
khe: kys kvc kfh rjd
rnp: rfc ruw rot bcp baj bam bpy
ktu: kux rid rwi
rte: bkz bbe bwx bui bud bun
bcu: bwy bju
rmk: rmd
ktk: rrj rhj
bxw: btz
kil: kzg kus rkx rko riy rgf rww rxe
kqd: rjt
rne: rzl ror bct bik bva beu bnx
kzl: rbe rgv
ruf: byd bej buc
bxi: bpg bnm bus
bzc: ckx
rtn: bkf bkq bcw bgv
bbo: bjz bxz bqc
byt: bnf bqy
ksc: kfc rcz ryx rgv rwv rsh
rtp: bap bso bfr bue
kug: rsb rmh
kam: klr kja kem kqh rsi rsq req
khb: khf kws kjb kzw rpb rpn rpt
bgg: bfz btr buy ckn
bxt: bzh btm bof ckc
bgp: bgz bgq bpj bfu bzr bqg bol
kce: kfa kzf kqd ray rjh rvo rei reu
bsy: bqr btd buj
rux: brp bwn bpi
rvc: rxt rxu
rwx: rdo rex rxo
bvt: bet bnt
bim: byg blw bja bze
roi: bxp bql bty ckj
bao: byh bxj bqh
khp: kps rap rdj rpd
rjj: rxc
kwo: ksv ktb koj rby rgi rjw
rzo: bkj bxm bph bzv bqz
kny: kua rac rwc rxs
klw: kxv kze rip rwm rjd rez
kkq: kkt khp kyy rif rsy rpn
knf: kuw ral rpz
kgf: kog rwx rda rxk
rqn: rqz rok bbv bwk bqx boe
kfl: koh rwf rvc rek
bjb: bml bno boe
kvf: kmw kug rpt
kba: kbz kvb kez kfq ktg rvg rve
rqz: rob bbz bav bim bdj bnq bov
kcb: kxc kfd rla rdd
kgy: kdh ksv kqp rrm ria riu rwb rxk rpm rpt
khw: knn ris rxd
kvo: kxw kzt rac riy rpi
rrq: red
kgk: kgz ksl kxo rrk rbw rch ryr rwy rew
kjk: ksh kta ras rir ris rhx rdw
bdy: bxd btl
kev: kpr rbt ric rij
rvw: rvp
btb: bti btp
kvp: kpd rhr rja rpv
bzt: bqb
bxv: btx buq
bgx: bsj bnc
bty: bom
klz: kxr kpd kfl kqg kos rgd
brs: bap bao bfp bza
bay: bwd bwu bmt
kju: ksw kem kxa rcw
bjk: bmc bnb bnu boe
rdu: rjh rxr
bgf: cka
bzd: bto
kur: rro rhe rjm
bnw: bfs bzk bui buv
rqm: bck bir bse boi
kml: rrw rpf rmw
kiz: kgq kwu rhw rdg rdf
ksn: kej kns kfm rrr rhq ryb ryu rwg
kqg: rpy
rkv: rro rcm rmj
bss: bso bpw bzg
bnq: ckp
kqk: ktt rlc
ral: rel rxl
rzw: rtr bax bie bhg byc bzw boh
kwn: kdh rcn rgg rea rmc
rzz: ruk bre bhw bfz bts
ksa: kzp rci rwh rjv
rrj: rit rgx rsc
kyg: kyx kdy kfu kzp rkv rgo
bic: byt bjx bpy
rsf: rpf
rjm: rvg rvs red rpi rmg
kuf: rad rix rhm
bhm: byh bqc box ckl
bbc: bhm bxa bmg bup
kpt: rcu rpl
kif: kff rwz rwq rjs
bxk: bna bus boo
bmy: bnz
bij: bhg bxa bqc bui ckc
rwu: rdt
krz: kyt ksm kpe kuu rki rvn
kra: kwi kfv rev
bwc: bfy bzz
khf: kyr ktp rwq
koa: rbj rjx rmr
kti: kub rin rlk rlj
rbm: ral rvi
knt: ktk rcr rxj
bjn: bpb bpf
bqb: btf box cke
bmf: bzc bun
kjf: kmo knb kzo ryl
kzq: ktf rbg rpa rmy
khc: kyx ktl rax ryv
rfg: rub rok rop bav bvu boc bop
rii: rjr
ksl: kxl kpn rrd ryl rga
rbg: rpa
kva: ksv kec kpq ktp rkd
kxu: rrg ryj rwr rvc
rxl: rmk
klk: kvo ksr ksb kef kxi rds
khu: kym kxf kor rrd ril rwc
brf: bbv bax byg bez bxt bni
bbg: bag bym bsp bqy
rug: roe bkm brk bws bjl bpf bon
rtm: bju bxt bpb bpz bzq
rln: ren
reu: rxm
khx: kyu kpy rwf rpg
rlh: rvg rvq
bdz: bfs bqn bqf
kvr: ktj
bzw: bug
kqa: rrd rcl rct ryc rla rvx
kdc: kmm rxw
kjs: kes kmo knr kqf rij riu ryh
kwy: kvl kzd kts kom rbb rjm rew
ktf: rkv rli rji
brc: bcc bcu bal byp bfk
knb: kfj rrq rin rxf
rcv: rcq rie rvh
bff: bqi bqs
bxg: bqo boe
bho: bjr bpw bfl bzk boi boj bot
raq: rmj
kmh: rhy rln rvf
ksm: kul rwd
kmz: kng rig rsr
klj: kgk kpm rhb rxj
kkx: kkf kwh rli rdw
rqe: bai big bpj
rgb: rjm rev
bri: bge bfb bqv
kzw: rif ryk rsp
ruc: byq bep bfp bud
kmk: kug kuv rhw rwh rst
ryg: rxx
brw: bcn bie bhr bxd bqp
bed: bex bxq bqt but boj
rox: brp brt bim bec beq
ksp: kme kfi kuh rja rvt
rhg: rlv rln rlz rdp ren rpy
bso: bur
bma: bmz bfc bty buf boh
bav: byx bvc bvw
bbd: biu bgy bsg bei bfj bzu bua
bcl: bhb bei
rto: ruf bdc bdg bsn bfn bzl bok
kdn: kjc ksv kex kfu kuq rpg
kly: kln klf kzf kzo kux rrc rra rgf
blr: bps bmj
roq: bbk bad bef bpr cka
rqo: bbu bla bdv bom ckv
kjj: kno rbv rbf rcs rwx rxf
bap: bls bdk bfw bzs
btl: btn
kci: kgw kda kdf ksr kma kut rco
rub: bcs bah bwt bjq
khz: kwo kni ktf rci rye
rdb: rex reo rxb
bgy: bdo bjh bsx
kpj: ram raq rih rsp
ryt: rlb rgh rsg
rqx: rqm brt bgt bdn
bfh: bfz bzm
rwc: rwl
bws: bjs bnz
rol: bko bbg blz bwm
kdr: kty rwh rjg rsf rso
bjg: bxv bqe btb btq
bom: boo
kes: kuq rkf rir rhf
kgv: kjc kjp rbj rhj rhn rdq
rcn: rga rwo rjn
kzk: kow kox rct
kft: kuo rak riw
bbk: bwc bvs bnm bzz btx
rzf: bjj bpc bpo bqr bqt btv
brr: bdt bmg btw ckm
rvn: rxw
ray: ran ryd rwa rdi
rvt: rmk
knv: ryp rvp
kqf: rdb rdj
bga: bgg bwd cky
kzg: kul koo rlc rpb
bpm: bnq
kdi: kpn knk kzh kol
rbk: rhh rvt rev
rku: rae rhx
bid: bht bgw bwr bxl boe
kir: rao ryu rsi red
klu: kwh kjv kxn rdk
rat: rxc rxh rmk
bem: bet bxd
rke: rkm rwu rsq
rli: rxr
bmi: bnl bzh
rqu: bkf bbm blj bea bpq bow
rjs: rmi
rjo: rsw rek
kdg: kxn rbg
bcs: bms bob ckr
kck: kgp kfj rbs rdv reo rmi
bsz: bsu bfj
kym: key kmi kfr kzc
bkc: bbt bhx bxx
kwv: kdk kfj ktk rkj rhi rhd rvd
kgd: kwt ksr kew rrm rcv rah ram ric
bkg: brp bhx bvg bsx bxh
bis: bjs bsy bmu bnu bfd bzy boa
kia: kdm kzq ryr
bif: bge bsp bme
kav: kxn rya rlw
rgs: rjl rsv
kcc: kne kfi kut rxq
bqo: bue boh
kgt: kmw rkk rdy rpp
bpp: bqu
rjt: rvn rsm req
kha: kpj kuz rkx rvj
knw: ktb ric
rts: ruz roj bqg ckj
kgo: kpu rva rxp rmk
ryj: rvc rxn
rwl: rwn
brv: bcl bct biz byw byx blh bxv bfe bzp
kro: kec kee keq rbw rhb rgu rpd
kfq: ktu rgw rxf
rzj: rtl rug bmw bqy bta
kjg: kfe kul rrv rib rge rgf rjh
rsa: rsi rps
blb: bjb bnn btd
rmf: bew bnc bnt bqx
bcb: bgd bdv bvl bvf bxb
rqy: bcd bgq bxp bfw bzu
rba: rau ric
kge: kef kme rjs rjz
bgj: bpx bum buz
rvr: rmh
kgj: kpz rrx
rju: reh rpd
rjw: rjf rma
rnr: rqh bhg bwm bom
kyh: kfi rys rws rml
bdn: bna
rgg: rxs
kko: ktk rbv rih rhr rlg rgm rme
kkf: krc kra rkm rgk rps
rrd: ral ric riu ryj
rel: rxk rmc
rhl: rhq ryo rvh
kpc: kff kuk rri rrh rrx rbe ram
kjo: kxl rkf ram rlb rpa
bhd: bvi ckc
rkt: rse rxi
kfu: kum ryf rgk rgb rwj rsb
bjo: bmg
bio: bhw ckm
klf: kdp kei kft
khh: kme kfr kzi kqk rga rss
bej: bxz bnk bny bne bnt btq
rft: rzk bry bdr bjj bsu bxs bnp bnf bzn bop
bzh: bos
kmd: ktx
bia: byc bgc bdy bvt
rgf: rxz rmk
kqi: kqx kuc kol rgs rss
rfc: bke bga bgm bjg buc
rty: bru bbg bgt bsw
kku: kyd kml kul rhm rsj
btz: cka
rhs: rlj rvv
ruv: bcb bwk bji bve bsf bxf bpx
bcz: bai bie byh byf bee bxu
kas: kiq klg kda knc rrp rhx rgi
rbh: rck rjj
kbh: koy rrk rhe rpg
ktg: rxn
rbf: rgw rpf
bgt: bda bny bnn cks
kyr: kna kte rcb rwv
rko: rha rll rww
ric: rda rdp rjf rxd
rwr: rdi rsw
bqu: ckn
bko: bgx bwk bjg beo bxo bfv bud
kak: keb riv rlj rgi ref
bat: bsq beo bxz bfk ckl
bdd: bxi bfc bod
kmx: knm rky rlf
ken: kqh rwi rmb
bvi: bmo bov
kxx: knq kzm rvt
rrz: rdx rsg ref rxb
kdq: kzn kox rdj rsd
kss: kfi kqp rbr rat
bsx: bff
kni: kfv rjj rsi rxq rpr
rnl: rfa bci bcg bib bil bjh bff
ryn: rep
kcq: khd kgj kje rkj rci rwb rdv rdu
bwe: bji bjq bmb bfq
bxs: bxx
bjc: bxj bpg bns
bwy: bql bte bov
kht: klp kpv kza rru rcc rcx rma
blj: bjd bju bvl beo bxf bma bmn bof
kom: rkj rhp rvq
bwf: bda bdp bfl
btp: buj
rgv: rwv
kee: kpg kqy rwa
kxw: kms rkw rby
kwe: kwp ksl rij ryd rsp
kie: kll rlr rpf
kmu: ktx rsy rsz rxw rpr rph
bes: bfw buq boj
kfv: rje rpo
bnl: bnx bqd
byx: bvx bew bex bfa bqc
bah: bgy bvt bxq btc
rhh: rjq ret
kqe: kqz rll rwq rje
kab: kdv kjn rkj ryq
kut: koi rke rly rmj
khd: knw kqd ktf rkl rrf
bby: bbs bwf bdh bxb bzf
rta: bca bmn bfj
bck: blx bja bni bto boh ckb ckd
bhl: byn
rac: raq
bbr: bbb byq bvq bpk bfy bfm boy
bhf: bxj bpc bmh
kho: kjl kvr ksj rba rli rvb
bsj: bpz btd
rag: raj
rtx: bcx byt bjy bvf bqm bol bos
koe: rwd rvw
rkh: rgn rvd req
bfu: bzi
kga: kog rku rcb rhg
rdg: rdu
rad: rhc rgc rpn
bbp: boq
bdf: bvt bpc bmt bfo bqg
kcx: kyi kvl rhm rsj rxr
bsb: btm
rqg: bkl bkm bcu bvd bmr bnf
bvv: btc bup
but: ckw
bnh: bfh
bye: blc bwr bur
kxh: ktl rdm
bdh: bpe bfo buw cke
bro: bav bjt bsl buv bol ckb
kop: riv rhu rjh
rsm: rpa
kbw: kgm kwe kvl rbj rlm rxe
ruw: bar bhu bwo bjo
rcj: raa
rbx: rla rwc rvw
rap: rle rsr
kwk: rbi rgn rjl
bvl: beh bfg bzd
bag: bjp bem bef bxh bpf bog
kui: kuy rhz
bsu: btr boi
kts: rdg rpu
ktp: rkx rhq rye rwr
bwl: bdq bpq bqh bqw bqt ckh
bct: bid
bwb: bdp bsj bsv bpe bmm bfw bqm
ror: bam bqt bos
bys: bjv bjx bmr
rzq: rul bci bln bxb bpn
kbr: kbz khx kwk kpz kql raf rwp
rfh: rzn bii byp beq
kaq: kgz kfx kqt kos rcc rxm
kgw: kdo ktv rcr ryr ryf rps
kpm: kmn kqi
kfw: rbv rvc
rtz: bkl bxu bpr bfw bqk
rla: rvz
bkd: bks
rff: rtu bbe byd byt bgb bgs bvo bmc
rau: rwa rde rsr
rea: reg rxq
bzb: bov
bbn: bww bvi btb
kmb: ktq rbb rse
rcz: ras rdf
kfm: kua rgg rdk rea
khq: klk rmk rmv
bgc: bwx bxw bpm bmn bfh bfn btt bub
krw: kbc kyg kvg kxb ktq kuf rmi
kuj: rph
btk: boj bop
kud: rkm rrf rpd
bal: byj bjs bzu ckv
rti: rot bcg bhl bwe bpy bpp
bmz: bod
kjx: rrf rsl rmv
kag: kyc kju kxp knp ryc rlt rey
kpb: kml rka rld rji rsv
bcp: bgn bzx
row: blc bnx bzd ckd
bcf: bir bnm bzo bqs
brl: bii byc bmv
rds: rjq rvl rmd
rcf: rim rxj
rlk: rlu rep
ksq: kpy kmd rja rvg rxb
bas: bic bly blu bvh bpj bth
byq: bzv
rcd: rym
rru: rlv rgd
kim: kyv rrf rjn
kyc: kjy keu rwj
bhh: bhs bxk
kol: rbf rhr
kvj: kxv rbq rds rpn rmr rzj
bdi: bvu bsd bmh bfb bqv
bwq: bds bvs bst bxz bmt bqi
kla: rka rbm riv rpx
kis: kix koq rss rxu
kzi: rkr rxt rme
ktd: rka rws rvp
bmb: btx
kps: kta rkn rrl rxj
knz: rdx rvp
kdt: kvd ktu rrw rbj rvu
rid: rdh rvt
bbb: bib bdj bmz bmt bns bfc
bgw: bfn
knu: rkg rbf rct
klo: kjn key rgx rxa rxg rml
run: rob bkd bhl bmw bmf bfk
rnx: brp brt bav bvz bmp bnp bff btg
knc: rst rpp
kje: keg kmg knd kfh ras
rib: rgq rjb rpq
bgu: bvr bxp bxu ckp
brn: bdy bjh bvn bmf bny
baj: baq bvn bzr btz
kea: ket kxs kti
bld: bmz
kph: rir rds
kai: khd keb kzl ryq rgd rdh
keq: rig ryu rlz
kal: kie kvo rdq rjn rse
ban: biu bla bwf bjh
rof: bhd bxt bpc bfb ckn
rvy: rvd
klv: kwv kdb kju kpi kok rio rgj rgu ree
rzm: rtb biv bga bwi bds
kbx: kcn kfw raw rhl rsd rea
rws: rdh rjl
bnz: bfi bqn
rqw: bar bwz bdc bxc bpb
kcn: kco kjv kvb kfk kom rym
ktt: kun rjb reb
bdp: bvv
ktm: kov rrt rht
kdl: rkw rgr rdu rvq rme
rzt: bly bpg bod
kox: rib rgn rda rdv rjg rxh rps
rfo: blt beu bqz boa
rqs: rta rtm bkr bsb bnk
rnw: rfy brw bif bit bfz ckp
rht: rjz rsk
bvy: bpf
keh: keo kxs kui rmw
rzd: roi row bky byj byx bss bqs bqq bud boe
bxm: bpt bfp bui
kei: kpo kqy rhc rhu req
byc: bgm bwp bdn bmp btp
kme: rgs rpi
kxg: kfi rrk rgz rdo
kfk: ktj rjb
kff: ktw rix reg
kdy: rkp rbo rvd
rzy: bgw bgf bxk bqg btx
kuw: ray rao rit rhj rdr
rxt: rpp
bjl: bpq btx
koh: rjd ret
kgz: rbj rer
kbq: kxk kmi kun koz
bdc: bjo bsi bmz buu
blq: bwn bpe bte ckh
bje: bzm bqx bou
brp: bgv bpe bmh bzq bqd bqq
bcg: bxe bfe buj
kax: klk klm kjg rct
bvn: bmb bte
kji: kvf kmo kzz rbk rap ryb rgy rsf
rge: rpk
bwn: bqz
rsq: rpj
rui: bku brh bit bws
kcl: ket kxf rpx
rkr: rgk rjc
bta: bon bof boo
rqb: rtw bvu btx
bba: beb bof
rqc: rti bkt bdt bjn bqf ckh
rfu: rtn bys blv bth
rql: bbv bvg bvd bpv
rzv: bxg bpe bnw bun
kaf: kdw kmn riw rhi
kpf: knu kuq kok rrf
kov: rrw rlu rst
kbl: kyc ksr kpv kfb ram
bke: brl bwg bfw boe
bbi: bwz bej bxw
rna: bky bwg bmu bmo bzd cky
rly: rxx rmi
rry: ram rgp
bdr: bfi bfd
kfb: kuj rcj rvw rvx rsx rxi
krk: kxb kpm ktr rhe ryj rye
kgu: kws kdg rjg
kgl: kwo kna rce rjf rxa rxz
bxj: bqv btf
byk: blb bgp bdq bsr bsu
kig: khk kwp kfy ktq rpp
kfx: rav riy rlb
rga: rvw rxy
krn: kej kfm rhg reb
bvr: bvi bxo bop
ksh: kxj kpv rcf rgq rdr rjo
kky: kdg ksi kni riv rgv rgq rxp
kgi: kwg kjl kvd kzd kog rdx
kmy: knu riv rlb rdl rxj
rjn: rvg
knn: kzm rbg ric rgg
ria: rlf rwo
rwq: rei
bpk: bnb bnm
knq: rrc rwo
bkh: bkp bhc bjc bni bfm
kms: kfr kqe rpa
kjm: ryx rvd rsg rem
rwo: rxr rxm rpj
rim: rsv rel rph
kkh: kri kgu kvl keb kfb rkc rbk
kqh: ktq
ksy: rjc rst
bdg: bde bjz bvc bst
brt: blf bdw bpy bpj ckj
rvs: rsb rxf
ble: bmu bfy btb btn boh
kio: khp khq kwq rkn ryb rys rpq
koy: rre rbx rhw rhz
kxc: rrn rpn
kwm: kwt kpl kmh knx
kmc: rbr
rvp: rxx
kad: kqw rli rgs rve rew rph
byf: bnj btl cky
rhp: rdb
rqt: baq bdy bde bpo
bgv: bsi boy bow
rnu: rqj bhx bnp
krj: kal kje kss kej kzn rsl
rae: rye rdc
bcr: bhl bga bev bxf bml bfc bzc buh
biu: bvt bzu buv
keu: kzt ktj kow rdo
kwa: kvk keg kob rru rvj
kxt: kmt ktk ktv rkz rif rdv rvy
bpw: bnn boq
rue: bcz bae bhc bgo
kbs: khj kxr rwt
ktb: koz rwx
bxb: bna bzy
brd: bix bhz bwg bjq bmb
bsg: bqa ckn
bpv: bfg bow
kxm: kqh rhf rld
bhv: bsw bev bzf
rkq: rle rgp rsu rxz
rji: rmj
krs: kcf kio rid rgj rem
rua: baj bjr bvv bzm
bhg: bll bvd bsi bpm bmw bti bod boo ckd
rnh: bkc bxg bzk bud bor boe ckg
bth: bon bof
rsn: rpw
bny: bfe
krb: krl kwp kjr kqk kqq kox rrf ryk rdf
rzs: bko bll blv bso bpc bmj bnd bno cke
bqc: bue
blw: bld blz bvj bei
reh: rxr
bpq: bul
kqm: kox rjx rsi
ksf: rwb rvg
bpy: bmi
bvc: bsj bxm bou
rus: bch bac bov
rfd: bcj bim bgb bgv bjv bod
bkv: bag byg bdg bjg
kiq: kqz kum rrp rba rjv
rik: rlo rws
rqh: bls bds bjz bsj bxs cke
rdo: rsz
kid: kyz kdt kjw kzx
rci: rlo rgv rju rxo
rjh: rvl
bwr: bsu
bvu: bsm bem
kyi: ksh rkt rrz ryp
ruj: row byn bvs bsw beq bpa bpd bmw
byl: byd bsp bpx bmx bot
byp: bdw bvo bep bze bua
bil: bfl btq
bjz: bsq bzf
kwu: kpm kzh kze rlq rdb rxb
bgn: bvc bqe boa
bqk: bte
bxy: bxq bmy bqq btb ckm
kuh: rwe rsn
bvj: bsj bnc bfe buo
kli: kvs kvx keo ktc rcj rpr
kze: kqk rau
bgs: bfe
kjy: kxc kne ryd
bey: bza bqx btc
kta: rvy
beo: bul
kcy: kwg kfk koq rrj rrt rbr rbb rbn
bxn: bzv bor ckm
rzc: bia bhk bds bdp bpu bzp btd
blx: bsp bek bed bzx btt
bxq: buk ckh
kgb: kgc kwq kdh kjv kpg rby rhz
roy: bbg bgj beb btv
rul: rus bgp bvw bsq bxm
bhr: bgb bpf ckg
bev: bfb bfn
kwl: kvs kpg rkk rwq rvz rxl rxg
brm: baq bjk bxw bos
kxv: kxn kqe
rtj: roy rou bgi bng bnv boy
kja: kfr kun rap rhk rmr
bbh: bae bwr bwb bmm bts
bee: bfv buo
bkf: bla bzu
bie: bmj bny bff bzo
bfr: bqo btd
bxl: bua bog
kka: kva kfh kzr kte rwj
bqg: btu
krf: rri rhv rgl rdw rpv
ran: riq ryf rwr
bbt: bia bid bds bjn bzk
krm: kbg kys kdr knb rjy
rnj: bhi bgq bmk buf
kaz: kdc kjb kfz kzy rgg
kfo: rxx rpi
rip: rsa ree rxo rpc rmv
rov: bay byk byi blr bjm bvx btp
rtk: blc blp bjk bsa bop
khg: klw klx kwh kxj kpu knh kts kob rdp rse
kxb: rbt
rzr: bka bll bzu
kvl: rdq reg rpr
rki: rky rjn rpo
klr: kmu rie rhu rpv rmg
rgh: rwv rdj rdz rjm
kwj: kwf kne rbb rck rht rgd rem
rtb: bnl bft ckl
rei: rxw rmc
khi: kxc kfm kzx rrn rsh
riz: rsa
ras: rdz
bqq: bom
kch: ksd kpw kum rre rpo rmb
ryl: rxo
kfr: rcj rwh rjx
ben: boy ckc
kgs: kwr koy rgt rwa rdr rso rxt
riv: rek
riu: rlf
rka: rrl rcr rcz rep
bgr: bdg ckh
kip: kiz kmb koa kop rwt
rut: roq brp bna bnj bup
kxf: kzo kqk kqp kuf ryq rgc rvd
kfi: koc rre rys rlw rwl rpc
rrc: rax ryy rws
bad: bhh bpo bmy bug
rby: rlp rwg rsn
bqd: bqf boq
bdm: bjq bpv bpp bfb btt bum
ktq: rrk rms
buu: boj
bka: byj blk bqv boc
rra: raf rwn rve
kex: kfi kqg kus ram rhh
bhe: byl
rxp: roi
bge: bsi bul bob ckh
brb: bbg bac bvj bvz bsv bue
rxb: rmg
rrl: rce rld rwb rdd
kma: kqj ktz rys rwg
kzt: kod rrf rxs
kdb: rbl rcj raa
kus: rhv rpk rpv
rfs: rqu rtj rtt blz bsq bzh btn
bkp: bbp baz bwu bjw bvp beb bqy btw
kkv: kho keh kzl rvg
bbe: bvi bsx bef
bgi: bmr
rso: rxt
bhb: bmf bft bqg bqj
rsg: rsn reb
rwn: rsf
rwy: rjd rsn rel rpj
kii: klx kdt kmn rss
bbw: bhs bwm bpw btr buy
bib: bmr
ron: blr bpr bph
rur: bry blu bjy bvl bzh bqj ckh
rve: rsn
bdx: bvc bto buv
bxf: bnq
rlw: rpt
kkw: kct khx kjw kzt rwt rxu
rss: ren rpr
bpx: buz buu
kez: knc kqw kqf rea rev rpq
rwz: rdf
bmo: btm
koj: ris ryy
brx: bad bjd bfc
kfd: kqn rrj rcq rah ram rya
kpk: rcn rai ras rlw
bsm: beu bmu buy ckj
kay: kgw kdz kok rbr rxn
rqr: ruw bae bhe bya bgr bsa bfg
bva: bmn
kjr: rrp rvr rmb
kmg: rrt ryv rvv rsx
kpz: rry rln rjz
kre: rkm rax rdk rjw rxg
kxr: ryi rei rpf
rch: rad rmc
kpa: kfw kfn rko ref
byz: blo bwb bso bfo buj boa
bln: bpf bqu cki
bvd: bxs buy
rng: brw bgk bwh bph
ryi: rdc rjt rvh rvd red
kby: kiz klr kft rws
kue: rrd raw
bbm: biq bfh bub
kum: rdm
kzy: kua kor rjd
rfe: rzv rzz rtv roy bcb
kac: kha kfl rbl rar rsy
kvq: kfe kov rvm
kfh: kqz rhz ree
ruu: bba bgz bvn bel
ryx: rmb
klc: kdz kpf kfl rpb
rqd: rqo rtw bli bdu bfe bto
bnv: boa
kkt: kvb kzq rym rmv
rbt: reh
bvg: ckw
rnf: rft brt bys bvt btv
rmp: bkr bkx bbs bin bgg bxp bpc btu
rkz: rbg rav rpv
kpo: knd kzw kol rbo rcl rjy rjl rvs rxf
bgz: bsc beh bzc
bet: bnh bnl
koi: rlc rsu
bxe: bpw buo
bax: bde bsf bxt bmp btv
kmt: knl rjf
bhs: bda bdh bez
kvu: keg koi rym rxn
kxn: rbz rvv rsx reb
kap: kvr kfh kzd kqj kuw kod rrr rjn
bfv: ckx ckm
bjw: bmw bzt
bip: bdt bvh
bgb: bdr bel
rlg: rds
bvp: bsi bxl bfn bzn
kao: kgm kjb kmi riv ryk
rlz: rvq
bxc: bzw ckw
bch: bic bwk bjc bmi
bwg: buk
bls: bde bqj bqn
rcu: rhx
roj: bkp baf blq bdk bjr bpr bpa bug bor
blh: blu bwz bsl bed bnw bzv bug ckk
bcq: bij blo bgn bdq bzb btx buf
rsu: ree
rdq: rvf ren
rfw: ror bsh bej bpu
bpr: bnl
kfy: rax rhs rlm rsu
rno: rzu bax bzx ckl
rgq: rdp
ktj: kua rsg
kbt: kaq kgk kxp
byb: bwa bxo bfk bfh bfm ckb
bpj: boa
rhu: rdq rvo
kbk: kdq kmf kne rgu
knj: rku rij rhp rlm
kgx: kjv kju kof rhi rmv
bdv: bun bov
kwz: kdp kji kvl kzg kts rkc rkf
bhc: bgi bvf bpw
kyu: kwf kxe kqu kok rrd
kdm: kdt kez rbh rlo rwn
bzi: bzf ckr
bsa: bpa bfn
byn: bgh bdv bsq bpp
bmw: bnv bou
kwi: kqh rcm rlw rpv
kin: kty rlc rgy
kbz: kah kml rpl
kic: kyj kxg rkt rro rhv rgm rjw
rbs: rsk
rwa: rsr
klp: kjf kpw knw ryn rpy
kbo: kwd knh rxn
bsh: buw
bhi: bdx bvr bms bfg
rtr: bkx bwp bje bfu bud
rkw: rrx
kau: kin rcj ryh rgp rwx
rdp: rjr rxd
blt: bxs bms bqb
ksx: rhx rdx rpu
kew: kfp kua rwe
rdm: rjt
kdp: knq rke rbg
rkj: rrg rce rmr
bcd: bgj bvg bsn bsz bpk bzw boz
kfs: kzc rkz rws rma
bvx: bei bmm bfs
kqy: kur rbe rxb
rlq: rjc rsn rmb
bru: bay biy blz bjz bsd boy cka
btd: boz
ruy: brl bjs bjm bmi bmo bqw btv
brj: bcy bwm bmg bzf
bnr: bfr bfc btr cki
kng: rge rms
rqp: rtr bam bhd bzo
rze: rzz rqk rtz bjp bmw bfp bqr bqh
kfp: kzp ktc
kmp: rrf ran rsd
kxi: kno koa rrt rbi rsu
bmk: bmf
rxh: rpg
rgj: rsr ref
kux: rbn rai rlm
rbn: rab rik rhw ryz
kqz: kuh
byh: bfa bui bov cky
bin: bwj bjy bvy beq
kmn: kov rdw rsh
kpe: rrf rlm rlz rpl
khm: kgl kdb knv rbw rvv rxc
kte: rdt
bzm: bos
rlp: rxe rpo
kcz: kav kju kse kxk kpm kzi rav rsj
kde: ken kmk rbs ryz rjv rmv
bmq: bzm
kuy: rcj rir
blf: bwj bmx btk ckw
kjc: rbi rby rcx rie rsy rxx
bsw: bzq bqe
rtw: bgq bdf bdz bnd
krl: kxz ric rhd ryl rgh rva
bdw: bop
byo: bze buk bur bob
bkl: bak byq bel bnt bzz buw
kcr: ksv rrf rcv rai rsh ret
kjh: ksw kxs koz rii rpt
bqv: btg
kfg: kft kzw kqt rwt reb
ksu: rca ryg ryj rgw rml
bqx: bqu boh
kcs: kit kjw ktx kug rrx rcm rav
kmw: kny
riw: rjh res
rdd: rsj rxa
bcy: bvr bva bsa bsf beh bnm buc cka
kqo: kue rrl rya rjy
rfk: rfj bij blq bwa bfu
rnv: rnt rzi bjw bsi bmy bfl
kry: krq kzd koa rcp rik riu
rfv: rqb rqj ruk bbk bao bhr bxd bpp
kct: kas kwd kmw knx rls
roc: brm bib bhy bja bxo bzh
rzg: bgy bgt bsh cki
koq: rrx rbl rhy
kqc: rrx rgo rjq rxu rmk
bpc: bmk
bzg: btw
bep: bpw bnc boz
kwr: kte kok rad reo
kuu: rdt rsy rmh
ktw: rcq raw rgx rvj rsa
rcm: ryg
kle: kjq knl kfc rcs rhw rhj rvb
bvq: bqy bup
rnk: rqz bda bjm bpe bzw bth
kdj: keb kpc kpx rcf rdv rdu
kix: kin kpt rkk rlk rjg
bhn: bva bnd buj
bse: bor
ksj: kul rcs rla
rqi: bsn bpj bzb ckm
rlx: rgy rgs rww
krh: kth rcr rvm rem rxd
rqj: rua rul bbi bjl boa
bjq: bng ckb
rkp: rcx
rce: rgs rdc rex
kty: ktz rbu rye rdc rsb
rvg: rpb
bps: bma
bjv: bsu
rvu: rxa
rgk: rdg rds rec
bhw: bdo bxo bpy bur
krv: kyx klg kjo knx rih rhs
kwd: kes kpb knv kuj rrd
byu: bgf bsv bse bxd bpl bfw bft bzo
rqa: rtx rug ron bkc bgs bmn cks
kdx: kep ryz rwk rww
rdn: rdq rjd
ktz: rio rex rxw
kyt: kla kel kxz kny rbt rag ryn rdx rxh
rrv: rcw rco rgc rvi
roa: brl bcy baz byq bdu bsb bom ckw
kjd: ker kxe kzs ryb rgi rwf rjn
bvk: bxs bud
rdr: rsw rew rps
kej: kez ryw rst ret
ker: kqv rxc rpw
kkl: kre kal kql rbz rhi
bcw: bhe bzl boe ckc
beb: bua buj
rhq: rwk rwl
kzb: kzh kto rbr rcv rmx
bfe: bzd bqd
bun: ckr
roz: bbn byt bpg bnl boe
kub: rww
bnp: bnz bue
rwb: rwj rvc
keb: ran ryx rwq
bwo: bqb btd
rnn: rtw baa bht bjv bfx cki
kqq: kte ktn
kzx: kor koe
kan: kgp kwf kec rac rxf
kmi: rhi rga rvk reh rpl
bwz: bdy bvo ckw
bxp: bme
kth: kug rvk rsa
ruh: bcm bfm bzs
rer: rpf
bac: bdj bfq bqe
rsr: rej
kqw: ktl rbx rmr
bra: bym bwq bjt
kke: kis kvn ktp koh
bsq: bqb ckx
bvz: bxa bpb
bbz: bhw bwl bfy bfx buc
rnz: rff roq bkg bbj bha bhh byw bwt bmb
bst: bmz bqr btq
kpu: kte
rkc: rih rwh rmg
kqs: ktz kuz rbu rpe
rrx: rmy
bgq: bpy
rzp: ruz row bkf bly bex bfe boe
rkf: ril ryq
kvc: kxe kpp rrh rxf
kye: kse kmo riw rde rsf rxp
kxz: rrb rgy
kdw: knp kfi kqj rsz
bjx: btj bun bod
kln: kjt ktl riz rhx rvo rpr
kaj: kvm kft kuy rkh rdl
rou: bda bvk bxc bqd
bak: bdn bea bmx bui bol
kdu: kmz riw ryk rvn reb
rck: rvb rpc
rbo: rvj rsn
kik: khw kdz kqc rhq
rzh: bkb bbb bhn blc bdi bxz bmv
bih: bip bfb bqe bti
byw: bpf bmd bnb
rhm: rlp rjg
kzp: rsj
baz: blj bjx
kcv: kvg key kfm rlt rjj
bry: bco bhi bjf bxv
rbi: rji rso
bki: bln bfh
kcu: rky rbl rbd rxh
rfx: rzt rqd bgy bms bor
knk: kte rle rdo rxv rmi
rvl: rsx
bcx: bwv bdb bew bxu btw
rtv: bki bbp bwz bvb bsk bsb bpw
kiv: kln ktc kup rdo
rcx: rjp rpd
bqp: boy bog
blp: bwx bnp bzu
bmu: bni bzr
kyx: kdx kdm kvx ksv rgc rvx ren
rjk: rpg rms
ksr: ryr
bkn: byr byp bdw bpt bqi bto
kul: rwt rdo rvx
rzn: rqy rut rou bkm brx bbu bce bad bwo bjy bzi
koc: rch rho ryi
rhr: rlm reg
kdz: kva rgt rel
kat: kyc kfm koh rla rsj rpk
kwx: kjx kne kfb kqw rel
rll: rds rev req
rgt: rdr rmw
kvg: ksq kzy kuz rck red
kda: kem rhn rdy rjz
krg: kcr kpx kfq kuh kos koo rka rle rgy rsz rxn rmh
kbe: ksi kft kto kol rhf ryq rsd
kza: ktv rrb raj rix rpd
bsd: ckb
ryf: rlv rey rmw
kqu: rek
bcc: byb bjt bvw bvs bpc bqm
kjz: ken kxg kmc rhm rgt ret
kvi: kuy kuj rrp rwn reh
rlm: rdh
blo: bdq bqp bos
rjv: rxd
rvj: rxj
rom: bki bcn bas bzm bqk bqv bqs
bni: bnw
blg: bjx bju bqs
rkg: rpv
kcw: kic khw kqn kot
kjn: kmc rwn rjg rek rpa
bdq: beb bfd bti
bwa: bxn bne btj
khv: kgo kwg kdv kzu rha rjr
bwx: bvw bek bxj bfb
bqm: bub
rbq: rve
blm: bdu bpd bqn bol
rbz: rgv rmc
kkn: kku khi kht kvg
rpa: rmv
brk: bct bis bhv bez bpt bpo
kyo: kxv rbq ryw rwl rsd red
kpd: kpe kzs ktg rsp
ryu: rdl rxp
bnt: bzp
rwd: rjj
bdt: bow
rvz: rsl rpu
bdj: bsk bqj
kri: kqi ktu kuj
kyj: ksf kpn knd ktn
kel: kxq kpx kuv rbk
kqr: rkz rcn raa rwi rwv
rxs: rpa
rzi: biw bli bqf
bjp: bvy bef beq
rwp: rdd rvj
kmm: kfx rln rds reb
ryp: rdy rpf
bfz: bzs boi
krc: krz kpt rwi rso
bae: bhg bsf bzj
ruz: bgi bjb bpy bmi bml bfp bzs
bkz: bgw bgo bxi
rre: rbu rho ryl rwk
rbr: ria rwa rvl
ktr: rlt
ril: rjm rsa
bau: biv bhs bnq btp
bms: bom
kzs: rhz rer
bla: bgw bdf bsd bpp bmk
blc: bpi
kiw: kgq kvo rkw rbw rxx
bgo: bdd bng box ckd
kbi: kcb kar khc kja kng kqm rrw raz rir ryh rgl
rva: rsk rmw
rbb: rbx rsr
kon: rkh rbm ryk rwe
kou: rrk rgy rwx rds rpg
rum: ruo bhy bgb bxs bnf bfl
bdb: bsk bpm bpz bns bzr
kws: kol rbf rsn
boh: boq
byi: byx bjl
rtc: rtt rux bab bgl bml bzp bub
khr: kdo ktr kud kup rak rvs rej
bhp: bdr bnr
kwc: kzm ras rya ryf
rfl: rtn bau bin bio bpw bzz
bwp: bmt bqe btf
btj: bte
bvo: bso
kek: kzh ktj rld rsz
kbf: kgu kpz kfc kzc rid rpf
rbd: rcw rgz
rfn: rzt bcb bhn buv
kpq: kpt kob rrs rit rlu rjf
kgc: kdc kzu rko rwu rsc rph
kvx: rkn rdj rjw
bcj: byy bew bqr ckv
rmq: rnm rfb bdb bjq bxw bzi
bpi: bzk btb
bcm: bho bdm bsc ckr
kxk: kpz kng kfc rin rgn rsh rxl
rtg: rtd bkx brv bye bea
bve: bep bxj bxz
bmv: bzv
rhj: rlh
rwh: rjp rsx rxe
klt: kxi kmw rdz rxa
rha: ryg ryd rlg rjz rxf rmx
rca: rcd raf rdn rsx rmx
kna: knn rrc rrf rcq rao rhp rwr rev
bku: biy big bvz bmq btm buh
bci: bdc cki
kyb: kya kmp kqi rcd rma
rbc: rhf rlj rvo rxk rxn
bdk: bxc bfc bub
rvm: reb rxg rmg rms
