kwx: kej
kih: kwr kds kvm ksu
kbv: kbz kgw kvy ksk keb
krr: krf kcb kid kdj kee
kbb: kau khl kwo kdd kdf kdu kei
kzp: kqc rrx rrf
kkc: kkh kci kwp kdc kdj ksu
kaf: kho klc kgb kdh kjw
kgy: kds kdp kjw
ksx: kee
kbd: kcw khm klm
kgd: kwz kvh
ksh: kep
kmx: ktl kox
kgs: kwv kvz kso
kos: rrw
kwc: ksh kex
kxu: knm kua kul kof
kia: khm klk kwe kwo kjj ksk
keg: kep
ksc: kse
knk: knm kzd kzq kqv kuk rkc
klj: kdi kdg
kii: kil kgo kvc kvh kvg
krt: kik kld kwr kdr
rki: rrj
knr: kft kqj kqn kqt kog rki rkw rkz
kfm: kft kfo kzy rky rrl
kyo: kjd
ktk: kui kuq
kgk: kjn kvz ksv
kah: kag kgy kvm kss
rka: rkw
kfp: kzd kqo ktl rrd
kvl: ksf
kpl: kmn knm rkb rka rkd
kwt: kdu
kfi: kta ktj
kfs: kfm kzg ktc kuz koa kos kon rkn
kvb: kvq ksc
kcs: kcu klq kdb kjv kvt ksd
kte: ktt kuf
kkl: kab kyf klw kgf kwy kdb kje kso
kxa: kmy kzh kuf kow koj rku rrc
kgf: kdi kjy kee
kra: kbe kar kaa kig
kqr: rkr
kqs: kts kuj kuv rkb
kpq: kma kng kfs kfe kzz kqc kqi kqg kus koq
kpj: kni kft kto rrh
kdy: kdg kdv
knn: kzu rkk rri rrp rrf
kne: ktk ktl ktd rkz rrb
kij: keg
kyr: kdl
kcv: kge kgp kdv kji kvq
kzb: kzq kqr kqy kqz kub rry rrf
kpf: kmu kzy kzj kqc
ksi: ker
kri: krd kbg kyt klk kdb
kmg: kmv kmn kzm rku
rko: rri
kmh: kme kzp kub kuw koc koj rko
khy: kys kye kjn
kpo: knk kqw rky rkj
kty: kux rkt
kqo: kur
kjn: ksi
ktc: rkf
kww: kjv ksf
knq: kfy kqq koc rkb
kgr: kgs
kop: rku rrn
khj: kla
klb: klc kgd kwq kjm kvl
klk: kgg kdm kjx kvp ksj
kyz: kga kjx kjp kst kep
rke: rrm
kws: kjf
kcg: kyr kwb kjt kem
kcu: kac kai kli kwy kwj kvo ksw
kit: khc keh
kyx: kwh kdl keb
kxb: kxp kmj kzf rkz
kot: rkk rkc
krk: kbt kic khx kyc kge kss
kzc: kzq ktr kti kte kun rrm
kak: kao kgd kjc kjh kvr kva ksj kel
kpt: kmb kny knp rkw
kvs: kvp kei
kpr: kpp kzq kqr ktr
kjd: kvu keh
kqi: ktb kub koz rkp
kvc: ksm
kpu: kuc kui rrl
kmi: kmv knr kfe kfx kzp
kgp: kvu kel
kzh: kud
kcb: kho kys kyn kgo
kir: kyj kyf kje ksb ksq
kxs: knc kzw kqq ktx kov
kwm: kwn kex
kja: kvv kvz ksh
kno: kfu kun rkt rrk rrc
kuz: rkq
kpx: kmn kfh kqs kuc
kwz: kjo
ktm: kuf koc rkn
krg: krz kia kgk kwl kde kjh
krm: kaw khe kwm kdn kvy kvd kek
khr: klc klu kvj ker kei
ktp: kup
kkb: krn kbt kir kip klp kex rkm
kad: kyi kwa kjt ksr
kqf: koo
kfk: kfd kfm kzm kzo kua kun rrr
kil: kij klb klj kgk kvw kvz
kkq: kbk kby kyg kgx kgn kwb
kkg: kbz kac kgl
kpc: kpi kzz kqa kuh koy
kqe: kti ktu rkb
kvy: ksy
kua: kue kom
kkx: kck kcw kcq kgi kwa kwd kjd kvo
kzi: kuw kod rkh
keo: kuq kuu rkp rku rrk rrp
kbx: kcq kla
kni: knw kzk kzv ktw
kzg: kzj kqd kta koh koj
kgq: ksq kes
kzm: kql kox
kfb: kqy ktf kue
kwy: kwf kjs
klu: kwr ksh
kvh: kvs kvf kem
kod: rkd rrx
ktz: kuu koe rkj rkx rrn
kge: kwj
kmw: kfg kfz kzm kzn ktb
kbw: kar kgd kvh key kev
kuf: kuz
kbm: khs kyr klb kgp kvn
kms: knc knh knn kqb kqv
kmb: kmc kmz kfl kqx ktf rkb
kun: rkj
kme: kzu rkk rrw
kjt: kvr
khl: kdh kjl kvm kvf
kps: kqt kuh kux koh rkr
kgm: kgn kjq
kqw: kqz rkv rry
kxr: kxx kpf knv kue koc kod rkk rka
kpb: kmn kfn kzw koc koz
kwh: kwq kdd
krd: kcu kih kvj ksy
kph: kpz kmo knr kzk kqf rrz
kko: krs kbd kar kwn kdz kjb kev
kdm: kjk ksi
ket: kpa knc knn kff kta koy
krs: kbl kbx khc kej
kbj: kcl kyg kyf klw kwg kda
klm: klz keb
kvg: kvt ksx
kmz: knl kzx kug
kzt: kqp ktq rrg
kas: khg kyk kyq kdc kdn kvl ksy
kfq: kzy kqa ktl ktt koh
ksz: kev
ktt: kuv kop
kwu: kdi kjk kjm ksl kem
kmu: kzh kqh kqq ktm kol
kts: ktn rkg rks
kzq: kof rkc
kbh: kbs kio kdk kjd
kus: koi koo rkw
kou: rks rkm rrb
kkr: khk khc khw klg kgd
kkm: krs kcz kam kds
kfx: kzg kzq kqz kuj koy
kac: kav kdx kem
kch: khj kht kex
kuo: rkl
kjv: kvh ksz
kux: kuo kom
khm: kyh kyd kgl kwc key
krj: kbh kbf kad khf kyk klc kda ksm
rky: rrn
kqb: ktt rre
kli: klf kse
kay: kad khh kda
kyh: kyo kld kgc kdk kjo
kxh: kpu knu kzv kty rrc rrn
kze: ktc rkj rrs
kcj: kla kgk kjw kvp ksk
klq: klt kwf kwt kjp
kwa: kjg kss
kcm: kwf kjc kvg
kgh: kgp kwc kwj
kfd: kfp kfm ktg ktv kor
kqp: kqt kub rka rrk
kan: kis kys kwc kdk kdb kdg kjr kev
kjj: kjs ksd
kap: kiq kgf kvw kvv key
kyw: kww kdb kvd
kwg: kjf ksw ksd
kcc: khj kgj kdg ker
kma: kfw kzq
kxz: kxt ktq kuh rks
ktx: ktn koy kog kof rkw rke
kbf: kiq kgx kva ksr kse
kzx: kok rkp
kxk: kfd ktb kof
knl: kte ktq kux rkx rrn
kgu: kdq ksd kex
kug: rkr rkj rre
kxl: kpg kqq ktm koz rrs
ksp: kek
kxi: knm kuw kup
klh: kgc ksg kep
khz: kyx kjg kvo
kxn: kxt kpc kmc
kqj: kqo kob kog rrn
khd: khm kyd kdx kjq ksy
ked: kep
kzz: kob rrz
kyu: klh kgw
ksn: kel
khg: kyo kwz kjl kjf
kga: kgv
kqk: kqz kog rrl
kuc: koi rkd
kqt: ktd ktv rkd rrv
kow: kod rkx
kfo: kqa kuo koh koq rkm
kdh: kdd ksy
kyg: kdy kvt
kbn: kio khe kyx kwa kdy kjj kec keh
koy: rrl rrv
kjq: kel
kmq: kfx kzj ktc kum rrj
kcq: kah kyd kgc kec
kza: kqu ktw kou rkq
ktr: ktc kug kuq rks rrv
rku: rre rrz
kyn: klp kvc
kml: kzd kqd kun rrx
kgc: ksu
kwb: kdo kjq kss
kvq: ksy
kqn: kua rkh
krn: kcr klf kgu kdl kjg kjm
kur: rky
kkf: kyc klo kgx ksd
kji: kjp
kez: kxu kpa kmc kfb kzt kqa
klg: kwy kwv kdm kjb kek
rkr: rrh rrm
kcx: kiz klf kdj kva
kke: kkp kcg kir khk khp klw kld kdw kec
kzd: kqj ktk kuj kob
kbg: kie khf kyp kjb ksl ked
kht: kgz kwx kjk kvq kvu
kla: kjj
kiy: khp kyc kyg kwk ksv
ksg: ken
kmd: kfx ktv ktn kuf
kpk: kmz kzo kqx ktp rkx
kby: kaq kic kit kls kwe kdr kjh ksz
kam: kim khx klv kwk
kef: kxk kxi kpi kmf kmq kzp kqr ktz kom
kfc: kqh kos kof rkw
kld: klt kdw
kco: klj kji kvw kvq kee
klf: kwo kjh kec
kdo: kjq kvj
kfa: kzb kus rrd
kdt: kjy ksb
krv: kbh kah kig kiw kiv klx kgy kji
kly: kln kgw kdo ksj
kbz: kia kst kei kep
kqv: ktq ktu rrh
keq: kxg kpo kmr ktg rko
kdk: kja ksb
kvw: ksf
kix: khj kyd kyt kdj kjc ksa ksd
knf: kff kzs kzx kqs kqx kth
kaq: khg kvh
kdv: kvc
kav: khr kvx
kzs: kqh kqn ktp kot rki rkd rrm
rkl: rkt rrj
kcy: kcg kcn kan kgh kwp
kmo: knn kor
kxt: kmx ktt kus rry
kki: kkm kbc klv kle kgq kdt ksr
kiu: kyv kln kgc kvc kva kvd ksk
kpv: knj kqk ktz kur koa rkj
koh: rrh
kdf: kes
kal: kyc kli kjj
kxe: kpg kmv kqb kqe kuk rkr
kll: klt kdq kjj kvv
kxg: kxu kfd rrg
kag: kaw kdp
kmm: kfk kfl kub
kdi: kdn
kdw: kec
kbr: kcv klp kjf kvg
kkp: kct klu kgp kvy ksf ken
kic: klj kdb kdm kjr kvj
kho: kgs kwb ksz
kpi: kqo koh kot
kba: kbe kcr kda ksh ksx
kxc: kxw kme knn kno kfg kqu rkp rkm rra
knu: kzr kqu rrh
knz: kzf kuu rkr rkf rku
krb: krt khc kwc kwi
khf: kyq
kju: ksn kec keh keg
klr: kly kgq ksp kst
kaj: kgh kwn kdf kvk
kyt: klz kgj kdy
kfv: kfz kqr kop
kcd: kai kht kyh kws kjv kew
kcn: khl kgr kex
knm: kfi kza kth ktm rki
kbc: kim kyw kyx kli klm kgw kwf kvk ksq kew
krx: klc klh kgg kwx kjc ksk
kjp: kvt keb
krl: kcm kha khi klw klt kek
kks: khi khh klh kdj kdu kjl kjq ksv kew
kck: khr kge ksw
kis: khx khn kll kwg kje
khc: klb klg kdn
koe: rkj
kwn: kde kjz
keu: kpk kpu knz kfc kfl kqd ktg rkq
kyy: klz kge kwp
kmy: knh kfi kfz ktd
kbq: kal kls kwi kjp
kon: koq
kdr: kvh ksa ksm
kxo: kpe knc kfy kzs kqk kth kup rkn
kkw: kkv kbn kca khj khu kgr kda kjw kju ksc ksf
krp: kaq khh kyt kgb ksu
kif: kww kvm ksm ksf
kbl: kbu khp kyc kgf kjp ksa ksh
khe: kgi kwc kdp ksj kei
kuu: rkl rrd
krz: kwh ksg ksv
kqa: kql kov rky
klv: kjq kvu
kvt: ksr ksu ker
kyf: kjw
kvp: ksi ken
ktu: kod rkg rry
kub: kuc
kbi: kaz kie kgh kdh kdt kjt
kuv: kos rkh rrd
kqg: kom rrm
kmn: kfi kzv ktl kuz rrz
kmt: knk kfa koh rkp
kmp: kft rkr rkg
ktq: kuw kun kop rkf rra
kip: kyo kjw ksh kea
ksq: kes
kth: kuf kom
kud: rra
kfz: ktw rkq
kdb: kec
kjl: kso
khv: kwl kdg kdm kjf kjz
kxy: kmp kfe kqm ktu kto rkw
kvr: kvg ksb ksw ksx
kqh: kqq ktx rrs
kwl: kji kvd kvf ksy keh
kkk: kkg kkv kkq kko kbt kbo kip kit khy kyq kwt kdo kve kvo ked
kdx: kej
kff: kzi kqw koj
kna: kqg kuu kot rkm rkt rrw
kyb: kyg klj kwj kdo kjv kvp
kqz: ktb rkr rrc
kid: kgr kdj kew
kym: kls klp kse
kxd: kpb kzt kqu kok rkj rku
kfh: kzn kqn kqq kta kti
krc: krp kru kbd kyt kgv kda
kcr: kho kwt kdm kja kuk
khb: kgx kwa kvi kea
kbk: klp kjf kve
kyl: kyd kyj kdb kdz
kcz: kgd kgs kgo kvc
kde: kjp kvn ksk
kmv: ktn kut koq rku
kim: khz ksm kee
koo: rkt
kjy: kvy kvj
kor: kox rka rkn rrv rrf
kky: kcd kcp klc kwd
kns: kqq kol koz rkh
kxj: kxn kpe kmh knk kzr kog rrb rrd
kqy: ktc koh rrp
kmk: kmp knc kfw kuu koc koq
kau: khs klw kwk kdt kji kjx
klc: kgr kjs
kqm: ktd ktj kow
knt: kqh kqt ktq koo
kpg: kzo ktq rka rkj
kdp: kjb kvt
kdd: kep
kya: kdv kdf ksc kex
kql: ktb kue kom rkg
kcf: kiw kiv khg khf kgb kwi kee
kdz: keh
kwo: kdd
kzv: kqq koh rrk
klx: kgl kge kjn
kiq: kyx kyu kwm
kvn: kev
klt: ksa
ktn: kup
koi: kot
knx: kzu kuv kob rks rkn rry
khu: klo kwc kwf kvg kvj
kqx: kuj kue kob kox kop
kci: kge kgq kjo kst
kgi: kdn kei
kum: rkz
kre: kbk kbi kcr kyd
kpm: kmi kmo kfa kqi kui rrh
kbu: kad kyv kdn
kyi: kwl ked
kik: kio kgh kwl kds kjt kec
kiv: kga kjs kvz
kqc: kow kom rkr rrg
kjk: kjv kjz kvd kew
kov: rrs
kkv: kla kvd ksn
knh: kzb kzd kuq
kfy: kzz ktv rko
kdu: kjm kvb kes
kve: kvm kvu
khs: khp kya kwo kel kev
kbo: kyq kle kvd
kzu: kuh
kxw: kpp kmp kqj
kmj: kmn kmq kfs kze kty kol
kgj: kvs kvt kes
kjg: kju kvf ksz
kkt: kcm kgg kgn kwb
knj: ktt kub kug
kzw: kol
kka: kkw kcc kcm khf kya klg kdc
kpy: kmj kqf kqo ktb kum
kfe: kzc kzd ktw kuh kus
kkj: kry kih kha kdu kjr
kgx: kji kjd kvi keb
kpd: kmw kni kfi kfl ktx
rry: rrz
ktd: kul rke
kok: koe rkl rke rkz rra rrw
krw: kbl kap kws kvk kes
kvu: kea
kzn: kqx kto
kwi: kdd
kqu: koo
kae: kgn kwp kjz kvt
khq: kdw kjg ksq kso
ktw: rkp
kuq: kon rkm
kbp: kag kyn klx kdt kjg
kgg: kdx kja
kca: kig khh ksk
kmr: kfc kqi ktb kou rrr
kys: kjg kvp
kxm: kpf kmp kqw kul rkh
kgo: kwv kso kec
kqd: kuz rry
klo: kgv kvr
kmf: kne kze kun
kvk: ksj
kdl: ked
ksb: kst
kwd: ksh key
kwj: kvb kss
kfl: kqq kti kou rka rrr rrc
rrj: rre
kuw: kuq koe rri
khk: kye ksd kss
kcl: kam kyz kdz kjq kvx ksp
krq: kru kch kiq kym klt kwo kdq
kwe: kwm kdo
kui: kuz kop
knw: kfr kqh kqx kte
kzf: ktj kuo rkb rki
kzk: kzq kuk rkt rrz
krh: kyk klt klo kgy kwd kjq
kuy: kue kux kuq rkk
kpp: kfk kfe kzn
kdn: kvi
kat: kih kiu kgo ksm kev ken
kjc: kjz kee
ktl: koj rry
kie: klb kex
khh: kyi kva
knv: ktt kom rrk
kku: kbe kbx kle kju ksx
kvx: keh
kwq: kve kvn kej ken
kar: kgt kja kse
knd: kfa kzy kty ktl kod rkv rrr
koa: kos koo
kjf: ksw
kyq: kes
kwk: ksk ksg
kzr: rkv rrw
kds: kde kvr kea
kcw: kyz kdn
kqq: ktp kur rkz rrh rrg rre
kgn: kdj kjf
ksl: keg
kye: kll kls
kib: kia kij khf klb kdn kel
kwr: kwe kdi kjl kso
kax: khc kyw kly kgh kdi ksp
kxq: kpu kmp kmt kze kql
kup: kob rkh rrx
kng: knw kfg kqa rkx
kpn: kzw kqu kti kuv
kto: kuq kon rkd rkv
kai: kad kat khw kvy
kkz: kcg kgx kvh kse knv
kha: khs kyy klp
kyv: kwy kvf
kio: khe kyk kdf ksp
knb: kns kzz kqf kou rki rke rrp
kdc: kjk keh
kzo: kud rko rrc
kjh: kvy
kcp: kan kat kij kli
kru: klg kgb kgy kvv ksm
kpw: ktg kuw kor kon
kaw: kyh kwn kjr kvv kee
kuh: kot rkk rke
kgz: kwz kvn keg
kdq: kjo ksq
khp: kws
kgw: kep
kft: kzq rrh
kro: kbd kbz kcu khw kho klm kjq
kmc: kmx knj knf kzr kug
klp: kwi
kpz: kmm kmt kff kfz kza kzw kql kon
kvm: ksc ksp
kct: kab kav kyp
kyj: klc kdg kji kvx
kzj: kth kun rkf
kpa: kpz kqt
kfn: kql kuj kol rrd
kbt: khi kla kem
ktg: kto kum rrg
kxx: kff kzh ktz kod rkh
kle: kgx kvw
kje: kjx
kry: khw khm kjc kvf
khx: kll kge kwg
kls: kwv kdj keg
kyd: kjk kvo
kiw: kye kwj
kxf: kfj kzv kzt ktb
kyk: kyl kys kjl kjz key
ksw: ksm
kzl: kqs kqx ktk kog rka
kao: kiz kyr kyh kwz kds kjy ksk ksn kei
kul: kog rrx
kig: kgs kgu ksk
kut: koj rrk rrv
kgv: kgm kjn ksw
khn: kdc kdn kve ksl
kjo: kvz
kjb: key
kiz: klz kwg
kuk: kut
kkn: kku kae kly kev
knp: kfo kos kou
kaa: kiy kll kdz kjn ksa ksl
klz: kja kvs ksi
rkc: rkd
kfj: kqa rkb rkm rrp
kgt: kwe ksa ksv key
kfg: rrc
knc: kqi koo rkm
kny: kqn ktu kua kud kux kov
kyp: kyn kdd kji
kln: kgf kjk kvc kvi
kab: kyk kyp
kfw: kqv koi kow rrs
kaz: kgm kdp kvl kvs kee
kin: kif khg kyu klz kga kgw kgu kwi kdf
kbs: kbm khk kgf kwx ksa ksz
kgl: kjv kjz ksh keb
kwp: kjb kex
kti: kog kou rkl rra
ktj: ktp kup rrb
khi: kwf kjv kjp
kfu: kzz koy rrx rrp
kbe: kho kyv kjb kjn
krf: kbv kbx kay kao kja ksr
kpe: kmm kfa rkq
kce: kga kwl kdl kjk
kzy: kze rkj rri
kxv: kna kza kzt rks rko rrh
kkh: kkm kha kym kjo kvv kvn
kfr: kqa ktn rrh
kkd: kbr kik kha kdl kvo ksx kex
kxp: kpi kma knv kfd kfv kuc kua
ktf: rkj rra
