bc: bh bm ia he yb yd vl
je: jt vy vd
ky: rq ih il ie ix hr
du: jf vj
bz: bo cf cz ah iz hi hs hz hq
am: yy yx
rt: bh bd cp ah ao he yl yp
kt: rr bk bj
as: ik hk yi ys
iw: hx ye yx yf
kz: rh by bv cv at hr yf
gq: go wc jk
cs: ay ik ii iv hi
co: at iy
dq: je vt
ya: ye
gj: wq dd jg
ww: ws dl dp vi vq
hu: ye
jt: vr
dy: dt vz vq
ct: ai aw aj yg yd
kr: ke rp bp as hz hu
yh: yg
ah: iv iz
jr: jb je
wq: db dl df jy
ak: ap az io
ku: bj ai ia io hx
aj: ap ie iq hl yf
wa: wg wz jg ju
jd: jo
cz: hl yg
rc: br ch id
ji: vs vz
yr: yh
aw: ad ae
lq: gb gj wh dc jv
rz: bs ah
ru: bh ic il hg yr
gl: gz wz db
ib: hw hd
yt: lc ls lt gk gc gq wf jp vc vg
az: hb
vb: vv
an: it iu ha
ij: hd hu
il: hy yn
bj: cm is
yf: yz
bg: bv ch ao iw hb hu
cw: ag am ys yf
kc: kf rx bh cn iq hy
lp: lf lz gz wi dm jl
kv: kf ri by cc ae hl
da: dj dz jt
ae: ia id im ht yc yz
js: vw
do: jz vh
rs: cr cp hl
ks: rw rv rt bo yl
di: dh dz jk jh
ie: yd yx
gy: gm dy dv jg
va: vi vy
dn: jj jn vj vm vz
ce: if yf
rq: cc cp ak ap yi
gt: wo dv dp vy
ik: ih ig hl yv ys
dd: vb va vp
ii: hh yz
wu: jw ve vn
he: hp ho yk
in: iq hi hw yx
wm: dm jc vm
wg: do vf
yx: yn
dt: jx vf
hn: ho yh ym
dw: jh
cl: hv yg
cf: cu af ip hp
rd: bl cd id hp hn ym
ag: hg yc
cu: as ii ij hq
gk: gr wb jx vi vt
dc: dp jg vi
bt: ap ic in hb ym dk
bn: bo cb hv yd yx
ix: io yy
gc: gy gm wk jc
cr: cn aa iq yi ye
ab: aa ao
kb: cb ca cn cf ai am
wb: wc wx jb jl jg
jx: vp
li: ga wb wh dy vs
le: gh gw dh
jm: vb vw
at: hx yh
ai: hv
wd: wz dk jr ji
rv: br bl ak hn ho
lz: we wu da dj jo vi
kw: bc aa im yl yv ys
iy: hk hw
cj: cf ah av
rg: bh hv hp yb
de: dm jr ju vx
br: cj cn hc ht
gb: wy dr dd ji vn
ay: ix hg
hd: ho
bd: bz hj yh yw
yu: lr lm gh gw jj
im: yi
bm: ak av hn yy
gd: gu dg df dz vb vv
ke: kn bj ic
gh: wg jh jm jn
wx: di dh jt
hr: hm yc
lv: gf wh dc di jd jm vj
bb: ba cg cz ir yg yw
bi: bg as is ym
wz: wu vk
vk: vj
bh: bn cl cj cu yb
hi: yr ye
ad: ib id hp hm
rh: re au hc yj yq
iu: hr
wy: wd wf dw dv dq
wt: dc jk jx
ll: le dg dx dm jj vb vc vl
by: ao iu yw
rp: bx bz cd hc
gr: du ja jt
bu: cy ao ij hn
lk: lw gl wl jd jv jp vh vj vx
bl: aa ag iw is hj yj
jb: jh ju vy
lm: ga dm dq js vj vx
la: wc wa wn dv jk jm
yo: gs wp di dh jy vd vq
kk: cs cp cq ab if hm
hg: hv yk yz
iq: it yp
jj: je vh
rf: hv ho yr
km: rs aw he yk ys
dp: dn df jc jg jp jq
vi: vs vm
be: cu ag iz iq hb hs
cp: ac aw ii hw
bw: bd cn aq
hx: ya lv
ha: hv hx yc
jl: jj vi
wo: dd vb
ro: cs cq is im hm ho
ld: lp wi wo dx jv
dx: vi
rw: cm iv hk hq
gm: gz jw vw
wl: ww wq du ju
ls: gq wp vk vc
cv: ih yb
rl: rv bd cg
bk: bw ic hg hz yr
lo: wn wq dg do vh vl
lb: ll wr jq vx
ki: rj rz ca ay av hj yp
kn: hy hv hx
lt: wd wt dt je vs
rj: bn hm yp
if: iu yr
aq: hc
ig: ix hu yp
we: dk de vz
kq: rt bi at ia iy yi
vd: vf vz
jk: vp
lu: gi gl gv gs dv jv
gi: gh gw vy
wk: dd df jm vk vc
vs: vt
yy: yq
it: hu ya yn
gs: we wx dx dq vc ve
kx: rp ru cu ab iy hh yy yl
wh: wz jg je jf vz
lg: gw wl jb je
ac: av iu hx
wn: vv vf
bv: bu ic
cq: ad yd yp
ln: ga df vm vf
av: iw
hb: hs
hq: yc
hs: hf yg yx
kg: ke kt rf co ig hu
ko: rs rz cx co ik yb
ip: io hl
gw: go wp jf
wr: wp dd ds jq
ja: ve vz
ck: ii hi hs ys
cb: is ho ys ye
aa: aq ir iw hq
ge: dr dw dd jd
db: jr jz vi
rn: cs as yc yw
rb: bq ch ii iu yb
go: wr wv dz vb vz
lj: ln lt jz vc
ci: ce al ix im hj yw
gp: gq ds jk
kh: kv ks rx bw bj
kl: ks ku rg cg cx al it
hp: yk
lc: lp gf wz jd jx vl vn
wi: ws jh va
cn: yb
ax: an it hr yp
dz: vr vw
au: is iz hl
gg: gx gu vy vl vq
gx: wp wt dc vd
bq: cr ca ce ae az hf
lx: gv wl jw
ds: jv vk vl
ch: cy ak ay hl
hc: hi yn
ri: ry bq al ie iz he hp
wf: vf
vg: vj vp
wj: ws wz jc ja vc vg
kj: ru bf cv cx cm
lw: gf wg dc do jh va vj vq
rr: rh iy hu yd
bx: cg cs ak hm
hj: yv
jn: vw ve vt
wc: dv ja jw vs
ga: ge wu dp ju
gu: wl dm jk vh vw vq
wv: dl dv ve
dj: jj jq va
kp: kt rr ba cn ii
cc: av ip if yj
hk: ht yv ye
yb: yp
bf: bu cl cv an im yi yx
jz: vz
jq: jt vm
ir: hr hy
dm: jc jf
hz: yc
ka: kh bq an hh
al: au if he
ws: db df jj
cd: am ya
bo: cg hi
io: yj yq
lf: gl gw gs wm wt vm
ba: ah ag yh
jp: jq
gn: dn jr jf jt vd vp
kf: bd bx hh ht
vl: ve vp
jy: jo vr vb vq
ry: rl ih ha yg
ca: cx ar yy yz
dg: jh jp
rk: rm bx cr as hl hf
bs: co aj av ao id
gz: wk ji vj
rm: bb cp hp
ar: ab az aq hc he
cm: ay aj il
cy: ai ay ie hf ya ym yz
df: vd
rx: ci aa
dr: js vv
gv: gp gm wk
bp: aa hi hq
gf: js jt
iv: hy hw hq
hv: ht
vr: vv vq
ys: yp
ly: lj lx lu wf
lr: wr wv dw du jo
kd: ks ke ko rc rp bj bt ha hv yb yv
jw: jd vx vn
re: cv in hd ht
ra: rg rw is yv yq
ap: ij im yf
jc: jz
dk: dl jo vk vx vn
dv: vy
af: ib iq yj
lh: ly ge wf dj dm ja vv
id: ix io ym
