ksz: kxr kzd
krd: kby kbj khl kzg
kte: kue rra rre rbu rcw rcp rcm rdn rvy
kql: kqt ktd rkt rrc rrs rrq rbj rht
kpg: kpz
kuq: kob rrf ryl ryv rlk
rhl: rgz rdr
kxs: kpw kna knx
kki: krp kbo kwa kjf ket kxz kfm
knb: kns kzk
rwk: rdv
kax: kih klx kdj ksz kqa
kqg: kom rkt rap raq rla rje
ktt: kog rrj rca rch rac rhk ryn rwa rjm
krv: kab kjy kjj kna kqi
kty: rka rbk rca rhp rdq
ris: rhb ryh rwm
rig: rdv rdz
kbn: kdg kdo kxw kpv knk
kbx: kic klk kgc kjj kpa kmk kmw kmn kns
kbi: kyk kvo ksb kmb
kvj: kew kfc
ktr: kut kov ryu rld
kiu: ken kpn
rgb: rga
kag: khr klp kjp kfx
kjr: kjh
kwm: kjb kxc kxu kmy kzw kqk
krn: kbv kxq kpy kqi
kdv: kpd
kwk: kmt kzm kqc
rhy: rgm
kxx: knt
kdu: ksm kxb kqk
kdg: kfl
knl: kff kzq
kbt: kcx kcu kal kls kwy kwq kdp kxo kmp
rle: rlp rgz rwc
ksh: kpq kzl kqr
koq: rro rhh rhv
kgl: kjd kvl kpm
ksw: kpw kmr kmd knv
kir: kwv kvs ksh knk kqc
kxq: knq kzk kzp
rcs: riw rix rhj ryv rgd rdg
rrm: rbm ryd rlf rwm rdh
ksi: kzy
rrq: rcy rad ris rlm
kih: kyg kgf kws ken knb kqi
kns: kqi
kuw: kov koz ryc
kec: kzd
kqf: rka rbw rcq raf rwb rvc
kia: khb kyh kjw ksv knt
ril: rit rlj rjo
ray: raw rhp rjz rvl
rkc: rax ryz rdm
kub: rrv rce rhu rgm rwk rdk
rll: rji
raf: rhn rye rlm
rip: ryy rgc rga rgx rdk
rky: rrc ryc rgg rdh rvl
rkp: rrs rcq rco
kni: rgh
kch: klm kjl kxd
kvm: keo kpf
kkk: krb kra kbi kah kan kyc ken kxe kpc kpp kff kqb
kxd: kps kpx kfw
rru: rin rht rlu
kuz: rrn rbo rct rie ryb rlv rgc rjn
ryy: rwz rvr
ksu: kxj
kam: kvx ken kxl kxg kza kzv
kyt: kvm kev kxj
rlm: rlf rdv
riv: rht ryv rjk
kak: kgu kdu kjc kpn kzr
kxz: kmj knu kfn
rkl: rcy ral rik rif rhh rhz rlt
kls: kwk kjy ksh knz kqy
rdx: rvc
kcn: khv kvg kef kpe kfs
kwb: kmn kna kni
kcu: kih klu kvd kxf
rax: rat rjz
kml: kng kzm
kkt: khp kho kyq kgv kgu kwh kvz kpn kzr
kfr: kfi
krq: kjx knn
kro: kbo kgk keh kqa
kox: rba rlq rgy rdx
kab: kao khp kgc kvh kxc kxu
kib: kgd kwq kdx ksx kfb
kgp: kjk kvl keu kxa kps kzm kzf
kje: kpz kmh
kcg: khr khe ket
rij: rlh rlj
rgl: rjs rjq
rwo: rdc rjx
rjf: rvy
rba: rbl ryv rlx rlo
rka: rrh rbg rlu rgw
kdp: kpx
kun: rrj rcv riw ryt
kbk: kcv kgc kxw kxp kzd
kei: kxi knn
kar: kau khf klc kmn knx knt
ksn: kep kxy kza kzg
rhr: rlz rde
knx: kzm
kll: kgd kdb kfs
rcr: rcj riu rhp rgv
kke: krp khi kwu kjg ksm kzb
kdy: ksu
kge: kwt kjb kvd kek knn kfw
kis: kwt kva kfk
klh: kge kwg kvs kzi
rci: rav rat rhy
krf: kck kid kij kio kxs kpg kpj
kxr: kpx
ktc: rbv rav rik rhs rhz rvh
key: kpz kzr kze
raj: rya rdp
ksk: kst kmp kno kzk
rdr: rdc rjo
ksc: kmo kzg
rki: rgy rwn rwq rjo
khj: kyk kyn klr klc kgi
ryw: rym rlo rdy
keh: kmm
kqm: kqq rbk rbn rhd rjm rvh
rhn: rlo rwp rwt rjd
rlh: rlw rdm rvy
kco: kiv kyw kgm kxi kxg kmo kfz
kyg: kge kdc kdh kjf kse
kil: kds kdq kvl kmw kfa
khd: kja ksm kpf
kcj: kas kau khj kli kec kma knm
kka: kwi kef kml kfv
rab: rwl rdg rja
rhb: rgk rwx rjj
rdl: rvi
kwr: kzg
kkn: krt kbv kbo kig kwo kjq kel
ktk: koc rkg rkv rks rit rhy rwb rjh
rks: rys ryt rle rlp
knk: kfc kzd
rrk: rcs rir rgi rgs
kfj: kfn
kou: ras ryw ryd rye
rwx: rdi rdo
rdc: rdp
rat: rdu
rio: rhf rdf
ktu: koy kol rki rkd rrg rav rhk rhx rwa rds
rak: ryb
rcx: rhx rwr
rcy: rct
kyi: klp kgj kgu kjm
kmg: kfr kzw kzn
kkg: kcs kyh kej kxj knd
ksy: kxo kmy kfh kfm
koe: rav rlr rlc rwv
kcp: kar kiz kes kpl
kot: rrw rax rht ryd rls
knc: kns knx
rcq: rie rgv rda rjh
rko: rrp rrn rbn rcb raf
rix: rhx rly rwr rds rjs rjz
kkr: kaf klp kxz kps kni
ktm: rbw rid rhp rhm rhu rgb rdy
kle: kwe kvy kpc kmp kzp
kjw: kpk kfz
kly: klw kgf
klj: kvn knd kfi kfy kff
kvs: ksz kmx
kit: kly kjz kpq
rim: rhv ryt rlu rwl rws rwf
kxy: kze
kqr: rro
rdq: rjp
rbz: rhm rlr rge rjp
kfx: kzr
kku: krg kig klr ksn kst kmg kzq
kla: kjs kmh kne
knm: kzy
kaa: khr kyd kvt kfq
ksq: kxa knj kfx
kgj: kjs kel kmd kni kfq
rhh: rgj rjb
kth: kum rlf rda rvh
rbo: ryx rwn
kht: kyb kjw kjv kvd kew kes
kdw: ksk
kkp: krw kan kgn kdk kvd kpj kzz
kyo: kpy
kgw: kgx kww kdb kzw
kdx: kvj
ksa: keu kpa kfa kzd
kpt: kfp kza
kes: kpb
rlo: rwv
kvg: kpy kmu
rya: ryq rlu rjc
kmi: knr
kcb: kiq kyd kjw kst kpq kmk kmd kfa kqc
kef: kez kxn kqh
kdj: kmm
rlu: rjw
kwf: kwt
rbw: rlm rln
kvk: kxe knz kfk kfa
kkl: krv kyj kjr ket kpz
rbx: rcp rhq rlb rla rju
rbs: rgb rwr
kwd: kwm kfd
raz: riz ryu
ksr: keo
kxb: kzh
kvu: kna kfe
kin: kif kgl kdo kvr
ktx: kum kol rrd rcd ryn rwq
rbk: rbt rcp rad rhz rge rdy rjk rjf
kzp: kzn
rkx: rck rir rhr ryr rlc rln rws rdf
kra: kgj kju kpc kpf kmm kns
rjh: rjo
kjz: kxa
kng: kns kfm
kjt: ksf kpe kny
rbg: rcn rai raw rax ryd rlj rgd
kyw: kyu kjx kmk kfk
kdz: kvg kpu
kwp: ksu kzo
rwb: rwh
kvc: keh kpa kma kmx
rgf: rdi rvl
kcd: kaj khr khy kyr kwc kdu kmw knr
koj: rbd rbs rir rwe rdy rds
kij: kdi kjl kvy kmh
rbm: rgb rwv
rav: ryq rlg
kvb: ksc kez kfo kzz kzu kqi
rbt: rcg rhl rwr rdv rdn rji rvi
rai: rgj rjf
kor: rrq rib rwt rjt
kdi: kdn kja kpu
kcf: kaq kig kww kwp kvw kzk
koo: rku rct ryf rlt rgv
kbm: kau kwn kdr kew
kma: kzr
rbp: ric ryq rgk rwy rdb
kva: kvg keu kxw kzd
rgi: rdp rvk rvr
krt: kcw kau kdj kjz kvh kvs ksk kzv
kjg: kpv kpu
rkh: rho rjd rva
krc: kbi kaj kwl kjf kpa
krr: kry kwa kja ksv kxk kpo knc kfj
koz: rbg rbs rbp ryc
rbv: rig rhm rwi rws rwf rdc
rkz: rii rgc rgj rjp
kta: rbw rbq rci rlt rdu
rrw: rbp ram rwi rdb rjy
rwl: rvb
kky: kht kvk knm kzk
kkx: krm kmd kfr
kjf: kvj kfj kqi
klk: kjy kje kfp kzk kqy
kgy: kvg ksq kmy kfn kzc kzu
kuk: rah rim ryy rlu rgr rww
rwg: rdj rjw
kwg: keb kee kmd
kmb: kfx
kln: ker kpk kpt kmb kmw
rwc: rji
kct: kiq kdl kdz kvi kvs
krz: kcc kiq kgz kdw kpe knq kqk
kob: rra rcf rax rin rym
kys: klw keg knv kzl
kep: knp
kgz: kms knz kzx rwg
kkw: kyv klc kda kja kvy ket kmm
krs: kcc kij klu kwq kms kqk
kja: kmp kzf
kmn: kzd
klr: kgw ksw ksd
knr: kfy kze
kdf: kjh
khz: klp kwz kms
ksd: kpe
kds: kvh kev kmw
kbl: kcp kyj kwr kwd kwm kdm knw
kmr: kmv kmz kfr
rwt: rdw rvr
kwn: kdt ksb kei kzt kzo
ryp: rlp rwy rdd rdm
kvn: kxq knt
kpf: kfi kfo kzz
knt: kff
kpn: knl kzt
khp: kls kst kph kno
kzt: kqr
rwf: rwq
kuu: koa raz rgn rgt rvb
kga: kjo kvr ker kfr kfe
riw: rlr
rkd: rko rjo
rly: rwg
kie: kex kmh kml kfx
kpr: kmm knj knv knx
kxt: knh
rcj: rav rhh rya ryv rwj rdo
kcz: klf kwy kwz kph
rwn: rdx
kgm: kex
kpj: kma knh
kem: kef kmr kfy
rgy: rwv rjy
rwd: rjg
kum: kol kov rrk rbr ryg rgo rww
kgc: kge kvn
ryc: rye rje
kyc: ksg ksj ksv
krb: kcp kjr kfj
kdm: kjw kvs
rri: rye rgp rde rvr
rcf: rad rie ryz rgt rjm
kst: kxr kxv kxo kfa
rrp: rbi rij rys ryx
rgg: rws rwf
khg: kls kgd kjk kva ksc kmn
rrh: ryu rgp rgn rgu
khf: kwr keb knk knj kzy
rib: rhg rhs rlw rdh
ric: rli rgf rdm rji
rre: rrq rck ris
koy: rrb rar rhe rgs rwk
kaw: kiu kyf kjb kzh
kgn: ksg
kve: kev kxn kne
rws: rdr
kbr: kbp khk khu kly kwg kwf kvx
kvi: kxw kfc kzw
kwo: kea keg kmi
klu: kgh kdr
rid: rgb
ksv: kss kxs
rln: rjy
kah: kyo kju kxy kpz
rjl: rjp rvb
kha: kwq keb kxa kmo
klo: kgh kdi kdl kdt kxh kxt kpm kfa
raq: rhk
kxw: kpm kfq
rlw: rdi
rrn: rio rhv
ked: kpo kmv kmz kzi
kbz: kbo kys kgm kwr kwy kws kdg kza
koc: rkv rby rlw rle rge rgp rdz
rgh: rgt rje rju rvg
rry: rcm rio rhe rdn
rcd: riy rdt rjq
rhk: rhj rwp rjp
kan: kit klc kes kep knu kno
kyz: kgp ksw kel kxc kxa kfl
klx: kss kpm kqr
kwl: keh kxr
kol: rkk rib rie rjr
rac: ryz rva
kya: kvo ksr knf
khc: kwy kwj kps kqk
riz: rhh rjx rjp
kau: kys kvy kez kxm
kbj: kgx kji kje kmx kzb
kda: kxk kxw kxs kpc kpe
kyj: ksf kpq
kvh: key
ktn: kuf rrw ryw rdh rdw rjk rjm
ryb: ryp ryn rlr rlm rva
kxj: kpb kfu kzj
rjd: rvg
kug: rkk rcd rak rye
rwv: rjx
kuj: rkb rrn rrz ryn rwd
rge: rwd
kli: kdw kmb kfj
kvq: kxl kmu
rye: ryp rwk
kyk: kwp kwf ksc kep
kgb: kdp kjo kxx
kxa: knz
ktv: rcv rgx rdv rjb
kjy: kxs kzy
khb: klk kde kdm kjd
kcy: kwo kjl kvz kme
rkk: rro rcc rha rlq rwl
kon: rbr rhu ryi ryp ryf rll rvk
rhi: ryw rgs rjq
khh: kht kwd kwu keh
rbq: ryr rls
kwu: kjc knp kzr
rro: rbh rlf
kzz: kqc
rkg: rkw rai rha rhd rli
kbf: khi khv kjc kxv kzg
rgv: rdx
ryx: rli rwi rjg
rah: rye rje
kwq: ksk
rhf: rgj
rwp: rde rdf
rkv: rcn rge rgq rwq
rbh: rbd rbs rid rwj
kac: kjr kvu kmm knx
kdr: kvy ksm kmj
rcz: raj ris rlb rwa rdr
ktq: rkn rai rhk rwx rdl
kyn: kxe kmn kny kfl kzb
kyu: kdo kvy kvz kfy
rbf: rch ryk rlw
krj: kcf kyg ken kxm kpb kzm
rbr: rbt riv rim rhj rys ryq
kdt: kje ksm ksq
kcw: kin khz kdk kep kxe kzy
kic: kyq klc kqh
rck: ryx rgs
kej: kna knl kfc kzl kzx
khv: kwi kfh kzb
rkf: rbu ria rgt rwm rvh
kbh: kly kdx kdt kei knu kfu kqr
kjc: ksl kzs
kye: kga kgh kwl kwg kjm kex kxu
rlg: rgf
ryq: rls rjv
kdo: kvm kxj
ktp: ryk ryx rwv rwf rdr
rkn: rru rwa rdc
kim: ksj knr kfc kfs kff kza
rae: rib rhc rgf rvr
rcb: rlg rgq rwg rdr rjx rjf
kvw: keb kez kmj
rhp: rlt
kwy: kdj kjc ksj kpx
kwt: kjc kve ksa
kbc: kis khr khn kyk kgn kdd kjy kfd
kpw: knl
kcs: kct kwg kxx kft kfu
kvf: ksf kec kxo kme kmf kfe kzf
kqo: kta kui kok rip rhd rds rjx
klf: kwf kjo kvu kxx kpp kfm
khi: khe khn klv ksl kmo
rik: rge rjp rjm
kig: kjm kvr kmh kzq kzt
kgv: kjw ksp knw knn kfb
kjp: kvl kss ksm kzo
rrd: rcx rcp rjf
klw: kjy kee
kue: rrj ril rix rio rhh ryz
kms: kns
rrb: rca rct riq rlh rda
ryk: rjh
kxu: kqy
krp: kaq kxs
rit: rgr rwa rwq rdl rdo
rdm: rvg
rrf: rcy rgf rwc rdq rdu rjv
ktw: kua kuo rrw rba rbe raw
rhv: rwm
kjh: kjz kvj
kuc: kob rbb rak rhl rho
rlc: rgw rwz rjt
rih: ryw rgr rwf rde rjv
rbl: rir rhf rwo
kyx: ksd kmh
rlt: rwb
rby: rbu rdd
ryt: rgb
kos: rcm rhd ryb rjj
rhd: rja
rct: rdv
rlr: rlt rjf
rds: rvb
knf: kfw kfq
kwi: kwn kdy kde kxd kxv kml kmm
rcp: rcq raq rli rvc
kyv: kdn kvr kea knm
kgq: kek kpi kzy
kyl: kdy kmo kng
klt: klu kxz kmz kmt knj
knj: kzl
khs: kyl ked kxo knb knq
kov: kot rcz ran rik rli
kad: klc kgq kpu kzf
kcm: kdh ket kxv kpm kzr kqb
kfd: kfm
kai: khj kgu kja kne
rwe: rwo
ktg: koa koi koq rab rgx rgo rdw
rwi: rjn
kdh: kje
kmz: kzr
klp: kjg kef knm
rir: rdy rjs
ktb: rry rrm rrq rcr rlm rgu
kqs: kte ktf kut rgl
rdu: rjb
ktf: rbb rcd rhb rhg ryo rwu
rif: ryt rwy rwj rde rjc
kpk: kff
kut: koi rke rck rak rlo rda
kew: kxp
rli: rgf rdo
khq: kla kxl knk kqr
ran: riw rhy rgz rwh rwq
rlj: rlt
rrg: rcb ras rao ril rhl ryy
ksg: ksz kmc
klm: kdg kfb kfd
klb: kjy kpv kpx kfv
kde: kxy kmz kzw
kkf: kbe kiu kgs kdz kjy kvn
kwh: kdf kph knt kqc
klv: kdv kjt kso kzo
kav: khg kyh kdh kvp
ryj: rlr rlb rjf
krk: kbd kbn kiz kvg
rcv: ryw rlv rgw rwd rwj rds
ktl: rko rao rir riw rlq rgt
rar: rhb rjl
kcl: kam klm kjk kjv kni kfh
kts: kup rhl ryi ryg ryx
kas: kle ket keo kng
koi: rcu raa rah rwi rjb
ktj: kui raw raj rgx rdr rjw
ktd: ktf rkp rbe ras
kba: kch kcz kgu kgo kwc kda kpc
kmo: knd kfb kfc
kiw: kip klj ksn kpk kpb
rag: ria riv rhn ryy rld rdc rdw rji
rao: rhx ryt ryo
rrj: rrx rhl ryu rdg rvy
kbq: kcp kdf kel kfv kzf
ryl: rgr rwx
kex: kmc
keb: knh kzs
kaf: kll klv kdy kxt kmb
kxi: kfj kfe
ryo: rln
kjx: kqr
kyq: kdk kdr kdy ksj
kqe: ktv kox rkf rbm rdn rdq
rhe: rvb
rrv: rrp rdd rja
kiz: kdi kdn kji kjg
rkq: rct ris rhr rgo
rhc: rdw rjr
rcu: riz rgt rwv
kqu: koq rcs rct ram ryc
ksj: kxb
kme: kzs
rjp: rvg
khn: kwz kde kjf ksi kpf
kdq: knp kfk kza
ryi: ryj rjj
kuv: koy rbj rbt rcq rih rgc rdp
rbb: rha rle rgm rdg rdt
kay: khf kwl kdf kzc kzq
kiq: khe kyd kwk kfi kzy
rgs: rgu rwz rjs
kzr: kzf
rkb: rbh rbw rcm rcu ray riw
kpq: kmv kzk kqy
khw: kly kln kdw kpd
rgo: rdc rjq
raa: rai rap rlc rvg
rco: rab rae rir rym rgc
kju: kmj kfq kzs kzu
khy: kwu kzu
ria: ryp rjl
kii: kgk ksz kxp kfy
kjk: kvq kpg kfl
rbn: ryr rww
rkt: rhi rll rlj rdl
kjq: kvm kmo
kgs: kgz kmv knw
rbe: rij
rrt: rbf rcp rcn rag rhw rhq rwg
kwx: ksj kxv knh kzq
kvd: kss kft
kiv: kvd keo kzi
kkh: krq kaa kyh kgo kfz
kus: rbh rai ray raz rhr ryk rlk rlp rge rwh rjr
rcw: rho rle rwx rjq
kua: kul rrm rrn ras riu rjc
krl: kyx kwv kjj kjq ksr kpt kzi kze
kjj: kju kvw kmm
kfc: kfw
rgx: rjc
kvr: kvf ksu kxa kxi
khm: klt kwg kfs kqh
kcc: kip khu kgd kda kjp
kjo: ked kzr
kre: krn kik khb klc kvs ksx kfp
rrz: rbr rcx rhv rhs
ram: rgg rwj rdl rdn
kuo: rcg rhc rhi rwa rdq rva
kgk: kdk kvs kev kmx kfz
klg: kgz kdb ksj ked
kul: rby rcy rae rau rik rlx rwu
kxg: kpx kmi
kek: keq knm
kal: kir kmi
kxf: kpn kms
riq: rgh rdg rdj
kgi: kdg kjc kmm
riu: ryl rjd
kkj: krq kau kya kyy kgv kgf ksq kzu
rku: rai riy rio rho
kmw: kmm
kkv: kcl kih khf kwj kjx key kxo kpd kpt
kpl: kmf kno kfs
kyy: kgh kwc kvo ker kei kzc
kxk: kfx kfn
ker: kez kpo
krg: kbk kao kwf kdp kjc
rbj: ryn rlp rlz rdb rjs
kdn: kzh
kkc: kcb khy kvo ksj kes kzi
kiy: kiz kgt kny kfb kzc
rhz: rwx rvr
kqd: kth rkh rrl rbn rld rjw rjq
kcr: kca kle kem kpg
rrr: ral rax rgd
kqq: ktb rbb rar rau rlu rwt
kbv: kcg kjx kec
rau: rlt rdr
rwy: rjl rva
kio: khc kyo kwa kdr kdv ksa kea kxh
kyp: klq kxh kfs
rwu: rdb rjx
kxo: kmc kfo
rii: rhu rwh rdk rdb rjy
kxp: kmg kzw
kmt: kfk
kww: kjr ksu kej kng
rda: rdu
kri: kry kso kxh kfa
kji: ksk kzu
kvp: kvo kmo kzj
rga: rwf rjn rjo
kjv: kxw kph kpo
kci: khp kyb kgz kjn
ktz: kom rra rix rhq ryh rgd rgp
kkm: krz klb kjn kvl kqc
rrl: rrg rhp rho rgr rdd
ksf: kem
kao: kic kgt kdx
kev: kxy kpv kqr
rrc: rrq rwf
rkr: rkz rrc rrh rhw rho rly rjw rjt
kwz: kxu
kpe: kfp kqa
khl: klm kse kmp kmf knp kzk kzw kzp
kqp: kqt kuh kof rlj
kbp: kch kcj kcm kdq kjq kvh kpi knf kfe kzn kqa
kqt: rkc rka rrh rig rlg rjg rvk
krw: kbb kiz khy kgr kjn ksg kee kxi
kwe: kvf ksz kqy
kho: ksf kmg kzb
kfs: kqh
kld: kgk kwm kzf
khx: khu kna kzh
kry: khc kdr kjs kvc keh kzj
kux: kop kou rkf ryi ryx rdj
kea: kxm kpz knz knu kfk
koh: rbh rbj raq rwe rwz
rjn: rjo
rrx: rbm rhe rht ryh ryf rjf
kdd: ksl ksv kxm
khr: khq kgq
kvv: kvu kmz kmo kfc
kuf: rri rba rid riv rif rwe rwn rjv
rcg: riq rlj
rbc: rbe rly rjg
rce: rhy ryy rgk
rap: rga
kff: kzd
krm: kle kdz kxe kmz kfu
koa: rkd rkx rrr rjh
kog: rru rax ryd
kud: kuv kuf rry rla rll rdt
keo: kmv
kxl: kpe kmg kfl kfv
kuh: rra rcy rcf riu rhg ryi rgy
rkw: rlq rwb rjb
kjs: kxx kmb
kxh: kzw
keu: kxv
rjr: rju
kgo: ksm kmq kni
kod: rby rbt rbo rci ryo rlm rwt rdt rjj
kqw: kuw ryd rys rwo
rlk: rdz rju
kjd: kvc kft
kwv: kjh knp knu
kgf: kvo kpl
rha: rhq rjz
rcl: ryc ryg rlu rgc rdi rjh rju
ryf: rge rji
kpy: kfp kzu
kif: kwc kjj ksx kev kxp knw
rld: rlt
kny: knj kfe
rwa: rjl rvl
kkd: kkz kyb kvv kfe
kmu: kfm kza kzu
kqj: ktd ktz koi rjm
kgt: kjt kvb knf
ral: rwe rdh rvr
kvl: kmr kmt knl
rgj: rjz
rlb: rlv rjj
kgh: keb kec kxt
kso: kxe kno
kbd: kvr kvn ksg ksf kez knf kzv
ryg: rjk rje
klz: kgn kgf kmb
rjz: rvy
kpu: knx kzh kqb kqh
kgu: kfg
kik: kdm kvx kef kez
klc: ksf kxl
rcc: rwa rws rjb
rhg: rlm rln rjd
kvz: kem kzm
kwj: kjx kna
ryr: rwb
kfh: kqa
rlz: rjz rvc
kyd: kyn kmb
kbg: kbq kcs kay kie kge kwf ksv kmt
rhj: rjp rvy
rgw: rvi
kjn: ksm kxa kml
kbb: kck khx kyl kmc kmd kzg
kdc: ksx kno kfu
kto: rak ram riy rig rij rit rhu rwp
krh: kat khd ksd kzi
rde: rdm rjt
kae: kiu kdu ker kft
kvx: kpo kmq kfb
kof: rbj rbf rhs ryb rys rgk
knv: kfx kqr
klq: kvp ksr kso kfq
kgr: kee kxa kzy
rra: rbq rgt
rkj: rkf rkt rrb ryw rgn rgo rdx rdu
kjl: kmv kft kzw
ksl: kxg kmx kzh kqr
rhm: rgd rgq rwr rda
kse: kpd
kpx: kqh
kom: rru rhm ryw rys rls
rbi: rhg rhp rja
rrs: rbs rap rju
kqx: rcx rlr rlv rdo
kca: kad kyh kvd kxq kqi
kgx: ksb kej kfn
ryz: rva
rym: rgx rws
rlv: rlz rgh rdw
rgq: rgo rdf rjd
kym: kgx kmk kzp
rcn: rip rhi rgh
kjm: ksk kps kzj
kmh: knk
kaz: kym klz kjg kxa knb
kxc: kpk kfe
kbw: khd kga kgs kwr kwg kfj kzv
rgm: rwe
kqz: koj ria rha rgr
kck: kcp kam kdm key kzx
kws: kvq ksq kez
kph: kfx
rhx: rjq
rbu: ryf rwc rdt
rlx: rwk rdm rdf
kyf: kgy kwc kvh ksc ksx kmk kna
ksm: kne kfv
kap: kyg kyz klr kld kwg ksy ksx kpe
kbu: kyo kgv kwo kdo kjs knq
rch: rar ris ryx rwl rwp rdj rjj
kwa: kwy kpg
rhs: rlk rgu rdk rde
kez: kmq
kui: rgw rge rdv
kmm: kqi
rkm: ryb rlo rwz rwo rjm rjf
rdj: rjh
kss: kqr
kbs: kjq kpp kmc knp
rhq: rla rjl
kcq: kal kie kly klm kgw kxi kmu knl
kpi: kze
rdh: rjz
kkq: kch kyp ksi ksf kpi kqy
rht: rwb rdw rvi rvl
kqn: ktb kur rad rgk rgh rdq
rcm: rhj rgb rjw
kcx: khy kwv kpw kmf kfv kzj kzx
kur: kop rki rrp rcc ral rag riz rio ryo rgr rgl rdi
kip: kst knx
khu: kwd kse kmn
ken: kxw
kaq: kip khr kvp ksi
rlp: rwr
rca: rva
kti: ktd koc rri rwk
kjb: kfo kqr
kvt: ket kzr kzn
kbo: khv
kbe: kwa kwl kdv kdf kpj kqb
kix: kiu kyb kyc kgb kvd kxp kpa kfl kqr
rgn: rdf
rbd: rii rls rlf
knd: knq kzf
kkb: kkx krv kjc ksu kfa
kpp: kme knw
kow: ran ryg rww rje
rhw: rdb rjp
rie: rdw
kup: kut rbs rid rio rjr rjq
kgd: kwb kmj knj
rin: rhe rhf ryt rjg
kqv: ktk kth ktw rce rjx
kuy: rbv ryc rdp rjd
kid: khi kyi kwb kjz kxb kmf
kce: kjo ksr kek kmy kmx kzc
ksp: kxd kpf kmi kfg
rgz: rdm rje rvk
kdl: kjd kej
khk: kyx kls kgt kjq kvz kse kfz
keq: kxr kxp kxt kfw kqc
rdi: rdp rjl
kko: khj klp kgw kwb ksy
keg: kpy kmd knn
kkz: kiw klu ksy ksd kxb kze
rdz: rjg
kdk: ksq
ket: kpi knp
kks: kif kha kyb kxz kpe kma kfg kzw
knz: knq
kyr: kgh kdc ksp kpk
kgg: kdy kpy knj kzc
ksb: kxf kmp
kcv: klt kda kjd kjt kez kxe
rho: rlq rdh
kmd: kfu
kru: kcb kly kgm kdh ksq
kyb: kyt klj klu kvp keg kni kfc
rlf: rgz
kxn: kmb kfg
kby: kii kyp kdy kxc kmq knc kni
khe: khx khp kwf kdv
kop: rbc ryg rye rgm rju
kok: rad rat rgq rwf rdu rjr
rke: rkt rrh rac rgi rdt
kyh: kgi kfg
raw: rha rwi
kaj: kas kls ksy keb kzz
kdb: kvh kpl
kvy: ksy kxv kne
kat: kvz ksk ksd
krx: kbm kio kgt kdd kpp
ryh: rdo rvl
riy: rhr rlp rdb rja
