jq: pw mi mj nv
ml: ny
mb: mc ms
ly: gg
iv: lg ln gw
dn: je vv vs eo pt
av: am yd yz wq db
vq: sj my nj
wz: wt wo
ci: ys le gc wq
ey: py mf nh
lm: gk
em: pv ni
rc: iy iz hd lg wj
rg: rs rm ck ig yn db
mo: nv nx
en: xn
ii: im lv
kj: kv ro lo
ab: aw ao gk
vf: xk pc ph md mz nk
iw: hx la gz
yr: wm wz db
ce: yy ld wj
kx: kz rp bl ck cr ci hj lc
mr: mn nx
wm: wn
mv: nc nh
lp: gp
gf: ww
xj: ps pt
pk: pr ml
jn: vj ew pr
dj: jd ss ek ma mn
ix: ip it gb wv
ck: hh yx gv wu
pd: ps
ec: ei em en xq mo
xn: xt pt mj nr ni
cr: ag il gy
au: lb lw
pc: nc
pt: ms nb
et: xh nw
st: pl pd nx
bf: at ih hj wk
rb: rq bi bl cg il ga ge
hh: wy
dz: jx jn vg sy xf pn pq ng
ht: yv yq gk
ss: sf sz ei xy py mi
vi: eg pk
lk: wh
hb: wy
ij: hx yw lq gh ge
bk: aw iy hu ym lg
aq: wb wa
hm: yy yl lx wj
bd: cj ws we
cv: cx cf ii wf
sp: sz xp mj
ju: ed xq xt pg
gl: gz gq
rj: bm cx hk hn yq gb
rh: ru bo cb hw gx gt wr
ef: pz ms nw
lu: wy ww
iy: ij hq lc ly
bn: ca cz ad ae hf gi
cl: yk gm dc
gm: wi
pp: nk ny
ct: az it hf
ih: gi gj wd
sb: sh xv pz
ip: hv
eq: mz nj
az: yy yt gw
yv: lc wi
vw: vu sa ph mb mw
bc: ci an id iv yf lz go dc
ch: cz in yk yb ge wh
vc: sv el mv mp
ra: rg he yg wh
xk: pz mx
bm: ht ym la gg
rz: by cg aa ia hq lm
ex: xg ps
an: yw yd yv yf gy
eg: pv mm ni
bw: bs cr ad af wy
rs: wo
if: ge gn
kq: rb ap io ye
bq: ap ix lw lu
rn: bk iu ga gj
bp: ca ie hs lk gp
ea: ns
mi: mz nc ny
jz: sl xl mb mt nr
jx: vr se xm pv
vh: sg xx xz mr mq
yp: gx we
yc: yt ls lq gk gy
cm: cf iw hg hf lv gy
yw: gc
jk: ji xg xu pz po mj
mj: mn
nk: ne
kn: rs be bp ap iu hy gz
ry: ru ci ih gw gm
lf: gb wc wd wz
jh: es xc xl xx pf mb nc nj
sn: mk mj mt
dp: jx va vt sd pb na nw
hj: yx la
mx: ng
ls: gm
xz: mv
cy: cz ia hw wt
vs: eb ej xi xn pk nk
sv: pw ns
me: mu nh
ha: hi hg yr yb ya gy wa
ai: lc wf
yn: wr
ve: sf ev xk ma nc nd
sd: xu pi np
li: ly ll
af: ig gn wz
ib: hq wx
jt: vl ey el xo mq
cq: ct ax ir ia la lx lt ws
il: lj wj
hf: gg gd gt
yt: gx
ya: ln gc wb
ei: es xa
vb: sh ep mg mq
dy: vm sc eb xm mh
dl: dx dz vx pw px mp nc ng
ga: wm
eo: xj nb nl ng
xv: xf pc my ny
jg: vb ec xl xo pk nj
xs: po mg mq
hc: hm yz dk
kt: ko ri cg au
pg: pj pn
gp: ww
cp: aa lv gt dk
ej: eo xw xu mw nj
kr: rh cc he gf go
el: mm
iz: iq yz gb gs gt er
kg: ks ca az au gu
sj: sp xx xf pb ph ma mp nk
pj: mc nk ny
lo: wi wv wn
hs: hq lv dr
ee: xh xe xm nk
my: mg ns
ew: pu
ho: yf lm gy gj
ki: bb hq lm gr wv
ws: wp
cz: ai id
aj: id gf wx je
xq: pq
vn: xp xo pk pj ns ne
mc: nd
rf: cq ag yw ym we
ps: px mh mw ms
mu: np
mm: mf
kf: rz bc av wl
dk: dr
hg: hs yb yy gl
ym: yf lk
sx: pb mg nl
kc: kp ip iq hk ht wt
cd: hu yw gi gv gx go
lz: wq
hy: hw lg ls lp lt gc gw
al: am io lr lm
jw: jt vm sq ea ep pk
ez: et mi
vv: vs sr sf ec pe
rp: as lb
hz: yb yd lf gf wk
bh: cg ip im in
dt: jm sn ex xp my nh
nc: nj
lq: wg wm
pz: na
pr: pc pv mc
je: jz vi sb ef xh mf
ji: jh vp sr sa xa ps ml
km: rq aw at ya
py: po ne
gs: wk
hr: yh lr gq
bx: bz ai ya lz gm go
er: xd xp pl
rl: av ib gn dk
rw: bq cp as ya gb gh wr wa
xe: pk ml mf ne
js: sb sc ey pk ml
be: ar ag ax at ik li
xd: pe mr
sr: ek ep xg pr pz
hq: gv
hn: ll gx gm
gd: wm wf wu
lj: gk wq
dx: vi sq su es ex xb xi mb mp
va: st ez xv ph
le: wt
yz: gk ga
id: if it hr hz wk wb
rm: ca dk
kz: bf cb yp
jc: jf vj eo pr md mm
dg: jo ew mb mo
jr: vk xq pc pg ps nb
eh: ee ef pj mr md mx
pe: mk ms mx
ik: lb gk gg
ro: bd cl ct ay iu yq gi gx db
ac: aj ym yt wp wn wf
yh: yt wy dk
yx: yo lk gs wl wg
sa: sh ei eg eq xo
ll: wb
cn: co ic yr gv gu wc
pq: mk ms
rt: bb ag iq hb yn ld gl gm
ru: bc bg bf bu ye
da: jj vj vm ew xr xj px nb
sc: ee pu mu
de: dx jr vr xr
cf: ab im
sl: sq su xx pu ny
bz: cj al ae ie hb gw
vu: xe mm na ni
si: es ep xs pg mg
kv: bk is li gf
io: hy wg
hx: ww
ie: he lb wc wl
kw: cr ci ar hl hp yt wz
cb: cf lb wx
dm: vv ed ma
rk: rd aw it yi
vo: sy eh ez pl mr mf mu
jj: vr ey ep xk xz po na
ku: cl cn ir iw iv ly le
ld: gu ww
ay: hk ll gb
rr: rv cq aj io hn
yk: gg dc
rv: hh lk ls
ic: il yv gr gs
ye: lb gf
sf: ex nv ne
cs: aw la le
lv: wa
bu: cb aq hr yu lb lv wy
ep: xm pf mh ni
eb: el ep xc xe
bi: bt yg gm dc
gn: wb db
ge: gf
dw: dd vr vq sy eb ew xw
ph: mw
la: lw
xw: xf
jo: pc mw nl
jp: vb vv ve xj pa
hu: lm gn gf
jm: vp sw sf em xq
br: as lh lx gb ge
ys: lk gi wi
dv: jd vx vt en
lg: wm
ax: iw lq wc
jv: ve sa py ng
yo: gy wy
ae: au ip iu ww wx
im: yj yv wb
is: yq la wr wf
ah: ij ht lu gt
by: is yx gp
ky: rp hx hp yx gh ww
mf: na
yb: lx
vm: mc
bb: cx ib
jy: sv st ej en
gj: gv
cx: ih iq yd lb wv
iu: hk
yd: yx
sw: ea ej pi mv nh nl nv
jb: vx sy xb
vd: ve sb ea ez xv pd pf
dq: el ed eo xk nh
df: jq ea xa pl
vk: sj er nc nx
ds: jq si sg ey eq ma
wx: wp
nd: nx
hw: yb yg lz
ks: ra hr hg lv gc
rq: bd bv ca hm wy
vt: ew ex xn
yu: ga we
xg: me
vp: ec xa xm pk pi nv
ek: ee mp mn
sz: st so eq xd pu mf
kb: ki kh bm in hb
in: gj gx
pm: pn mh np
kl: kj rs rx ax az lv
cu: ir yt wv
ed: pd ne
sq: eq xr ph
pv: me
dd: jy sb sm st xj xz pm nr
kp: rk am yv ld gd gq dr
ca: cl ap yp gr
xb: na ni
vg: em mz mt
du: vd vv et xe
kk: ke ku ru ce ay lr lh lj gr wd
cc: cp ig hp yu le gg
pn: mg ne
vz: vu ef ph
eu: xd pr me np
jl: je sh ed en pn nj
gi: wq db
yl: yw lp ln wd
yy: yo wu
ir: hl lw
ke: rv bw az lh wj wm
pl: nv
mk: mh me
wy: wz wo
ag: aw
wf: wu
co: gv wn wo dr
ia: hv ht yg lb wp
xt: pl mm nh
pb: pu mu nh nd
gq: wb
mt: nj
hd: hu yp wo
vl: sy st xs xt nv
ri: yi lp gz ws
xc: mo nk
he: wr dr
hv: yi yt wj
rd: rx ar ip
bt: cy ah yt lq wq
cj: an ii ym gj ws wz xy
yj: wk wy wf
jd: vn ed pp mi
hk: li ge ww wv
lb: gt
di: dm js je xb mj mt
pa: mp mf
at: ij la wg
cw: ad io gm dr
xo: np
gk: gn wj wt
as: yq wn
se: el xl pi po mt nk
es: pk ml
ka: bi bo yg ym la
bv: aa im ly gj
xp: my
jf: vo st xh
ap: ig lc gv gz wm
ig: hv yi yu ln wf
pi: pq mk
xx: mp
re: ic iy hh hu ll
am: he lh ge
lr: gh
sk: px mg mm na
hp: gp
pw: me
sg: ec ey xw xs pf np
cg: hx yy yp
yf: lt gi gz
ba: ai aj ii ih hg
xr: xt pq nr
bl: ch iu
bg: lj gn gt ww wj
aw: he yj lq
ja: jv jf vz sp er ei xr pj pz pu nv
rx: rm bb bv cc
bs: ch cw ih wl ws
bj: bq ch ip yk lj wh wl
xf: pe
yi: yh gg wp
wj: wu
kh: cv ce ab at lf
xl: mh
bo: ar ay in yy gg dc
vj: ee pa py mc
ad: in hh hw ly wn
do: jb jz vq xy
hl: hx hu ye lo wp
ak: aq au ib ic iw hr lx wn
vy: si ez pb mz
xi: pp po md
lt: wb wc
so: et mr ml ne
dh: dg vc sg nh
ao: hk hc yj ys yz gu
hi: yh yj yn lv
xy: pc pn mp na
sh: sj
xa: xd np
sm: ed xj pr mu
kd: ra bv is ye wn
aa: ii ix yb yg lw
ko: rr bw bz cs cu av if db
su: pz nx
xh: nh
sy: sx sf
ev: mj mf nj
it: io hm
xu: mv mu mo
vx: sf pa nw nj nx
