kki: kte bnu crq cbk
bve: cdc
rly: rwl beu chb
cqx: abc abl aak ajn iim ixv
roi: bso bua
ajj: asz apd azc
cku: ccr
cfv: aap azy auf ibg idj iuz ioc
ahb: asr iim idf
rdu: rmw rnt bkg
avw: avz anq azh atg iut
cxu: cne acg ahl avy azg aqt irn iyk iek ifq
ruc: blw bwg bzm bto bue chy
kfe: raw rzf rqv
ctk: aex aqx aol hkm
bgk: bdb bnb cgr
ksg: rly rgf rzy ruj bnr
ayt: axu ata
bml: cap
aev: iak iiq igy inr
aln: apr aqx ibe igt ixz ifr
rjn: rsf bde bmb cih
kzc: ryq rdv rdn rjg
kbg: kqz raz bml ccd
kfr: rei rzm cgy
bkb: bla bnh bfa crg
adc: ili idf ixz ims
beh: bev cyx cwx
cuu: asn aoa ikq ian ihg itz
ryz: bbg byf bdd bzd
kwi: rdw rdt ruy brs bbi cyi cgz
iul: iux iob hkl
kwy: rju bah bpt ckj
kdg: knq kfw rkn rci
rij: rhg bye
bmp: cye
bnm: bqb btu
cnl: cur aca idt ixh izz hrr
ras: ryv rqg bjp chz
kwq: rmk rtj ruk cyi
alr: agj awt aot iab
agm: atg iyp
irn: izi izw
alp: aov imx
axp: ibr iuw
ika: igx
afi: irg ibs iho imv ifi iff
irt: iej ixx
aok: iov ioe
kkf: kps rui roa bat clz
raw: bwm cld
cml: cnb aht afr iiz
kjs: rjr rmy rui byc ckd
rar: rgl cat cln
iha: idl ipf
rvb: rmm roe cbt
ryr: bhl bpn bfj cgf
cnj: auf ikf ihi iyh iwh iso imm
isg: ifr
blf: bqe bth
kal: kdz kvj bww bqc
ihk: ifx ifm
kmo: rlk rlc biz cbm
rte: bvb caz
iqw: iux
buk: clz
kfp: ktl rrb rjh
rhw: rqj bhn bmr
aft: iki ivp
ciq: cgd
rkd: rrr rdi rss bbi
cul: cuz asl ibc imp itw ium
rec: rqr bhq bjt bvt che
iqd: ium
iws: ixr izl
krc: khl klt kjz kqa ktp rke rbw rin rgw bpf cgu
cez: ctp ahf ast icm
ivf: ier ieo ipg imz
kua: bss cgq
aym: ajl ihv iwz ipz
rwj: bwh bon cgf
ksd: kqk rbi byw
rda: rsf bko bbb bno bqg btj crv ccs chh
kdy: kef kpw kur bci cyu
aaq: iri ien iqj
irq: ial iev
bju: bey bff
csz: cpf arh aaw aiz ahk ama ibu ixs
kni: kth rbs rgb bat blg crr
kqv: rjo rzw bbq bcs bhf
kob: kou rpu bkn ccy
cjl: csb ayy alj adb ase aub icg
rsf: rmk bbo bdr bdy bjb bti cka ccw
bpq: cwu
iit: imr
akt: ara adu apw ibc hkw
bgs: bgt buy buv crv ccg cwo
rji: bbx bcx byi bto cce
khu: kpw rgq rfz bzz
ctn: agv ana aor icx ixu izb
cug: ale aps iat iyi hri
keo: kow bvd chw clf
buy: crq
khs: kwd kjt kvq bbe bny btb crk ciq
rbn: rha rut bxb clh
iju: ifn
bmi: ccs caf
inb: ina inw
kry: kag kxh rwr rxo bvd bsu cho
rkq: rxx bwy ber bfq bzf
igg: ixi ipv hrw
rvs: bwf bnc cgw
kkm: knh kud rbu bgc bqx
ckc: cis che
kwf: kvx rrl bkn bbl buc ckr
kuy: rca rev chy
bdn: bxs bod
cth: cop alf alu ike isu imk iop
amn: ilm ith
kcx: rdv rpf rok cbd cax
bna: bqp
byl: bvo bzz
ije: ipi
kew: bnj ckv cbn cgz
axq: amp icg iau iif
iyg: hkc hrk
cmu: cqn arg aet amy
bnj: cbc cwb
bvv: cwk
bqo: bom cce
ksz: kzc rgp cii cyz
rbl: rzm bec cbz
crg: ccr
inh: ifo iuo
auh: ida
brs: bhl bvx bea caz
cxs: akh acf aij agc add iao ilu idw ijs ieo int hrj
kdv: rdc rnk rqn bhd cyk
adj: ajq iih igg iqs
idd: ijr iuv
boq: ckp
avs: ibq icx isi ixa
rlp: rvh bau btc cae
blp: clu cwm
kls: kjx ksd kee bww cwy
bha: bmj cho
kyd: kdz knq rev rpq bkd bci bqd cgu
bip: bge bjs bts
ksh: kff rvw bdu
brf: bda bes
rvk: blu bed bpu bzs chr chm cyk
bpm: bpt bzn cdk
alu: agh adr apj ang ihq ijb ifn
irp: izx iqh
kbs: kpi bla blq bgn bsw cli cgk
cfp: adj axt aom isp
imr: iux
bal: bjo
ixy: ixl ixp
ile: ieh iep
rmm: byw cax
rtb: bpj cyt
rir: rhg rtz
iqz: hrg
rpa: rnh bam bia bvx bxq bob ciy
rjf: rno brp buz cgk
aqb: aqa ibm icf igb ieq ity
kzb: rjc rur ruw rok bmv clu
bps: bnz cwe
cka: cgr
amx: ans azs idf hkv hkp
bhr: bpf bmb ckf cre
aeq: axo aqx aoh iui
kqm: ktq rbt btp cig
agu: apd irq iii ieu imi
kfd: rrv rmr rfz rou bhe bpb
rvq: bcs bdo bxr bmm bfi bzz bul
kbe: kpy kng kqe kof rtv bsy box cai
rww: rjj rpd rti bso btr
blq: bmi cyd cdb
cfk: cqs asj ano aqj iyb ijz iza
cqf: iyg idi isi imb hrd
kfx: kql rbx rwe rql bma bfd caf
iah: idy ijm ixh
aun: iso ied
kvy: rir rjm rnt bdq
kvm: kup rmw ruo baj bsc
rib: rhe rjk rve bcd
rre: bkn bis bfp cat
iph: imh imj
azf: igh igd
rqs: biq bpj chm cgp
rai: rus bwp bsc
axu: iis ijt iua ion
bik: bqf btl
kln: koh rav rgr blq cky ccu ciu
rmn: bbl bcd baa bmh bnp
icn: ilg
brd: bqa ciz
akj: aqm iiv izb
acl: ajm ibf ilb
roo: bvn cgu
bia: bda bnf bum cas cyv
kfw: kui ryj rul bwd bev
iav: iqe iui
kjk: kti rcd rgv bqz
kmh: rbf rlf roc blq bgj cry
azk: iyf ips ifu iow
iiz: isy ief ixt itd hkt
rqn: rte bjj bqd cly
ktb: rca bte boa cab
kxy: kxe ryp roo bwn cip cgx
ivr: ixb ipn
kwj: rmh rzs bfe cgd
izk: izx
rjy: bdp bnj ccs
khv: keo rao rwz rvu rnk rtf boy
rca: rcw bjo cay ciy cla
rhb: rxw bxa cgq
rfy: rza bso bpk clg cwl
cdm: cxw aaz axl aol ikd idb ifg
ifv: iue
ceg: cqw arw awj anc ibx
art: ahx isr imc
rde: rux rok rop btx
kuf: kop rrn rdq rfx bxy
bwe: ckj
bqq: bte ciw cym cgf
rrh: rvq rof bai bhq bdg bun cln
kvs: ryi rnp rta bvl
iht: ivy
rky: rrt rat rqf bxo ciu cdi
cee: cnt cuf ano irx iva iel itv ioz
rjk: blp bln bsy bzy
cpj: cfp cuw coh akg ael afz aoo idb ixg
iau: iht ild ign ijk
rco: res rnh bec cbx cae
kcj: rev bhl cgy cda
ari: axz igx ioq
rwg: clm
btp: civ
csj: cqv akv ira ias iwh ivb inu
azr: aqh izs
ayg: aen aoh iyn ion
brx: bao bik bzc
cdw: ars adu ajw amz icy iln idw
blt: bug cgf
ayf: adm aqd irs idr iuw hkb
rft: rqa bwp bzi bts buu
khi: ryl rvt rse rom bxa cbh
rmr: bbj biv bfp cdb
avm: ann aoq ipr ius
kws: knp rbz roh crx cck
aye: avz ijn isc
rxv: crz cro chu cyz
kyl: ktz rrq rnb bkv bav byu bpn cid
rwu: bci bno
bwh: bjg
bkx: bcw bwu bex
icm: iea izh
arl: abc ase anp azt ico iyt
rwi: bdh
kuu: koq rmp bcf bys
cmv: akd aey aqv icw iti itf
rtc: bgf bxa
rbs: rlb rjp rpk bwo bxs
aet: afx afo ihm ijp ixf ipt
axe: amm iwy iqa iqf
alg: awn
amm: afs ibi iwb hkg
iim: ipm hkw
bgo: bdr bjw
ryd: rtp car
rpr: rtf rok bci bio bvm bsq cih
rsp: rul byn cyr cwj
arx: afv azo irt imt inq
bzq: ccg cce
ckz: cal
iry: ijk isd hkz
rsh: bhe bgs bnc cwy
iza: iqr itn
bsk: bnt ccm
rqa: bdt bxk
rob: bdu cby cae
aob: ibk
rrt: bwx
bmy: bmf chl cyn cgs
ikv: iga ino iqs ioj
cta: abk icc izn
azn: ilq ixo
rsy: rmm rnm
rgw: rnc rzp bfl
ksi: kfj raf rux cyr
iwq: ioq
rnn: cgc cwi
ayr: age adj ajn amy aos iql iuh
khn: kno rwt rxp brl bng
aru: abm ann aut iye iqz
ayl: alp awu aop
bjw: bzt bub
ctl: aru aik aww adq amb itw
ape: hry
ixd: inc inz
ihm: iyy ido
rko: rfm bkw bry bdu cco clb
abl: als
bht: bxp cch cis
rhi: rva rfv roy bjj bms bqy
amu: ibi ixa
ipr: inw
rne: rtq bge
bvt: chh
aoy: iar isz izh iud hkm
cng: cov aii iaa iml iqg
axz: ibp
anr: aff aqp inv inm inq
axy: igz ijl iju ivq ixi
aig: ada axw atw ijl iej
aqg: icp inp ifz hrk
cpm: cma awy ajw aer azo irx ibm ila iqo
rxl: bhb bqs cbr cdl
rof: brn bmr
icj: ieb itm iud
ahn: apq iye
ikq: ivs iez imj hrg
auj: ila iwv inm
bpb: bpa
ktq: bvl bxu bpk cic cwi
kwd: kwx ksk ker rrt bab bow
ixl: iuj hri
iev: ien ins ifl izq
cfg: agk aei aqq aty iei hkw
abf: awh ikr iiv iwe
kgo: kpm ryf ror bwb bod can
rpd: bry
kha: khq rfy rzy bns
kox: rvo ref rnn rzd
cwm: cda
aqk: ibc igs iwb iqw
adv: asp aov icf ihs ifd ita
cot: avo ibv ixa izg
crp: cil
bca: bxn bmk
icv: iyd ijv ivw
cuc: apf atm ato idp
rht: rsb rzr boj cam clx
acg: ali adu afb ipr
kpa: kue rcc che
kxa: kuo bdv buh
atd: aup iil ihb iqw
rog: bmi clu
adn: amj aqp ifu izx iqe
cnt: cqs ctt irg hkl
aon: ivg
bbh: bab bwl bpo
cze: akb ayj app ikg
ceq: ctd act agq aqr ili
byz: bzn
ber: bpq ciz cgy cwn
aqp: ath
cpi: cpn avb ats iix iwa ieq iqu iux
ado: aev amw iqb
kqx: ktn ruc rob bsk bpc
czh: ctf coc ape iak
cfw: arr abt aco atw idw itg
rrr: rxj byj crs chu
keh: reb rqp bry bze cay
ata: iac iti
ast: iak ige ivf iek
rdq: bjm cip
rql: bao
kwb: rnd bap blm bfr bus crp
rin: rfo byl bzv
cyn: cly
bhm: bvq bog
bem: clk
kxx: rdr rez chm
irk: iwr iph ito
icz: iwc itt
rsn: rst reg bvq clk
bwr: bxp cwy
rbe: rlp bmy cbw chy cwm
ahx: awf aeg aqd ije
btc: crt
rep: rux cac
cpn: alj alv adg aon idv ive itv
rch: ryv rfi bbc bom
kei: ktk rde rtk
rgm: ron bvk cdr
kto: kuz rwi rqr byo bqh clj
kff: rfu rup roq crq
khp: kgh koh rvx
rfa: rzm bcl bhh bsa beh ciz
izn: iqn iur
iyf: imj
rfv: rtg biu bds bjj bnv clp
bxd: bma
knr: rso run cat
apm: aog ikj ica igs imx
acr: adf ajo auk ivg
bew: cln
cpg: ctz coi ixc iqt iuv
cag: cyo
rga: rox big bdx bss
bus: cgd cwt
hrb: hrv
cer: coa aks ais alz afj isl
atc: aos ikd icv iut
idu: imd imv iox
rgo: rdo rfa rqb bex crt cay
ivs: ink
cmf: igu ifh
ath: isf izg
bnl: cra cgy
awt: icl iig ivv
awy: amv azj ikf ihx iwq ims ifu
byc: byd bow
coc: aps iht idr
igz: ixl
rju: blc bjl bvv bxn bmw bzd
iqh: iod hrb
btr: cba cwb
aze: ilh
kea: kto kur rkn rwt rml rfg bac bly
knd: rdp rob bkm
idj: ixq imj
bbp: bdl crb cre cyd
ign: ivg
imz: ifw
cfb: cuh cov ayj amk ats iry igc inn
cym: cgz
cdx: cmu abs axk ano aua ikj ite
rfw: bkn bii blf btj
rxe: bar bal byg bep bmr bql bul
aph: aql ila iot
cia: cgl
bnn: buj ckk
rwc: rdg reb bem bos ccj
rqq: rog bkc bin
kel: ked ktu rhn rdj rvc rfb
aux: ire igv ixs
ckh: chc clq
rvm: rsb bya cys
kpb: rdt rzf brf byd
rhk: ryd blb bff cib
blk: bsm bej
rgz: rtm bky cbo cwg
cjj: ceo ahu awc ise iec iqp
rqu: brg bas ckr
atl: aob ilq igw ijp
kjv: kzw bcv bqb ckt ccr
iew: ifa
ibe: iqd ioq
aki: ayg awn igt idm ipl
bay: bgw
awi: awm imp
kqj: rdw rmm rnz bbw blq bjj bpx boz
cem: cnn cfv awx ifk
bqz: cht
kum: rrb rlj rzs bjz
cne: agb auf iyk ivw ipk izv
ark: aii alp awe
amh: iiv iwa izo iue
rbj: rid rvd rvs brx bdk cgb
akn: avu aeg aps and atu
apu: atv iwx idd
byb: blc bjd bom
ajz: iga iwl ijv imi
rfk: rqz bwj cwu
rkm: rmj rne blr bsx bug cgg
avl: iic iga iqz iom
krt: kek rdx bgp bzp
ref: rzm bka blb bpx
cpq: cmb cqi aym agu aqr
igi: isw
aif: aqo irb iir ijx ifp
aog: aos iah iwo ixa ior
icr: ihc imy
kma: rlh bhf bfu chc
rwt: rsj
afg: azu atb ibf ijn ivl
koh: rxv rfv
rjm: rsg rep rnx rue bea bfv cyo
idr: ive hrv
bes: bue cii cyf
aso: apt idw
bvi: bvh bxx bpl
aqf: aoz ism
ajl: axm ihv isc ixg
rsc: row bjr ccu
kks: krw rxm bli bjs cyp
cju: czg aey axd hkw
kpp: ktn rih rqi bph cgp
cni: cfm czx cqo agl aso atd ikw
czb: ako adt axs ipw imp hks
aqw: igu itj
rdr: rds rqf bhi cau
bmn: btg cwp
rqh: rqw bll bnk buv chs cyf clf
ahd: aya aql iqj
cdg: cjt cmh alq atv ibz iwn ipw iqu
cqu: cum axp iis
kmm: kto bcw baj bas bsm bst bnh bfa
bwc: bvz
rej: bgw bsk bps
rtt: ruc bki bwt ccq
blu: bpk boh
bjn: bml crj chk
kfg: kqg red rqz blb blq bvz clb
ixz: izk
bev: boz
icl: iaf
ati: imi ini izi itr hkp
rlc: rwo rjl rzw rok
kih: kyb red bbd bil
cog: aqv ikx igs idh
rgi: bfw cru ccg cge cwk
kot: rkz rcb rqf bye btp bur
kxk: kpf brr bli bea clj
krf: kxt rkk ryn bkw bfc
ibn: ihn
bxl: cbl
avg: aml irj inl iqk iog
iki: idx iqh hka
brv: bvz cgz cdi
riw: rne
rml: bkh cwn
awf: ajn aqk aua iar
cdt: cet aat ahp aft iaq inm iuk
rif: bop cbs
azm: irh ivh iqk iqc
riz: rsr bpe
cpo: abe ayl afo azq auc ica isp hrg
rod: ccu clb
bue: clf
rlk: rsm bnt bqq
iyu: ijh int ifr ioh iol
kwl: kjp keo kms knr knn kox rks rjy buf
cpp: cmm cuy ahi agf azm ath ibf ilw ipr iuk
cbd: car
cjc: cxj cxt acm aia adw axr ijt ijo isj
rfs: rtu bbs bhi bqz
rpo: rtb bse bfu crh
kby: kcw kfc ryi ryx rlu bbk bzr btg crk
ibh: ihu idv
aql: ias ihc
iod: hrj
aah: aur iia ixx
ach: ait auy iji ixv iuc
kkc: kcr kzq bco bgo bmi cat
auc: isc itx
cdo: cui act aai ayx iuq
rwm: rjz rzv rzx cku cbm
kru: ker kth rgz bdd cre
bsy: ccp cgj
buz: buq
asb: iru ifz
bcp: bpt cyr
act: axc ikk
bdu: caq clc
bif: bno
rpq: rfw bqs boi
alf: aed iww ipp
kmd: rrm rln rqd
key: boh ckl crd caw cgf
boc: cyq
ahj: ado aml iib iqt ith iog
bho: bxa bfy bzg cya
iix: iou
cxb: coi art adb ihp
rri: rob rou buq cyj
rnj: ruv cah
iig: iyo
bkt: bxa bug
kne: red btw
rmy: rue
avk: atf icy ily ilu
ckl: cch
iyb: ile iwf iub
bhb: byp cgg
bxv: bng btq
cqz: aow iyg ieh inp izl
kvd: ktr rlk rwn ree bwl bsi beg bny cix
rnt: rzg
kfm: rdf rzf
rdn: btq
ran: rgy rna bls bpy cye
coo: aai aik ays alr azu iwe iwp iuv
kjr: kuh bgi cgl cwo
ilf: ijk ijr hkw
abg: abe avq iid iij itr itl
adx: afz aos ilw ilv ipv hrr
aoz: ibg ibd
axr: idg ijo iel iok
iko: iwm iem ixk hkr
azy: aua aoz
bup: crq caj
bhl: cri
iyh: ijf imf
cnc: axg amd azw iib ipp
izo: hri
apo: ibn
bwv: btv
koy: rbd bgc bqj ciw
bff: cbe cyz
cok: akp abi aai avx aul iio iwc
kgu: ktl reb rpc bwv bxg
rtm: bmg
ivj: ivs ivf
acd: ijh hrr
ijf: isa ifx hrb
bzx: bqe cyd
rvu: bwj
isk: iqp
afo: itu
ajk: aji irf iqn
awd: adt aup inc iun hkr
kji: rbj rvb rmt bsv bnl
brb: bdc
awc: axd aft azm ijl ifi ifx
aal: aqt iwp ivq inx
awl: ajs iso
cel: abu amn anx anp isv iuk
rjd: bep bof chh
rty: bvw cby cyn
rru: rwi rel rpn bjm bqn
aty: auh
ice: ise iso ieu
abt: ayp agn ibe iov
icy: iwj izn
aom: icu ifs itu
kdc: rhc blj bso bzj buy
rwf: btw btm
asi: ipk ing itx
alq: anv iky irb ibx ifk
rtu: bca bag bhg ccn
kgv: kzj rkt rpl rms rzm rtb biz cwx
rbx: rfh bav bfy bqd
isd: iqe
krb: kye kqw rcw rcf bhh bgr bwn bqe
bcx: bik bgp cbc cyq clq
rym: bjg bxv bzy buz ccu chf
alo: aqf atf irh ijx
ant: aoc ikw iaq iyo ife
clp: cgo
kkz: rwm rny rqc roq bwi bnk cyd
apt: ikv imv
igl: ijk
rhs: bhc bht byb bgu bwn
rzr: rtw bfi
adr: apl idr ivj ifr
azc: hkj
bpo: bmf
bwk: bnn bzb cbn cwi
cts: aak aqt ipk ipa ita
kyh: kyt kwo rji bii beo bno cik
knc: kfe rif rnv bcr cit
cxl: ibn iad iyd ipy
kcl: kdr kvb kzt bwq bet bop
kfs: bgr bjh btz cac cif cya
cjm: ars aiv ajh axv iwx
ili: iup iop hrc
ibd: iwl ivt ipp
avq: ann ige
rfi: rui ben bpa cav cit
rhv: rfv bhf cgx
iib: ils iwo ijb imu
cmw: app aqo ike icq imz inh iot hkn
kul: rkh rpj rpe rqm bwr bod cro ccu cwq
kmz: kqy
idt: imq inz iub
kmq: kza bhp bhn bqn
iwt: iew ies ixt
ilt: inv iov
anz: ihp its
aor: irx ivc
ink: itu
cyl: cdb
ida: hrh
aug: igb ivz imf
bom: cct
rmc: bby bvr cry crs cci chf
cuo: amu iha ier hkh
cqs: coc axd ata iiv igo ioq
iaw: iap iyy iyd imo hrb
kve: ksa rmf rfz bag bjt bzx
rev: bab
bwd: bjw
imp: iqh
kvh: rwq rzr rud bxg cau cwa
ipc: ius
ihv: iyf igh
ijz: iol iot
isx: iex ifp
kqo: koo rpo bor
ksb: rcv byb cwq
bio: bjb bog
awo: asz ape afh iuu hkr
aim: aso aoi aop ixa iqt
ilz: ijs ivp imj itk
ckf: cya cgr
kyu: rhs rww rzd bkk brd bdb
kdj: raw rid bye cyu
kfb: rmg rqk bhj crx clp
kfv: rsj ruu cic
rmp: rfj rzy blf
ass: azx icz ixi
aiy: afc irl isq ies izt
iwp: ish iug
biz: bnx
raj: rvx rze rzm brq ban bez bnt cie cit chi
ayv: ayp avf azf ike ibn iyn ipo izs
cdd: afq ata iyt ina iuu
idg: ine
bzb: cil
kfz: kqb raj rxj bsg bqc
cqd: adh adp amb iyl ieq itk
rma: bkd bkt
ake: acw ash amv iix ijg iep ipj
ryb: rfn ruj bya bms
kas: ktn bee bep
ceh: czk cqt abz acm avc aek igx idv
kbt: rkc rds bbb bqh
csv: cpo cff aal aop
brr: bhc bdq beo bnj bfy bqf bta cgy
rup: bje bqc cyf
kij: kgj kol bhy
cte: alb alx asi iag idt ijv
rvw: rsb rxo ckh
rbu: ryw rlz rgf rnf
kqt: rpl bch
iil: iit izu hrb
kcn: ksh kzk rwg rph rne bkm bxh bzd
app: isa
brg: ckk cgj
bmv: crl crw cib
aji: aeo amk irl icf izo
byf: bjk
aek: ihv
aap: aen ieq izs
cus: ize iue iox
knx: kqh rwv rnw rqv bmp btl
ibl: ihf iob hrk
bya: bvj chl
rmu: ckx cih
bpa: bul clk cge
rhn: rft rzb bim
icf: iws idk ifi iqm
ibp: ihr imx
ibu: hkk hkc hrh
icu: iyk ilb ixb izp
ipx: hri hrd
rau: bro bhc bfl cge
kfa: rhx rjo rmx rfd bbb bwx cip
rxf: rnl rfh rty
bey: bmb bna
kdx: rwv rsw bai bic
cql: arl awv adr aju
bdo: clv
cqp: aak apn ics iwe imi iuw
ray: res rpv row bix cbk
inx: iuh
abh: anx afh aof ijc
rou: blt bvl bng ccx
ktv: bgx cgz
kim: ksi kxt rlv rvs bww cgr
ics: iqa iti
kuh: rpa rmh
ctj: afm azh aqh
iyl: itn
atr: aty ick ict
rek: bcg bzc bzz
rur: bkn bcn bph
aju: apu ill ifu izm
kkl: kwf rdk rtf bol ccm
aoq: iao igf iwd izg
bdc: cyn
beo: cbb
kta: rjq bns cge cws
icc: iiy iwx
agt: ibi igt ifl
rpn: bpa bpx bfc
bse: bmf bok
brn: baj byl bom
cmt: ctt cuk ifh hkd
bcj: boz ckg cby
izz: iof
kct: kut rmu brk clh
ixa: izd izm
agp: irc igr imi hkh
cyt: cwg
bbw: bys bzz
abk: axb apy ihv ifz
bkz: bil bwt cid
rem: biq cby cbf
cms: ctb akp arl axd
adi: ase anu azy azw iay
kin: raa rlq bky bhh
kty: rav bcd bzx cgb
rrq: rsm bga bqe chv
kqs: cka cke chw
aut: ivx iun
bhq: bqk ckp cld cda
apf: idm isv imh
ime: hkt
kbw: keg kxn kft rib rjo rvw rvf rzy roc
rff: bev cby cli
agi: ant afx ixw
cec: cpf aml ike iwb
aqq: ijc ixs
aot: ijs
rqt: bzv bqi btd bte cbi
roz: bzm bus clh cgk
kqg: rlo ruk brt bcf
con: afn irr iii iwq izz
bcn: bvv buk cgz
rdt: bgl
ayu: afn ivk ivy inz
ajh: amc ign ijs
kya: klx kse raz bbj btr cbg
arp: avr avh auv aox hkc
kus: ram rva rma rtp ros bvl
rzf: bux
brm: biy bfo ccw cww
ket: rlx rwc rvz rus brv brq bhw
imn: iqz
adg: icy iuf
acw: ikb irh
aby: aaa aen amf ixq iqo
bws: bsl beb bmm bmu bqw cag
iyz: iwz
kad: kgl rep rue bki bhc bdo cip cyw
rbh: ryq rlc blr bwb
bcd: bdy
aqo: iee ixp
bgm: bzi bqr cbs
izq: hrd
rdv: bsl bpv
and: afe iky ixl
kzg: rxk rul ciu
rrg: rwe rqu bbx biu bhq cya
rcn: rjf rte bcp
rfx: bdx bed ben bpw bzw
irm: ive ivf iue
bjc: bfm bzr bzs
rao: riw rjt bko bed bpo bqn
afm: ikj iif ife itc
ikx: icq iat inu
rks: rvy rmr bfj cao
bjk: bqa cdy
apa: amo anx afs aoj
arr: ate ipl
ifo: hrr
rih: rdx rji rqr bxb
ble: bgo bun cbn
bfk: ckh
rxp: brf bho bxj bnf bop crl
iar: ieb ifj iub
bdd: btd bts cgg
cjy: cxb aky aqr iaa
ijj: ite
rjv: bgy bso bey
ilo: ivt
kro: kls kju kfq rrl rwn rqh bwc bsg crf
cns: anc azh ikw inj iuz
abb: agp amh ilb ija inq
isi: iue
kdn: rbn rfm roz bgn bmt bov clh
ikp: ikz igx
rjr: bwg bsk bxr cyl
iny: iua
bwi: bqq bux
ryw: rfg rfq byr bdk
ajn: aqn ixz ipt iqd ioc
rig: rjq rme brh ckm cce
bym: btj cko
kst: kfp rbv rcz bgr bta
bwb: cbg cbm civ
cqg: ays apm iid igs
ipo: iop hki
alw: apl
acp: aqz icn ifo
ibc: izk
rkk: rpz bxg bnr cio
aix: ayt awb ass anu iit itg
iwd: hkx
kyx: kgq kua bym boe
aeh: aud irf ihl imf
kdk: rcd chf clv
kux: raz rpk bma
bpx: ckj
ryf: rep cin chq
iiv: isc ipm
arv: ajt aqy iyg hra
kxb: kxw koq rpu cgf
aav: iri ity iux ioj ioz
rnc: bpg cbl
awj: iuh
cfl: coj abk anx iyu hku
rms: bcg bvy cwq
cey: aie als avs aqa
bjz: bxq
kpx: rbc ryl bii bvv cyv
klg: kej kpm ryi rdi
rer: rzi rtr bkf bau bgj bez bqw
ixk: iuw
run: cri
ihn: ioa
rqj: rto bab baf
amk: azu iiz ifs
cmr: agt awp azc irf imx
bfu: cgv
ksu: kqh rli rtz bao bzo
bkn: bre bro blo bww btq
ajo: auc iap isf iuh iup
rtz: roe bgk ccy
bsa: bsn
rkl: rrq bkl chg
iio: ilw imz
rxj: bpq
bcf: bjc bju bna cbh
rcd: rwr rvz bgt
biy: bpe cca cco
aba: aab aos idy
aib: ayq aza atp aoi irr ibv ivt iny ium
kfh: rst rpn bzg bzx cya cdr
khf: kmq kof rms brg bwp bvv cwp
bbd: bpw cws
aky: are aam asf iyz iqm
agr: agf azw ikt
cmn: arp aer afs iyg iou
bry: bvu cao
coa: coh apa amg aze iex izp
ieq: iny ifb
akc: avo aev ixo
cjg: cos ajk amg iny
bzl: cca
amt: irp ico iie iyr
rxt: rfk bbi bwz bmr
bvw: bqh
iga: inx ift
anl: ihc ijb
ktz: rqi rtd bra bpo
ayz: ago ase amc ilb iss isn ifv
rdy: rtz bdd boa
aqs: atn iay ivh isp izj
kmj: bdr bvb bsi bur
iqp: iom
ajy: iak iir
cpa: cms cua auo igq ipr ios
beg: clw
col: akw axh iyx imr ius
atp: aoq iil inv
iva: izj iuf
kvt: kum rkr rtu run caq
aqr: ika iiy ils
klu: kpy kud rkt rhd rqp ruf bmf
brl: byy cyp
rta: bbq bcf bdv bpw buh cax cwg cwm
kop: bab blg cyi
coi: aay aey iyl ify hrv
kyf: kzs rrf rto beo
kgt: kwa ksp bxh bzb cas
rik: rhn rxo roi bvp
rxm: brj bhg bhd bly bvf
bcc: bsu bzm cdh
ijb: ixk ixe
ayx: awc azs auh icx iho iyz hkh
kcw: kim kox blp ckn
rls: rur bkv bjv btz ccm ccf
rwz: rol bir bqz
rqk: roe bcx bwc
cqy: avj ass atl aok ikj ibl ivn
klr: rfy bri bta clq cwl
knu: kfw rjc rfl brz bda cio
kik: rlj blr cae cyw
kbf: kav kjv rgx rnu rtn bbk bbt bvd
cvs: cxr aal avp axy aqw ifk
bga: bdt
avn: aqd iks ira idn ixc ipe
ahe: awf asn anv afj ilf ist ifp
bnu: ckj cbl
kfl: rby riv reu rqf
cvd: cpf aao agz amw anb ikf iyg izj
cco: cwr
ruo: bhq bxx
bko: bhx
rdc: cav chv cyx
ibf: iiz inf hkn
coy: asl ikw iaw ixm ixf
apd: amn ibb idm itw
ccp: chv cdk
rok: bbz bze
amd: iyi izs
bjf: cyy
bsf: bee
rbk: riv ber bnf buk
rgy: bgu bxg
kmt: kfy kqb kum rfs roo cbk cyr cyh
awr: awc adx atw iip
kny: rfn rou biq bnf
aue: isf
inc: iow hkl
cjr: alz igk idd isj
kqb: bfh cru
rdp: rsc rzn cll cdy
icd: iur
kos: rcw rae rio bbs bip bod chq cwm
rop: ckc clv
czn: cqz ajz irp ina inx
bwm: cye cll
bdv: cle
cdz: cmc cqt col con ade asu axi ich iuu
cnk: abk ahw ayt ado avo axi aub iks idl
cpc: ayw axg ato ics ihb ioa
kcr: kzm rri rqh cyo
bku: bgc bwj bxi bpp
aep: ixs ipu
apv: aqp irr ivp ipt iqz ity iuk iun
kdh: kxv kui kor rcm rdp rme ble bss
csb: ajk iry iiw igs iej iqo itb ion
iky: iwj ijd iqz
kqn: rah rqj bgx bpv
bag: byh crv
kpy: rkt bhz bqp chd
rvd: rer rny cis
rmw: bkc bkq bsh
cuz: ayi ajc aji iif ioz
rxz: bhk
kdf: rkr rkp bht bdr bsw
kax: kfm kfz bar ckx
bld: bxz clp cgi cdb
knm: rvo rty rug bqi crs cyj
akx: atb iad iyc iqg
iss: iou
kir: kfz rho rmc bnb
rbd: rii ryw rew bbi
cmj: ctn ahb ijq
ara: agk asq inf
cxm: aqh ibe icv ilk
rwd: rvm bba blk ciz
kpg: kqw ktd riz reh rfk
ava: avl avu axt ius
ryh: rjc rvu ren rmy bwe clf
rox: bwt cgl
kaj: khl kfu rkk ryo rlv rzu bxm bzw
rvf: bag bmz bfo ccw
bpf: buf cit
ajr: asj iya iov
rvc: rmi rta
kyg: rkm rju rfu rth beq ccc ccq cwh
rtx: bxs ccy
rkj: ran rdr bra blm bzs btk cyy cgb
auq: izi izd ioy
aiu: avn iid iiv
but: cij cyi
kiw: khh klm rdm rfj bwz cbg
cpe: cpp czp cue alw amg aok iwr ifm
rkp: rll rsy rzy bvj buu boj ckm
rcz: rwo bkp baq bjy bef
rvx: rel bhc bxi
kql: rru rlm buz ckn
cjn: czy anh atn irq iyq iea
alj: aqx ipu imo
ayo: aem icp iuz
cji: ayp aoi iig ipw ipj iut
asv: anz atq icw ixt
cyd: cyj
rle: bvj bzo cdc
rnq: run bkj bjb
ick: icp iye iwl iod
ixv: ina iqv itj iot
bdr: bdt
rso: rxu bbt beg bun
iwy: imt iqq
bgw: bxz
aja: amt azj ier
ack: alb amk ira ieu ino
kbc: kbu kcv kmg bka bqq
iqc: itc iuh
cvf: cmb cnn czo iyu ijk iqu hkv
ist: iev inc int
cak: chd
iif: idm iny
ivp: ieb
ade: atj ich iqv iqn
arc: iax ipi
cqb: coj agr apb auw iab iip ipd
rke: rfd rql rtx bba
bgg: bpm
bwt: bst ckb
aht: aly awi avt aee iba
iee: hku
kug: rva roq brr bxh cdl
rxr: bua bum cbb
kjj: kqc rhy bce bjn bzy
khw: klv ksj kut rqu cgn
bwy: crv cak cls
abd: age asp aoo iii ivq
rzh: rtq
alh: aep afl azq ihs ijj ivv ifd iuf
cst: ada amp aqp aou iiy
rgn: rwe rsi rmz bwz cbo ciq cyc
azq: izc
cqj: asn azg aob iro iis igh ipl inr ifh
irj: izv itn
bfq: bzj
cvp: cfa awn ikd iaf iwy
afy: aum iic iiy
rnk: bka bao bwu bor
cds: cvs cuk cut cuo iiw inj
axl: icc iif ihw igv
amj: ikn irx igm
blb: bfr
anm: aze ipt ind iun hku
bez: bph bfy
ibo: iyj
bvb: bnb
kmp: rdb rdq rvl bdx
ale: ads aqs ifs iuy ioc
ryl: rus bpm cgs
ipk: ipx hrj
bam: bsu bfa
kli: kei kpw rmz bap bta
bcg: bxz cbk caa
ryo: rnz bin ccv
awp: aon iej hko
ker: rbz rgu ros bkf brc brf bwb cwv
bde: bnt cil
kfo: kzz ruw cam cwd
kzj: kuy cwo
rgu: bvc cbl
cdu: csy cej iam ihi iwe ivl isn ifa
ici: iwr idg isc imr imd imm
knt: kfm rtj bwh
irc: icm ige izb iqm
kxd: kmr rjc rzu rqw biu bft cab
ilb: ity
ikm: ihm ijh ipf ifw iqx iup
cca: cwn
iwj: ise
asj: axe icr ima
arf: ajp isd ioi
rhp: rli blk bui ccn
rit: rej rnl rof chv
knw: rnc rtv brl bsg bed
ibr: iby ixm ifb iux
bbz: cbp
atx: ilt izi izf iur
izb: izi itq
ivb: iey ifq hrl
ksx: kou rii bcz bva bvf
cmh: acl ayw alm amc aov isr iqg
ash: axp imy
rcl: rdy reh bnb ckr cak chs cwf
cqq: cul ahp awp apq ils idf
kvp: kxr rrl bbb bav
iso: iew iti
bpc: bmk bmg btu bul
kqu: kom rxl bor ccd
iiy: hkx
rim: rlm rsl roa bns
ikz: inr iqf
ctz: apq ilu ieq
reh: bkl bcm bcf bob bov
bgu: bwp ben bud
als: ass ikd iaq ilw ime izy izz izt
azl: iws ies ieq
rgt: rsh rqn bek cll
afx: iyv iuc
afe: aom idh
rjq: bbg bgv bjc bfb
irw: iba iqx hkb
ads: aou iap ipw iql
apw: afe aqm ibh ilk ilj ixa itf
rci: rjg bby bnn boz ciq cwg
any: ilf izk
avp: afy ira hko
bih: bhg cdc
chu: cyl cwn
bsv: bxj bmz cbl
kww: kjm rhr bdo bxb cwy
kmx: kol rlz bqy bum bow caw
cmb: abl iyk ivi iqo
kxe: kfu rpu rty bir bfh bfq ciz
rbi: bbz bix bxf bnm bff clh
kys: kfr rrt rzy rqc bps
alk: aga agz axf icd
cuh: ael axl ict
ajw: ihp hrj
rxa: rfl bwm bxa ccw
rwe: rqy
igy: idn iud hry
rjp: bcj bnv crv cbj cco
aks: auu iky irn ibm icx itm
kkt: knq rli rgx bhv bgv cbr cwa
bux: ceb
rsz: rfh bxr cbi
riv: rhl rlj rea rzl bxf
koq: rld bra cdi
ajd: azr iki icl ihl iwi
khz: kmn rhw rez bgy bjv bni ccs
kcs: kas knw ktm bcs biz bwd bnl
bxs: bmm bom
anx: iju
kuv: rhg byb bwh bmj bqs
rae: brc bmp crd
bfa: boy
rgr: rdn rol bba bty
csi: abm axf aqh ibw ilh izo
kss: ktr kuc rhz rmy bks btr bok
ikt: ihl ino hkm
czc: akv aay avq irz ifj
anj: ata ifk ioy
rzl: byv
aao: aip aso icz iyd ifi
rli: rzh blm
bar: btm bud cay clx
knb: rai rvl rsz bll cwi
abn: aei atr atz
cux: akj arj ajf axv ama azl atv
bvs: bfe
itj: hky
amc: igl igj izc izm
rjz: rjo rnf bho bxf cch
rgd: rmm bir bod
idx: ivb ivj itq iug
igp: ijt isl iov
kic: rrq bmf bux civ cyz
rvl: rvo rfh brd biw
kvk: kxn rbf rho rfe bsi beu bxw btc cik
czj: cqg con abh iei
ayj: aza iby
adt: ibn ijj
ktu: rig rwf btq caz
iiq: igy ige igt isf
cpb: ara apa ipd ifj iot hki
akm: awh aob iwr iwf ift
kmy: kuu ril rxc rpb bke bha ben
kno: rko rry ryr biw bxs btr
kej: ktb rzv bcx
iby: ijw iqt ium
cxv: cno aaj afd azs hku
kef: ktj rwj bkb baf byp cct
afp: aqn iwi idz inw inp ios
rfz: bkn bse ckq
cmq: alq ilr ids idp ise izi
cxf: cuy coc awf ajc azg aut ilr imr
asm: aez iyd imt imu hkk hky
iyx: ipf iqc
kgg: rsl rmu bxw bfr
req: rpg roe bdb
kap: knd rcy rwt bgk clm cgq
iez: iow
rki: rra rsy bhl
coe: adl ang and anf iwo
rfm: rzx rto rod bbn bin clu
rmg: rnd bmw bnn chh
ahy: ikz irk ihf iwc iwp iuq ios
red: rxi bbf
kkq: kjn kvh kmu knz rbq rwq rts cyb
adw: aso ivr
ktm: rbq rel reu rqw bbd bzx
kfy: rmt crb
row: bdz bxb bpz bnr bfx
bac: bzs clm
kwg: kec raw rjb rzz bof
cjf: cuv arz avw ilf
iax: iaq
igj: imw
kil: kje bij bgj bdd bof
rzn: roh bkj baj bva bqx cwp cdk
kza: ryk ryd bek bma bmn bqm clg
rsw: roa bnd bux cys cgl
ayk: alm amh anw ant afx ihs
kzm: kto rcn rfh crb
krp: khp kxp kmk kmz bmj cbh cap
bgr: ccb
bkq: btb ckb cbq
rix: bru bah bgj cac
kqf: rsy bly bfe
kga: kwk bev cbk cak
auk: ilb
rcy: rau rtn blz
bxt: cak
kis: kin kjh kxs rid bbe
kbb: kyo rxq bky bbr cda
kuc: bbk bad bgb bqp crn
iiw: izw
czp: abg idg iva ied itp
cnh: coo arz alg ajw avb
ckq: crh
kxj: kpj kmw rie rpg bgc bxe chv chx
reb: clu
inv: hkd hkq
ibi: iek
cqe: cqn ikq icb ilv iej
kvr: ryu rwi rvk rmz brm
bls: crd caz cau chs
aic: aso aqe atx ivi imm
caj: cdh
ipg: iqr iuj
igm: iwd hkb
cja: cjt cpo abo auz
rei: roq byv bmf ckv
rpw: rpf rzm bru bep cbh
rsg: rtr bsu bzf chv cln
arb: ard acz anw igp ies its
bat: bpa bfa cya
cck: ccs
arm: agq iwi
ruh: bkt
kex: kfi riq ryu baz but
avj: aoz ihn ipo itu hkz
brk: bio bjr buu
rgc: bgd bfu
acx: aif axv atr aoe ilc ixm itb ioo
cph: agg agj ati ate iaj ihs iwa
bmt: cll cgx
rfl: ruq bhz cws
ilx: ida ivc
asp: apa iwt
rdf: bjf clj
ini: ifg iuy
axk: aoc ikd ism
iyn: isp ixb inu iqm
akw: aig ivc iuq
acs: acq ijj ipe hks
crm: cbv cah cwq
ird: ich ico idz iqq ioa
bwj: bmk buj ccd cgb
buh: bow cix cgh
kly: kdh kji kpx rbz rce rab rpt bxy
biw: bid bsn ccn
iup: iou
rkb: rat rxi
aik: aws adc ivj ieo
cix: cwu
ksc: knv ktf rym bia biv cyx
koj: brl bcp bim
aqi: iau iix iut
bvp: bnb chn
cqh: ctq atk icm iig
crw: can cha cdr
kyi: kem kef rrb ryc rlt rzk btg bor ckt
rbp: rav rjt rfc bra blx cdy
cxo: aab azr aue aok iaa iio ite
krh: kph bkp byg bph bfw cwu
rqo: bbe bqs
iak: ilf
kcm: kgx rqs bwe bna bti
khc: koz rwq bhn bxy ckc
cnm: ard aic itx
itm: hkq
bwl: bxk
bmj: bua cyn
kyc: kqi bnz bup cbk clz
bpv: bfy bqu
bxz: cdc cdi
cej: aff azk ice ixg ifs iuy
rhf: rdh rfm bgg bsr cln
izx: iuh
rew: bwz bnw cyv
cqk: ado avw ihf ilo igo ids imr ifh iqm
kcq: kth rkg rag bxu bmo chb
agy: afl igt idj itr
kbk: knx rxr bvp bxx cai chz
rad: blm bpy clk
cev: cxm agj axp icx iip iox
rps: ruw byh bqc ccp
aho: agd apl anz afz ibp iyx
boi: cll cgs
auf: ibw hrj
bhf: bxw ccl
rhz: bgb
ktd: rqv ruh bzj
agj: azy
anq: aqy igd idb iqg
kwv: kqw rlx cbr cag chf
kja: rkz rrd rcu rid rqx ruy
iii: igz ivx
ilg: igx hkw
bsi: bqr
bzp: crm
bua: caf
kyv: kda knh rlj rdv cas
kao: kgu kpk kpb rgn rzl rqy bda
rsl: rfz ban bnb
cub: aff aow iex imq
cqi: aha atp igh
che: cgu
chm: cyy cyo
aop: iux ioc
agl: awm ibl ibs ijf ier
rwa: bvc bth buv
bzw: bui caa
acj: awt aek amh aum ibh ipz
rez: bhx
ryc: ryn rdq baa bji bph clw
akb: axm anz ibj iis iyj
kcf: kay rwg rmu bkv btp ckb ciu
ael: ice idn ixa ixf iof
rpz: rno bcn bdn
aex: izj izf iql ioo
bvj: bna
ixm: ipa
kjx: kxe blz bzz cwt
rey: bbz bai bxz bfw
apb: aol iyv ivm iqc iog
reg: rpf bis cwx
ktx: roq brz bct bhi chn cgc
iic: iys itv
rts: rod bvb cws
ktk: rkc rum byp ckr crp
rqp: bhl cbf
cof: abv abn abq aia ahn adf hrk
amf: anz isr izq itp
kur: rbe bkr bko btc
bcm: bfn cwg
aww: aue
klz: kzm kqn rkl ret bkb blv cbl cbs
aaz: alo aze iuy
rxn: rqa bhy bjp boo
bvm: crj cbk
rsa: rfm bsx bfp ccq
aci: adi anr ilp isu
iro: ijv
bax: bxt
avx: iku imi iuf ioo
bvu: bpb
kxt: rwz bcr bhy bew car
kcz: kas kxc kpo kzv rkq bdi cga
bea: bxj cks cya
akz: abu ate izy iud
knv: rka bjf cie
cse: ctd aax afw ilv ipe iqv
ave: amd aqf atd aud iws ide ior
kmr: kzo rid bkq bln bpf bua
ats: ien ipd itx
acv: aco atu inw
rnp: byj bwy
azz: ati iui
ana: atz irv iet
isn: inj
ayp: iko ids itu ioo
bmc: cyb cli cgy
awe: any iix igd ifr
avy: afm ixp ifj
cpt: cms czt arl ape aqu ijd ivd ins ifb itl hkd
rpu: rfx
avc: ang aod iif ihq
btn: ccn
rxg: bvc bui cbv ccc
rdm: rfa
bkc: bix bxh bzu crp
bln: bgz bei bpg ccl cwj
bbt: ckw crx
rbr: rsp bga bsa bek
cxy: cxs ctf afv hkg hrk
bbi: cww
ier: imv ios
cpz: coq ibo ieb iex ifx
rmh: btf buf cca ccg
kun: rrx rwq bys bfd
cef: czg axo azd azj iwl iut
bvg: bvp
bky: crq
ask: azc ich ipt imo
khl: kmo rwf ror bgg
buw: chz
blg: blp ckp
ctx: acq aeo irb ivy
blh: bji
rzo: rqf bgg cke cko
amq: ibw ial imt
cfh: ajh irs iwu ivy iey hrc
bjo: bqv crc crw
kdt: rzg bso cbr
kse: knt ram rxg rtt bpn bmu bti cka cre
ixx: inx
aje: amb aqa auh iag iym
bqm: cyv
ijp: isf ixo
aqt: ikk ihk iwy iqh
ihz: idi
apy: azt iih iym
iap: idy ify
knj: rvp res bjz cgb
ruf: ruq
rvo: bcu
cxt: cus akm ait afm itz
iih: idy
idy: hkw
kxn: rxr bia car
ctc: abi ack aws anp aoj hkx
ahs: aee icl isw
bgh: cce
ids: imt hkg
bgt: bnv bqe crk clr
cpk: agp icd imi iny
adf: ast azk aoe isv hkh
cxr: ibj iiu igh isr ifd
ire: igk ied ien hky
iwl: iml
krs: kby kek ryw bkl
kay: kuh kuv roj bhx ckd
cvy: csx cqf akd anf aus
cum: aaf ahf ibb iwv ies ipq izg
bsu: bqk bqg boq cbe
ajs: ila iol
idn: ivw inc
kme: rdv rvz rut bgt bsb
rpt: rov bcb clc
azb: ibf imq iub
iel: hks
ait: ivh ipv ink
awa: irl isg imy hku
anc: auu iyb
bcv: bih bef beo cgd
csa: app atv ikw ixd ixz inh
ckg: crb cbm
kjh: bqz cgb
khm: kgs kpq kzq bxw cbn
rge: rph rzr bjf ciz
kol: rhw rhs bvd
kuk: rht rdr bhr cga
byu: bgz cbi
csx: cmh cmz ajp icv iqq
imb: ing iqe
bsz: bmx
cfy: cqh akm aba abw asq atx ilb
ram: rvq rxd bhu cki cbh cbq
koa: rcs raz rxz rnr rzz bdv bqr chb
apx: afb iij ihd ije iem ifa
kcd: rbw bas bec bnp cwt
bdj: bdp
ktr: rar rpa biw cgn cda
agf: att ikb ihh iyp iqh
cow: ata ijz imz ioo
igb: iwc ivh ios
rzb: bzk cgj
bkl: bbo byy crj
rsv: rej rfb rtp bkr bay bhz bzq
aau: asu axl iih ivd
cyb: cgp
kda: kpc kzh rrz
rcu: rdo brg bcz bve crp caa
ady: isk isn iub
ane: iug
kpi: knc kfv crl cgg cww
ksp: ktn rlc
iyj: isn hkw
rio: bpo bmt
brp: bgh bvj bed cko
bkv: bkq bmr bnn
ibb: ivq imh hrj
kgq: kmi kok rgm rvk rsm bil cah
aya: aqr aoy img ioz
cwh: cwz
ihj: ihq
kft: rhp rxm bbv
akl: acw aii ajr iau ijx ism ifn
rme: rtm bjb btt cbn cwz
cqc: cte aac ihi igk igy itf hkm
ahw: ael iro iak ixa
kgk: kuq rkn rah rpz cia
aqx: icq iav ivk inb
rzm: rot beb
kzf: rlh ccd cct chk
ina: inq
cjv: czd ame aoz ink
iwz: iuu
ima: iup hrc
bsj: bzk cbg cir
rea: bbn cip
cft: ahr ili igi iww img ioo
iir: idt ijq ien
rni: ros cyc cls
bob: cbo
cnb: aii aih azh ieb
krm: rpt bah bwq beg buf
czf: aiq ayv ihf iwr idi izr iuo
aer: iyu idu ivv
cii: cip cwi
kjo: kol rpf bre bds chb
aol: ins izx iqy
rth: bni bql bub
rjl: rsn rew bad bhj bsc buy
asz: afc ihv iwv
kuq: bis bpn
kvv: kpu bza buy cgp
bir: bhm cwe
rgs: rja rqc cky crv chj
css: ced cod ajs aou ics hkx
bin: bqi cak
kdd: rtt bve bpy cya
ixh: ixg
kyp: rep rmt btv cbn caj cht
arg: aby asy iaq
bek: bpk cir
amz: atl
rmq: bwn bjs
rmz: bei bzf clx
aed: atv idu
biu: cbf
kau: kgj kdm kxx rjw bml cwk
ryy: bsa bpp bmh cri
rqd: btu bux cyy
kwc: kzk kou rrm rhv bbf bxi
rra: rot bcs bgo bvu clr
cby: cgg
keg: kol reu rmr baa bij bww bml
alt: asa ici ill
rje: rol bcg boe cyu
kkd: rqt bbd bxo ckr cci
cjx: ced cpf cqu akb ich iha ifo
bfx: boc clv cwc
rqf: bby
iag: iye iqs
ibz: iqb hkb
cfc: aat ame afr aug ivs iur iol hkd
kzq: ron bak bzl bth chw cgz
cex: agt ajg azh irb idl ipa hrh
khg: rvw bcg bdp bxk cbu
agn: agu avl asg aeh auk irs iyr
rpc: byw bfn cgs
bvz: bfs cbv
ayh: ajz aqm isk ina
biv: blg bjs
axj: anw aon ich ihd ipc
kcv: raq rxd rqv
byh: cyc
blx: bfe bzb bok bob
aeo: ihl int its
bhx: bfk but
awn: irh idc hri
rxh: bhx bsu
crh: cyk
iri: iie idb
kam: kjf kzr rdj rpw rup biz bpp cly
bra: bro bax bdn cbl
adk: ase azu iwk hks
kxr: kth rcp bkp bhr
kbh: rav bjj bxj bqm
afa: afu iiz ist itk
rzd: bcd bjp cbe
inu: iol
rbg: rhw rdx rzy bdq bzi cyj
bfv: chu
irv: irm iih iwp
cvl: cmm ami iks iio itm
cza: akv aay avk afy aod
kzu: rty bau bnx
kph: rhv rwx rex rfk bgk cau cdi
igk: ipm hrh
kko: kto riz bbu bai bsw bzy clk
rvj: bfp
rdl: rpy bch blx cgh
ise: ipv ifa itx
idl: ieo
kkv: kbg kew rcz rvj rxe bha bvt
kvz: kpn ktv riw rvs bjh bxu bmp cgw
kep: rhb bxp bnz bqd ccf
klk: kdu kqm rjx ruu bdn btk
bcy: bey caw
cxc: cfm aml aqh auv ivz
cgp: cwj
rkz: rdt rmo bcx bmp cre
rhr: bsg ckx cww
kqy: kot rpe bvp
riu: ren rfw rui bfq
abz: alh ago afx afq afo azg aqe aof ilk
rcf: rfb roe cap
bau: bgk cha
kpl: rkk rpa cyp
bgx: ckt chg
aff: iqd
kdu: rex rxx bwh bdm clj
anb: aud auz irv idu ifw
cpd: agr asd idc ixt inz iqy
ctt: asz ihh iyq
czz: ady aus ikx imc ifm izb ioz
rsi: clx
rqz: byu bwt
cdj: ayy auu iav iwj ijp ifq
kgx: kwz keh kfn bbf bir byr
adz: ama aqk icb iwp ixy
kbi: kvy ksg knt kfy rov
bst: cke ciy
aoh: ikc ilq iws ivm ind iza iqd
rkr: rrt rbq rym bbt bsi
aem: igq ijg ieb
rrs: rmq rtj crc
rhq: rdt rjs bdo bjx bza
rpp: rqe bby bat bja cku
rmk: rmz rtj bbx bxb
iqf: iut hrw
cei: awb axj amz iad ied
cno: abs avf aek ivs
ryp: rnl cyw
auy: ibx iia ihb ijt ivi hkx
kpu: raf reg rzv bhs cbj
cui: asr aqy atu aud ihi imk imo
ahu: axv iwd itk
bpp: btw cad
rlg: rvd bac bdz bvp cym
riy: bcb bid cks ciw cwh
ken: ric rdm rss rxa rqe buo crb
iie: isb ifc
awq: axi imq itw
bkr: bww bwx
imu: itc
bqc: ckn cha
aul: aus ijz inn
raa: ral rdw bhv bqy bqu crm cau cys
iaf: inw
kbu: kqj rgm rvy rsa bho blx bgv bfn bus
igu: iuu hra
acu: ahc ibj ial iza
kpo: kqu rkv rij rur
cuq: acp awk avb ild isb inu
cov: icw iye ilq
bzo: bte
kvw: kne bbw blz bpo cbr cix cdl
igt: iss iee
btm: bup
rac: rvc bia bur cgd
ikl: iis iha
kiv: kmb raf bau biq bhf bwd
bhu: beo buw cwr
bzy: cga
aua: igu
kkh: kij ksw kxi kxo rle rgs rsr rnj rft cle
rsj: rqh bdt bsh crl
bbb: chl
kpr: kqw kod bck bsx bus
bqx: cbe
bxa: but
kri: kis khj kgi rkg rbi caa
ihu: iea
kpk: kpy ban bnn bfs
asy: apt idh iep ieo hrv
bre: bbx bcd boo cbi
caz: cgt
kxs: kmc ktt kog rkm rri ckf
bgd: bny
kdl: rzz ruf bua ciq
kgs: kdt kof reu ron bbm bgk bwb
rrd: rlu rsp bdv cww
rbo: bjb bfq car cic
kbx: kef rsu crc cwl
aag: aae adu iki iuw
bsq: cwx
ktg: rwi rww rst rnd
kes: rpm bjk bqy cho
atu: iig iha ixc
knf: kqy rwa roq bdq
rcq: rnr rtl bau byy bdj bfl ckh
brh: bcx cbx caq
asu: aut iky ikq ihj izy
iai: ijz isa ipu iqa
kfi: rci rdi rxb rnr bei ccb
rgg: rxx rnt bgp bmn bzj cgv cwk
bfm: bui
roy: bwr bwu bmp
isq: imu
rcc: rjs rqs bed
kzz: rzs baa bgg bgx bvw bvn bow
awm: asu iyh iwn hka
rpb: bbg bur
kku: bkw crd crx chy
bjy: clr
kup: rhn rwt brt bbs cwa cwn
bid: bxt bzu ckr cgq
rzy: byc cbt clw
rot: bcm bcu bzs cwb
ihe: ixl inc
cfa: cfj cti awr icr igj iqo
asd: iri inh hkj
bwo: chx
azj: ihe
ren: rzb bht bqx bqz
apz: aur ihd iyw ijr ijq ipa
atj: irj ige ino itq
rtd: bld bgr bgz chm
iwu: izw iuv
iis: ihf igw ivi
idz: ini
kgy: kel kxc rto brq bpj
kdq: rrn rbz rsb rmb bnl bqu
ifu: ita
kdo: ksj rry rsi bwi
kid: rll rzj bfn ccz
acc: acv ava icw ial iwa ixk izt hkl hke
igd: imc
rzt: bga
bci: btl crc cgl
ahq: iry iig ipi hki
aqj: hkq
ihq: iod hkj
iik: ilw
asw: amj auu ige igz izk
rxb: bug clc
kxi: rdn bxi buu crb cam
cpu: cqw ayt alc afz ath
crb: cam
csu: ayz igi imy izu
cfr: aji azz ibk iut
adq: igm imp ifv izs izf
bxq: cyh cwc
rbw: bjb
avo: ipm izj iqn
bkp: bbm
iwg: iwp idh ijw
rba: rvc rnl roh clw clp cww
khj: kgj kdn kql bpq buo
ilr: iwi
rst: bpi cli
rjo: bvt btd car
bxg: cck ccz cla
rdo: bkl ccz cyt
bzj: chz
iqj: iub
bgn: bwa bzb boj cla
kif: khm kpp kzs rse rmd
ajq: and afm iif ilo ino hky
aox: icd iem
iwe: iek ixx ipg
bzn: buo cyk cyw
ato: irb ihp inf
rnz: rua byf bww cin
ksw: ksq kzh rss bns
ivc: ifm
rjh: rng bbi bvi ckv
iji: ixx
axb: iyp ixz iuc
bvd: cyl clq
klh: kvu koo bkb bsf bfg bum cgh
rgj: rjd bsp boy cgb
anw: irw isu
ccf: cwl
kqi: ryl rwx rdm rvj rtc big bgc crw
bnd: ckm cws
bbc: bbp bfn buv
akk: aeg amm ang auy ipa
bcb: ber bew
cut: awo iku ilz ity
bhh: bxq bze cye
rpi: rmm bar bft cyp cgq
coh: ava irb isu ioy
ipy: hra
bbo: bwt btn cab
rxy: byb bdk cgs
rva: bsr clz cwq
rfb: bwr
cnu: ctm arf ior
rsk: rni rul ckb cbe
bmu: cib
aai: iva ifn
bwf: bfv
aih: ale agi ixn
rnl: rzg crb
ksy: kms kqf rhr bhg bew bmt
afn: inj izz
cmg: azs aoa iil idb
azw: iyy iss
aiz: ayk awc adb ajt iwr iqw
rds: rjr rea rfm
bhz: bvc bvn cif cgl
koo: bvg bxt bns
rip: ryn ree bss bfg bul
ctv: ihy iek inu iqs iug
cea: cqz irx iaj iiq iqk ioe
ryk: rgo crh civ cgq
bvx: bqd cyy
kng: rik rog bat boj ckb
ibs: ina iop
iyo: ind
rtw: bjz bpd clk
kch: kgr rko rea roa rod biu bnj cam chw
rpk: btt bul
kzk: cax
byd: bdw bnp cko
bpi: bth
kzh: rcp ral cby cab cwk
cuv: ahc ayp adp azz inb
cvc: ahm awn aua auh auj iid imw ifk
rkf: bkq bsc cgp
krx: kbp ked kfo ktl rps rtk bjy bnq cbk cbx
cep: cmf ari ard aan iga ipb iff
aad: asw asx ann ivo ieg img iqz
csr: cxs ark avd aso aex
bub: cbu
cfe: afi ilp igg ize
knn: rcp rho rwa rmw rzr bgi
caa: cir
abs: acz awy isi ifq hrg
kdp: knd rcg bmr bta
kjn: blo bwf crz
brw: chq cyv cyq
rmi: ruu clr
chz: chq
kgc: kps rws rxb rpg brn byp bfy
csg: ara ibp icz iiz idf
axv: ijn isw iek
ald: aql atn ikv iwz idc
baf: bmq crs
bsw: bqh bqs
rry: rrj rbs rcq clo cdr
abe: aeq iee ipj
aaw: ibo idd inz iom
aaj: ajy ide hrc
bmr: bnu
afw: iaw iyb iwb iwu isk inj
cqm: aar ain avq azo ing
aub: icr ici
rel: rfx bre byp caw
bit: cck ciw cyi
bnh: cch
amg: iaa iwx ieq ips
ilw: iwh
rzp: bic bsp bqq chd
aqa: atj icn iyz ilu ipk
agh: afv hke
kzr: rsj bbj bhu cby
rzx: bpo cbs
ayq: axc iax iyp iur
kyw: kyt kwd kdm ksd bop
akg: agv amz ana atc izw itn
ktj: raa rxl bkc
rlr: red bko ciw chk
cjs: abf acv awa aop irv izm
rwx: bxh cin
kqr: rrr rak rln clt
kcc: khb rlu rou bsa cgp
rkh: rvz bcm bef bpt bzz cwd
cua: asg auu
rav: ran rhq rnj bav
kmi: rxr rnc bpx cbs
aoo: ivl
kai: kmz rph ruf bag bur cip cwb
rck: riv roi ccx chd cln
kio: kxp kta kuh rla rti bpt boi
rag: rhx bwq
kxw: kpy kzv rlz cid cgf
bib: bds bfu
bxk: bnj bza cbd
afl: ihm isa ixa ipc imn
cfx: cuo alw aww adw atg hrk
iuc: hkw hkf
rlm: rvg rnu rzg baz ckp
ijr: ieh hko
ruq: bcu bsx
ijm: ixc ioi
rby: rwk rfd bco bew boc
kav: kve bzf ckm cbp
ktp: reb rnm bwu bvt
kxm: kov rhv baw bzr
bka: bng buw bou
cmy: cqv cut acy igr
bji: bfi cra cbp
kzd: rla rpl crv
rud: bak bzl crh ciq
bsm: bnl
kdb: ked rgn rfr bgr cbe
krj: kcq kve rjr cal
aup: iaf ihh iye idm ixr ipi
kvn: kpm kot koo rwo rqf bad
ieg: ifj
bti: bui chc
bpw: bqm bqz ccf
bwg: cyg cwe
aud: icl ixp iuj
kpq: kqo rtd bvw bef bnz
rqe: brv bhk boo
aar: alg ajv anc auf aor ibw hrh
kjl: rxi rfj rue rox
csk: alm apj ill
keu: rri rzt bhb bdb bqr bqx
kzl: bdc bdd bot
ibt: ifv iqu
czy: ali awm ajg ifb ifm ite hrr
bwx: bti cwu
kvl: rju bku bvq bxz bot
kgp: kex koa rnv blf bsl
awx: icz ipr ine hrc
rnv: cif cgz
bej: cra cis cgx
rzv: beo cal cii chk
alb: aso ido
rhx: rwf red bpi
rbv: rsl rfv rfe bdh bsf ccf cil
rwr: rev rem bzj ccv cgv
bll: bxo
kjd: ran ryw rnk bbq bgy
avb: anl icg
rgl: blp bwj cyu
agq: iwo ivn iqb hrv
iyc: iyp idq ivo hkc
iia: iji ito
rlz: bsh cks crr
czg: aix ajy ito
aqz: ihp igp
kdz: rrx rhc rmf bxb bng crn
chj: clo
bpe: bfq cym
kez: rwy res bbf bai crw cgm
bxm: bpu bmw crj cas chj
ceo: cma acb alm adj amg imp
cfd: aad ahb auv icl
bcr: bne
apr: aqd igr ion
ivw: ipp ift
aqn: iyj isz izi itj
ajc: avg afc idg
bni: bzt
kok: rxj rnd rol bkg cka
itc: ite
cvr: ayf amo iku isz ifc hka
kuz: rio bxn che cgw cdy
ijc: ieb ify
bxx: cci clz
amp: ixk
axo: irx ivz ipq ito
cet: cxz czc azn aow ide izs
ctb: aka aos iyg ilj iqj
kju: rcn rad rja brn blt cba
kgw: rab ryl rsd cgc
rns: bvd bmi bfc cko cij cwd
kbl: rib rie rye rgu rns bkt cru
aqm: atx ipb
bgi: bqq cag
kmb: knq kot rgb rep rmf bgc bnq
ryi: rmn bck blc bje bvo cck
rdh: rfp cgk cgj
cra: chc
bvf: bfv bop chx
bet: bpt
bri: btw cld
rxw: rnd bcy bev bpu
idb: ivl
agg: aqb aot iht iqu hkb
ksv: roh bae bsg bzy
ijh: iej hkd
ahg: agy age adj axn apf amw amn
bgq: bfq bty buc ciz
cjt: akc akt aah avp apt
ryu: rmy rqe bib
kxz: kfo rwt rxx bks bxn
kwn: kex kpa rlp bgl
csy: cnn cfv asb auc igs ijx ixs
cvm: ctr ctw ate iau
ril: rid rdj rmn rnm bwu bvx bzb
crx: cyk cyn cwi
kzv: rhi blw bxj cwx
asa: azv ifd
bun: ccc
coz: avk axt afy
isj: inu
keb: riw brl bqo cyc cwz
axd: iyv idk hrl
cvg: cqh ahz auq inf ift hkx
cod: aaa aht irq ilv itt hkv
rcb: bsp
rpf: rzt rup byk bje bmc bqc buc
rgv: bgk caz chg
arh: avr apa aob ixj ifg
kjg: ksr rkv bwe bwo bef bmr ckz
ank: ikg irj iae iik iif idz
bty: buw
aay: aat alt agq afv iws ipb
avv: irb ihp ixv
ikd: ign
aco: alp adh ifm ity
knh: ktf rbm rqv bwk cwd
bum: clx
ivg: iew
rhd: bku brq cka cyj
isv: ipv ite
ibq: iik ivd
aae: ixj ifg
ahk: asq apw iju ipx
afh: iwf idx ixq imu itp iup
cmk: cnm als ibn iak itk
bpt: bql cim
axg: itm iox
kfn: kty rnp ruy bif bhd bwv
bvn: bpb
att: ibi iut
isr: inz
ipu: iuz iog hrl
ijs: ijx ipz iud
brt: bnd bti boj cdb
ruz: brk bdk cyi cgh cwa
btl: ccc
ksn: riy bxx bzc cit
rxo: rqb bdc bqo
rrp: rxw bfd
crj: clq cgb
rvn: byg blu bjc bxu cwu
iti: iur ioj
ifd: iqr iqq hry
cbr: chh
rqv: cby cwp cwo
rlo: bkr brd btn cke
rrb: rsh ron boy crr
ctp: abo apy ipc
rkn: rgf rdv reb bhz
rsr: rpv rup byg cwe
rjb: rei bjv beh bef bnq
asg: amk aot ihz iln
ces: aqu irz iav ifl
kba: klg kwm kzm bgz
bqj: cbw ciy
kcu: kif kqo kor rco rec ren rmy rfw bjz bek bpq
kxl: kus rzu ror btt bus
kmu: rpb chv cyl
csh: cek cua agj avp amz ian iym
bof: cgr cgi
ace: ane iwj inp
coj: arm aii iph
iuv: iom
bsp: bxu boi
bgl: bpx chp
ibv: ila
rmt: bzf
cty: aia avs irm izn hkp
rie: run bjh bvm ciy
kzs: kto bah bvv
bne: cbz
cfj: abb aak agt afu auk idg iob
kqq: rkb rxa rnx bct bld bnr chp cda cdh
kjb: kox bjv bmi bti buv crm
kkn: kmx rdn blf bxz
bbs: bel
bhi: btz
rgh: rzn rtk byw bjm
bjt: btn cbd cgu
kyr: rcp bjv btf bok
ceu: cnz aiy aev idj
abv: ajo afu iba iyr izv hko
cgi: cwv
rpm: bdt bvr crv
arw: arf aip apn ana aqq iay ixw
bjp: bzt cwz
ktf: rar riq rzq rtv
ilp: isf izi itd
kcp: kux koh rje rmt rop
bae: bzc cyx
iac: imi iov
ijo: ink izs
csf: cqc cqn ana ikb ihr ipo
ild: ige idn hrl
rsq: rtg bcj bxb
kib: ksu kmp kmz rjc rvm bcr
atw: hkz
rdb: rqx byo bfx cyw
iad: iyj ijc ius
kmw: kot rid rvc
kwz: kpi bdc cls
cpl: cnc aka aix aei iiu iwq iex ins izg iow
cgv: cwf
ror: bcr bvt
bos: cid chr chy
bdi: bsn bqf cbx
rcp: ros cyi
rug: bls bwo bsa cba
iqv: itb iuz
cuk: arg ahn add ann
aro: ajt amo azn
krl: kyf klq rrb rce rwc rql bjg bzj
kje: rzd bbm bio bjf bpf
idw: hkg
bpr: bqi cbe
cup: aik ayg asp apl ild isr
ars: awe asf iqe
atn: isz
bsc: bow cyg cwa
aea: atz
anh: iet imc int
ksl: rqq bhy bwy cbw
bdl: bjn bup cwy
cai: clc
rhh: rtu bvz bej bxe
kth: kuq rij cim cdk
rxu: rty bah bwk bnm chs
krr: kwz rra rjv rxq rti bjy ckx cik
cjz: aat ahs ass ics igd isb ixr
cbi: cif
akf: ahb als imn iqj
irb: iay iaw
ate: iyi imp
bbk: bwn bua cid
aou: icg ile ift iuc
kzt: kqu rvg
asn: atq iby ixu
rve: bdm bmw cyf
bjq: bvs beq civ cha cwj
cfm: aye aqe irw ixx iqm iur iot
bvy: bet
igh: idy ijl hrl
cxi: adz aep aof ikn ity
rvr: rxs bmw bmq bnj cdr
krd: kob rnw rzm rqx roe bng cys
rll: rvy rnu bcf bgx bpi cdi
ctg: aio aty ihh ihy ijj
ihh: iqe
apn: afk ira ibv ihq izt
baw: bjd bvf
ayy: awm avy ial
ryv: rmz bfw bzo cch
ikn: ivb ioa
kyn: kdh kpb rke rrg bis bfp ciw cln
bbl: bhj bdp bxx crn
iln: imk
aie: anr aoj
bys: bdo bta cyu
afu: iid ijm isl ipk
kxc: kms rdu bsz bzs
kym: rjp rjq rep cht
ahc: asv iia ifs
bnr: boa
rjx: rqo bfq boo cri clw
kae: kvg rbf ras rxv roy bbq bze bta box
ihg: iyi idt inq hkw
avh: axc azy iug
rfj: rqg bku bir
ahi: ahq ikx imh
rzc: bpd bmr bzg btl cak
rxd: rov bfk bzn cye clf
rro: rax bue
kem: kun rrm rmk rqs bbc bcq bwl bna cca clw cgk
rph: rtx bym bvl
ibg: isg izv ioa
abx: aag axx izr iqa
kaa: rrb bmk bmh ccg
bak: bzl
bep: bxa chn
kci: rhf rvm rsf rny ckn
kie: klj kvv kfm rnh roj
afs: ipo
kht: kzx kuv koo rjy bps
iip: iwc
igr: iqk
byv: bol cwm
cqo: ajj ird icf ilh
rut: cwa
kig: kys rsb brc bag chr
rmj: rut byf
bzi: ckv cke
bph: buv
iye: igq
ceb: cee afb ilk
cfz: igo ijh ivb
rwh: rxt bhl bzd
kms: rmv bju bzj cgc
kwx: kxa rwl cgq
bdf: bsr bnw bzq
kjm: ktb rml rfs byz bnd cce che
kke: kiz kjo kzb kqt rif rxr bub buq
asx: ign izc
cqr: air axe afs
chg: chx
blj: beb bnl bne cyx
ctq: akf azf ihp ilt ixx
axw: aqd aos iri ixn inn hkg
cos: aak azc ibr ico
rtg: rot beo bnt chp
arz: aaz ajt anj ixh itm
kjq: rbs rhu ree bah bao bft chu
blv: bjr caw cyo
byt: bem bto chl
bjd: cke ckz
idk: izb
rdw: bri bqp
bwz: beh cha
aoi: isq iep
kyo: kpf kou rhw ryd rtz bat bhp bgj bde cwo
bmf: bok
rhy: rjx ban cck
kld: kgb kdc rbq bld bnk bty
ajt: ave aor ixc ius hrj
bis: clq
kdm: rdv rxz rmj rng rfb rob bhe bjo
cnr: ahv ayp anb ijc
cvu: cpi abp ayx alw axw axo any ial
icw: icd ihk
aqh: ikl
cso: ceg ced ack afm
ruu: bdq bfm ckn
kye: kjm kue rvp rti bgs cho
bgy: bpl bzh bqb clk cgs
ioh: hrb
rkt: rla blp
cti: atv aod ipq hkv
rpx: rup ckv
brz: bax chn cwt
cxh: cpz ayp alh amq ihe iqi
kwu: ksr kmu rro rud bce blk bxd
igs: iel iqe
blr: bgt bxr bqs chq cgo
kpw: bgc
cat: cwz
rlq: rge rve brx bow
rmx: bgd bzg caa
iaa: ihq iez izf iuv
bou: cbt
rse: rfl bdg caz cym
bmm: ciy
kjc: ria roy bal ccj
rnf: ruk bvy cwq
cdp: cfk cox any aus isv ien
krn: kds rld rsc bcj bqm cwe
avr: ire ihj
aeb: aes aub ibu icx ihw
rtr: blt bnm cge
cpf: cuf aqt atk ida ide ijm
ihr: isl imr iof
rvv: rou bfq cas cib
kac: kdl rkj rts bac bwq bsn cbz ccj cyp cww
rax: rix byk bpe
ixe: ipz izv
avz: axn aoa ird
kvq: rgc rdv rjy rjs cig
csp: ary arg aau avj
ilq: idh
aqv: ibu iyt ild igq idx
ktc: rxp bzr ciu chr
kkp: krb klw kdm byc bjl ccf cwy
kzo: rbq rav bag
aiv: aif awt igx isc iop
rmo: bhm byk byh bfn cyk
bhk: bsx bmk crz
aij: ayv avi axk aqh
cqa: abl ace avb ask iyg ier iqu
rkx: raj rqg ruh bdw bql bqj btk cbf
rvp: cyt
rmv: ccb cyi
boy: cis
kho: rlp bzv chp cyp
ais: aha agz ibk iyw iuw
rqi: bbq bpw bzs
buc: but
ann: idp isd
iwk: imh iul
irl: ixi
rjw: rni rus btv bow
alc: avw amy aza ixx ina ita itd
cbz: ccu
cxp: cpq czi czh agf aea iwd iey
roq: bkz ckp cbf
bhw: bzt
cob: col abh iga iqd
igw: iwc imy
idv: iny iox
kui: rvo byg bdv
bhc: btf cht cgg
rus: ccw
klv: kzp rii rgk rzj cke
agx: awb awj irf ilx
aow: iiy hrd
rux: bsb cwl
ila: izl
azu: att iyc hkq
ays: agh ang ior
byn: cwv
ilm: ipy itj
brj: bqd chf
ric: bwi bjd bmd cch
rlj: rgq rpz
cma: cmf ibd hku
awu: iix iga
ibx: ifv iut
ahf: aja ajp ikp iex iom
rpy: roe
cuj: aks anm ipp iuo
adu: iay
ksf: kzd rpt bzf
kgf: kzn kqg rvu rta bkd bxk buj crg cru
bkw: bbm cix
kfq: blf ccm cgs
czw: cqh cta avy ape aox aoo iks ilo ixi
abq: acd axy iwv ixd
kpv: bdo bzc crw cbc chg
bcz: bzu
ctf: ayo axg ihi idv ixy ioo
byj: bwc bdc buo cdi
ccx: chx
ayi: amw iki ibx igq inr ius
klt: rkg ral ban bgb bsa
ipq: ime itn
kcg: kmj ryz rou beb bqw cwk
caw: cyr
ani: ile iwm
ihc: ipl
rwb: bgz bnh bof cbq cam
acf: aco aah apg afj iyn
byr: bzr
iij: ija ijj
czq: ahr ahz adu iax iyg inw iqu
ria: rdl rxt rzu bku bfh ckj
cfo: agg avk ira iik ihw iwz ixw
asr: auw icd
bhs: bfa
aab: alf azn ibx iyy ilh itm
rhg: rpd bvs
rqw: bmt
rrx: riy bdj bsn cwl
rdi: rsq rmv bxb
knp: kfy rtf bug ckj chi clm
baz: bwa bud
rdj: bwp bvg cdh
cqn: cuu cop axs ihp ile
isa: hrd
kjt: kvf ksb koz riy rpq bax
cuf: isu imk
kag: rsy bwg bsl cgc
rxk: beu cgl cdi
kqp: rmj rqs bxn cam
rul: bhg bsm cks
rny: bgh bmj cys cdb
aku: avu ibk idf ims itw iun
bkj: bcw bha bde bxw bot
cvo: cou ahd aly apo amj ani ioo
bcu: bda caf
koc: byr bzk bov cki
rja: bgl cle
alm: adu afk iyx
ksk: reb rzu bxd
bvo: bzq
iwh: ivl iei iob
bgf: bdf cal
are: ada axz aoe irk ids ixz hkp
rjg: rxf bbb bhe bjt bqu cgp
csq: ctj coc akd ajx idm ify hko
aii: avc ilj iwi ima
cor: aii ibu iai isr iuo
cvz: cnu alt asi axj iit hkh
bhp: bda cac
bjr: bzj bzx clo
kiy: kpw kut rwe rfv ros bhr bgm bwr bwn bsx cac
rlx: rul bco bgq bxr
cnw: cnx awm awo aom ihy iln ime inq
bjh: chd
ryn: bkg bpr boq
bmd: bni bua ccg
cen: ahs ayt axv amf iwg iwp hkg
ixo: int itc
aan: agu amu iie hrv
ico: iao itn
aee: ikr iou
kde: ksl rrg rvv ros
ict: isb itc
rpg: rtd
cfs: cff cqk akr apj aum iyh ivu ifr
rmf: civ
cxq: aie ahl amt iks iat itx
icp: iar iqt
rbm: rgw rqm bkg byb cgl
rjc: rzm roa bzh buv
bmx: bzq boj chc
ral: rhh bki byw bfw bty buy
kll: kqf ros crj cbm
kkg: kgt rzt bbh bcq blh bxd bnf
cmi: ane ikl iew
rfd: bif ckh
bwp: bfd
cbx: chu
khb: kjk kxo rfg cbw ciw
rnm: rtp
khe: kmd ric rlq rpx rzj rzz bka bko bon cbo
kfk: rsd rud brh cal
rum: bjk bmg bzu bqe cwv
ans: ilf iuj
kxp: kpx rvm rff
kcy: bgl bvj bse bxw bqw
axn: azg aog iix igl
kck: kxf kzg rrb rhz rml rzf bcf byq bem bmr
kra: kxr bkd bja beg clu
aew: ikr ikp iln ixt
kix: kvc rcq rvb rvp rsi bhr bst
kov: rzv row bgn bwn bqz ckg cbz
krw: khq kjq rro raa rna rzl bhd bje bfp cij cyx
abr: aae aed amn icu ian iyt
rzk: roi bix bjn
btx: cbu
rgx: rod
bxe: ckg cwb
cpv: cql cqv ais aqe iqu hkn
ckx: cwh
ajf: irv iwb ixt ifn
cvj: ctc axn ane aod
ibm: ijy
bnw: bql clf
kaz: kee kfs rcd rzl bam btl clt
rlt: rgj rgx rps bme bfr btb
afd: aqa ata aon ies
cje: aaw adm azj ibs ido ivd
clb: cpv
ija: ivj
kkj: kqg rdk rvp rew bvq
ich: iql
aur: auh ist iuz hko
bco: big bvh bnr
aka: aii iat
agz: ird irz idz iqd
ayd: awv iae ihu ins ion
ctd: coz akh ane
kzn: rsd rsq rom bto
ali: ags iru ist
adl: asp apy
rlh: rmr bvc
izf: iuy
cxk: arf ady avy ilf ifc ifu
ifj: ioj
rrl: rvp rsn brh bip bvj
rdx: bfz bzw ccc
clo: cwt
boh: clf
kkw: kgu rev rth bvd bpq
imc: izy
cdf: acx asa aei irm ihs iya
ijw: hkc hrk
rjt: bbk bcy bax bwh bmk
blc: bxb chk
btv: cbm
cmc: aqr ikt irj ibc icf isi inr hkt
kkb: kbq bah bgv bex
rrw: rwm bpt cyd
kek: bkk bym bdq
rza: ror bdm bsv cau cyp
cbs: cci
rgb: rpp bxq
kwm: knn rah bit cle
iec: ixc
akq: avy ijt hrr
cme: cfr coq aro aij aeh
bur: can
krg: rwf rqd bwu bfs bfo
kca: kaf kgi rcd bey
atq: ilg ixi
cmm: all ibw iln ioa
cir: cgk
agb: aoo ibc iyz inz
rfr: bby bbg byu bqe buh
avd: ato ilt igm ivg ieu imw izp hkd
rcm: ryx rxc rom buk
cwv: cwm
bts: cky
rrn: rso rec rqe
bai: cyo
ruk: bys bwb cwq
bme: cgy
abu: adl amk ihr iwm iok
aum: isa
cps: com aju avm anu ibg ife
csd: ceu axq iho idt
byq: bsh bep btg
kgm: kdl key kon rrw bke
cxg: cfp cqn cqf cou ajb ilw ivx
ipp: itl
imo: iom
bfs: clr
acz: avt asb
igc: idl iep iup
bzz: cwy
kah: kli kvv kes rte bfd
abp: ibc iib ive
awv: axz afd iqy
rbc: rxz bnc bnz bft cwn
ism: iuf
bzc: cro
rvi: bgv bec bem cgz
amr: iri iig imm
knl: rcl rix rqm blj bvl bpl
abo: agv iiq
kti: rcr bvw bqm
raf: rlk rsz bic btd cis cgx
czk: cua ivg ies
ahv: aqj iam idh
api: idk ipn iqu hkg
ilk: ind hrv
ryj: rww cae
bqw: bqj
kcb: kgk kgn kqw kts kto rrw cia
cbh: cyb
cun: arc awa apk irg iao iwb iet itl itv
bxj: cko
kqc: kue rku bmf bnv crd cgm
cuw: apx aqx icu ieh iom hrh
kar: rnl bab bdx bqo
koz: rip rol bwd
ind: hrb
izt: itx
cjh: cue ado icf iit iss ipp
ivm: hrc
aaf: afp iab ili iww iqs
bxc: bot cbq
byk: bet car
cre: crf
kbm: khc kqt bam bvy bxl crr
atf: aok iab iep ipt iuk hki
aat: aiv ahz asx axi ihu ijp izj
kwh: rhe rmq blm crt
rfq: bwh bxp bmo
bnv: buo
idq: ifs
kwa: ryb rlz rwg rub bdo chq
iku: irn ibt hri
aei: izz hkw
ivl: ixx hke
ize: itl
rap: rhz bct bme cyz
chp: cwq
kwt: kjc rln rec bfd cct cht
btb: cyw
kod: rrx rgt rjn bla
kor: rzj bdk ciq cwp
cvt: cpl ayb adb aqs ibd ijx
isl: iqy hkq
irg: iag iap ign izf hkm
bsr: bsq boc chp
rvy: rfh
ban: bmk bzc ccd cik
iqb: iqe
czv: adp aew ilw ivs
iub: hkz
kpj: kfn rir rvr bes cbr cda
bdg: bxu bnx crf che
adm: aea amb iko
kbq: rbo rct rsh bcd bsl
atm: atz ijb inl hkd
csl: aiy aye apw ijc
kiq: ksx kfw ryo rtb bcc bvx
cvv: akl ant iym idp iqz
rkw: bsm ckd cwe
bel: bpb bqm cig cgl
kit: kfe rrh rjd rni bmh clg
awz: asz ikj iht iyq iey ipr izc
abc: ade ilh
kva: kvv ksm rsu bws bvi bnu btm cam
aoa: ird
rnu: bdw bsv cru
ajb: ibu iyp ijy ixj imb itr
bbv: bap bfn boi
bhj: bnq bno chr
bsn: bzq boh
kxh: kpl brg blc bjd bzj
ksr: rcu rah raq bcb bhs bdn
aca: ali afr iyc iye ixm
cff: ayu ika ilb izd
kev: rkb rcs rpy rfp roz bby bzc
irs: ias izb
com: aaq ahq anv iwr ipi inx iuw
rnw: rzh bso beq
bba: bbu bdg bjv bva cki cbc chj
kge: ksm rre bvt cbf
rzq: brx bdh bmj
ase: ikm ihx izb
kso: bxq btg cgy
kqa: ryb rwz rqn rqo bju bsz
aqc: aom ixa inv ino ifu hkf
ige: idf ifl
kiz: kyx kxj kua rcg ray byo bvg bee
avi: azp ijr iza
iay: ihj igs ito ioh
ked: ruo byx
kyb: ksi ktw kuh rbt bpr
rsx: bbz bal bek bxi bfu buq
rxs: byz bjv ckl chc cwt
blm: bdq
igv: iqe
rsu: rpm rfg bhy bvo ccg chn
ain: ams amo afm idr isr ipy imv ioe
ccz: clt
bsb: bqr
iei: ipn iui
aov: ivx izo
khr: rpy rmd bmm bqy cly
ipj: iqx
iab: iww isb
ctm: ayn irs imb inj
bnt: btl
bkh: bye blt bvc bxn bpl
arj: air ied
klx: ksq kex rcm rlo rgy roj bxz but bog
bzk: bqn
bms: bos
ias: idr
bru: buw cyt
ama: ihm igl ixo iuo
axs: ieu iqs iug
ien: ixk
ktt: rcr riu rhh rjo bye byt bvj bfe
kuw: rge rfv rta bix
cmx: aiu aey aue ikv iyr imi ifz iqx itt
khx: kpx rsr bkt clr
ksq: rvs rnm rqc bba bng
bas: bhg
aza: ilr ivh imf
bxo: bzk cct
cjq: cuc cob afw icc iji
cmp: czv ajh avq irk ihh ixx imc hrw
cmo: cfz abd aic ahs avw asv anz ieg
rpl: bgx cri cbp
bql: ccy
kmk: riy rmc cwh
irh: ilc ixc itz
aga: atw iwa idg ivz
kpd: rcb rhp rwy bbj cla
bmz: cra
kdi: kng rkw bns bfs
ksj: kzt rjx bie cld
ica: isx
rcx: rdn rtf bay bhy bsn chj
rjs: rma cbk
keq: kpk knc rhp rgd rfk baf bqx crb crp
ruv: ruo bca bvw
klp: kwy kei kti kob rex rtt
rno: rzs roe
kna: rai rsh bac bqa cws
bfo: btk bog cav cix cyt
bny: bng
krv: kju kma kqv ryy rev rxy brx bfy
ike: iec
aez: iat ilx ipw izl
rkc: rgn rxy bfz cct
azo: aux idq
ris: rwo rpk roj bms bnc cyi
bke: bif bdk
cnf: aer amx azp auj izz
ryg: ret bwo bsj cad clv
rqm: bzo bum ccx cyo
ccg: chs
rku: bjx bqt bts cww
rlb: rmm blz bpj bfe cyf
bav: bqz caq chg
rzj: bbs bcy
kyq: ksc rtg bgw boc cam
bee: bxy
aid: ayh atw aui ihb iep
ijg: ixj inh
bfz: ccg clj cgi
add: ibf ihk igv
kxo: rfa roi ron
afz: ihb ihl iyj
axm: afc inw
bww: bex bze
czm: akj aio azv aqo isg
ivz: ixb ipe hkv
ayw: axp ikp ikz iri iez
rvg: blj bsc boe cwi
axt: aqp ibv
kow: rzn rtm ccb
rcr: rak rgf rtv
bqt: ckr cam
cew: awm aqo ino iud
atv: isd imn iff izh izz iub
kyt: ksf knj kzl rgq bxj
kia: kwh rhr roo bge caq cht cgi
inp: iuq
krq: kvq rid rsb rsm bir clc
czr: acm ahm adk asf ilt
kzx: kqd rgb bye bgs bqe
arq: aia ayi anf iiz ieu ine hkv
aaa: agd axr ikr iiw
kzw: rfe rzt rti rth
rkg: rrs rrm ryj bkv blc bpz boj
rtk: bvq bqf
iya: ijw ipa
box: cwz
bei: bpe cif
kjp: kva kvx ras rnm
riq: rpw rop
ihy: ili
cjd: cfe ajy aec hrr
rws: bzh btl chk
rlw: rpd ron roo brc brj cag cie
agd: igl
rwp: rdq rjo bji bnk
asc: aee azd irg ibp
czo: cuh aap aok ioa
rvz: rmh bww bts
cmz: cff abo aaq irg irn ieq iml
ahm: awj anx atz ilj ipn izi iow
rfu: bcq bvi bon
ioy: hkf
kxg: ryf rlp bya bej cdl
ala: awl adg avf axk auu icx
aac: awi asw imq
amo: hkm
big: cle
kan: rcl rwe rxf bki bjf bsl
amb: aqq aui auo idd
ami: azq igy iqy
ret: roq bik bxy bxv ccc
kxf: rls rtk bxd cya
kgn: kpm rcg rlu bat bht bfy
kip: kwt kek ran rtc bwv bxi crc
brc: baw cwa
kyy: klk kzi rwu bgv bdf bpz bmo cyw
bhe: bmx crm cig
bdb: bej
aeu: axm aor ily iwy hkd hrr
bzm: chi cwi cwg
clu: cgt
czu: cqd arc aem aqc irv ijv isr
klf: rwp rvd rnu cau
kpt: rnt bbv ccv chg
ajm: api izx itv
cqt: acd ice iia
alx: axj afw aue
avt: ilm ifv itc hkh
all: aec irz ibs iqf
aia: ahs ibk iit
ihl: hkr
ihw: igu itp ium hkf hrr
ips: hke
kpz: rbl rtn brg bvg bpk cbg
crc: cyh
rvt: rzv bru bhw bsl bev bzr buu cbu
afr: aqr
bjm: bpd bfo
asq: igf ijy ioc hrg
kvi: kug bit bec chh
rhu: bih bhx bnj ckh cry cgs
kxq: knd ktv reo rxz bnl
bkk: cle cgv
kiu: khj kyq knv rie bwz buu cry
rbt: rsd bme cla
coq: agq azk iaq idd ixq
kla: rjc bde bsj ckk cgo
kxu: kzg rly rxq bwa cac
knk: rcr rwe bba ckj cii
csw: cuw agc apx ivg
bdz: bsk ccr caz cyd
bao: bqa bth ckv chx
ahp: atu ird icl icj ido
bvh: bxy btq
bgv: bsd
rfc: rod bkt bwf cyh
bja: bsd btu bod cbs cbm
bsd: bml cbh
ikj: iyq
bgb: boy bop cca clh cgt
ieb: ifz itz
kii: khb kpz ryk rpg bse ckp
kky: rru bar byv bfv cih
kgz: kos rqx bii chw
kpc: brd bbg bfb clj
kbd: rxp rmb rtj bbv bwo
aha: irh ijr ime inl ind itl iul
cop: akn abk aqm ide iue iuz
rce: bec cav
kaw: kdk kei ryk byb chb
ros: bpr bph btn
bwa: bdd bsq bey cyy
irx: igi
rrf: rxn bcl btb clg
kwr: kpe knu rcn rfx bcc bdf
aws: anm irk ibl igb igd
cxa: ara iru iic ilz itk
aas: apg ibe ivc ifg izb hkb
axi: apc ivt ixr
kvf: kqh bdh cko
age: afh aun
ctu: asf aoq imx hra hri
rui: bcq btw bof cbf
kou: rdr
kjf: kfk kuo cie cld
itw: itv itm hrd
kak: kij khz kjw kmn raq rpu bib cda
cox: abz aem imh izd
bwn: bxe bng
kbv: kwh kvh kvt kzk ron bbl bgs
bhv: bfq cay che
ruy: bfx bqk
bdq: bmi cwl
kxv: rnm bdy buk
boe: ccc
itf: itq
aiq: icc iwf hkm
awh: iia ied
apl: aua auo
ahl: avz amo afv azi aqt
aes: axq icf ihp iey iep ioh
kgh: rhf rva bkb bzk cbj
atk: iwv ivm imd
iqo: hkb
ilc: igs izk
atz: iiv
rtj: bbd bxc cwr
rua: bit bqg
rcw: rqo bcb cad
rii: rtw byz bgu bvi bql cyp
aak: agm ijz ipn
cjb: cmc cmi ape ish ixa
iin: ihx ino its iun iuf
ryx: rsy rne rug
kzi: kzj rmz bvg cbu
afk: afp iai inz iuv
kgb: rrj rjz ckq
bpd: bni btx
bns: btk cll
aej: aev att iyf ipc imz
bxf: bqo
ith: itv iow
knq: rbu rle rjl blt
ixs: iuq
kmn: kne kur bxl
ikb: ikm isw
awb: avi aea azs aoa aos iau ilu idq
kmc: ray rwa rfd bry byk bsj cgi
azg: ike ibn izt
kfc: rgi bif bef
rmd: rzg bhv ckw
bhn: cbl
klm: kej cbu cgi
cqv: avk ana iam
rwn: rdl rnw roe btf cbs
ktn: rsq rny ruq
rwl: rni bck caw chg
bim: bvo crx
ijd: isy ipn itx iuw
auo: ibs iup
cvx: cvm iaq iim ijr
rxc: bif bgk bsn bur chh cwd
klb: kwv kfu rtq blo bxc bmh cck
auz: idy iqy ior hrb
rxq: rqn bwy clr
rtv: bip bdu bnx ckt
bck: bgk
rln: brw bch bik cit cle
rfe: bby
ruw: bkq blr bpg ckg
kte: rco rpk rme run bir bhi cwr
iwn: iwu idu
bth: clv cgr
bhd: bhu buw cgz
kue: ria byj bos crm
rbf: bbh
ckw: cls
cnd: cfm cqr aph ika isl iqk
kkk: kss kqr rki ryk rlr rsk bhm cko cbe cwj
ief: ixx ixn iff
ajg: iie ihd inm ifk
rue: cdb
bmw: bts bot
cue: coq ahz ayh ilg ixn
kkx: ksa kor rrl bqj cwd
ahz: aqz iaz
rfn: brs bir
rzi: bss bef bfj bos caj
bqh: chv
ary: aio aqc ite
icx: imu iqp
azt: ike iec iez ips ipf
klw: rji rtr bkp bip bmq
cxz: axc igg ipb
akv: aai aam auv irm ibh iiv
acq: aau asj axx apn aou ilg igg iqv
ihi: iww ien
kre: kjh kzo rvg rmu rzk bdm cye
ruj: bvk bqh cad cik
kze: kug rai bwa bnm cyq cda
rrm: rhi rgm rwj rvs ccj
kml: kfx rez bta chw cga cgh
auw: iwy ipr
cdv: cjk cnn cuc cuh ayo iju hkk
baj: bmo
cxj: cxv czj coy akq iah iml imo
rdd: rmx bay bwu bzw cbv caw
kns: ktf rcf brf chs
bli: bel
aec: azx iro ija hkm
byo: bvs buc ckg
ayn: avg anf aqr aou izp
cih: chb
kfu: rgq
rti: beq bqr bup
bmg: bqu
kpe: rck ryu rng cwz
bpu: cyk
cdn: cjp avi apc ape amg ica ihw
kce: rcb rxr bey chq clr
cdq: csq cmr czc agd afg iaj iuv
cjw: agw ade asy ibv iii inl
rna: bmu ckr
cva: csy ctu con arq
roc: bin bsc
ily: igx ids ipa
rrv: bbw bfe ckd
ccl: chm
aoc: ikg igi izj
rfp: rzk ccv ciq
chr: cng
rze: brc bmx chh cgd
acb: act int
ipt: hkk
atg: ikf iey
apg: ibj iqt
rnx: rot
rhc: rxx clz
kgl: kot run bbr bvg bzk
iyy: imu
iiu: igh izb
cab: cin
cbg: cwj
ajx: iyl ijn
rzw: bdg bzu
byi: ckw cac
kdw: rgn rep rma byo bzq buz
cxx: atv iix ieu iup
cve: akc awq ass apo ibs ivy img imz iqo
ako: ayy ayv ajk isz
cmd: anc afp iiz
bxn: crl
kab: kvn rek rxr byn blh
rpv: bak ckz cic cix
bce: bas baz bmc
czd: arj alg avv iht idk iun ioz
cxd: cmj cti arg avk amw ifb izm
aio: amr anr
ikc: iax iuz
abm: awo apq azt ijy
bbu: bsq bzw cbv
anv: ikr iyr ixv
iox: hkn
irr: iwr
azv: ixv ifj izr
kqd: koj rkd rww bbt cht
csc: cqz axl afo iah
afb: aue iaw igq ifc
cpr: ctb iix idg ijv ixu
ryt: bcm bcn bek bps
ihd: ixd ipf
azx: aqd aqu icl iac ihu iqi
ikw: ixp
rys: brf bpy bpv bzl
axa: afz aoe ivn imv ioo
rbz: rtn byi bll bxo bmy
kps: rjo rej rfg bdz
air: ayf ayo axp amr atg icc izy
raz: rwr rqm blh bdf bfk bfq
rlv: bbx bvk bmq
avf: iir ihn ivi
abj: acm avz aqm ied iou
azp: iwk ixz
rxi: bga bxb
byg: bdc chp
aax: ahz ilx iwq ift
rtl: bzk cbp
iid: ihz iew
bhy: bnm
cxe: cuv ada afi aun ics ivq iuw
kqw: rgb rpr bvh
kmf: bzf btj chd
cpx: cqc acb afi idd ixu
ipz: imw inw iqk
bpj: ckl cia cii
csn: cuc arm avu ibf idx idn ion
cde: atz ibq ieq hkh
akr: ahf iwk img hrw
kqh: ktj bfj cbt
rcg: rvk baq boq clc
kzy: kqf rpd biq bhc cbj
ivq: ioh
klj: kfg rlu bif bpy bqt
ail: ajr iyv imd ind iui
bgp: bjh
bwq: bur clc
hks: hry
bvl: bqt
rtq: bzl cry cyo cwf
ikr: hrd
rkv: bkc bro bce bzp cao
bge: bdc ben bto cky
amv: ivl iqk
bzh: crn
czs: czt agq ifa
rld: cih
rcs: rtk bkm bca bfg bzv
bva: cch
ame: ant igx igp ivm
kco: ric rxq bbz boc clt
ctw: axn ily itw
kaf: kqf rgf rjv rnh ckx
kuo: rxh rpu ruj bgj cla
reo: bws beg bop ckf cau chi
kdr: rjv rzm btx clx
kud: rfs bjt clt
bxb: bnh
rvh: ruq brk blu bnx
ixn: ipj ioz hkn
ivy: ioh
adh: ibf iae ief hkj
kyk: rkc rbt bcx bln bdl cbg
koe: rat rim bvr bsi bmh cyt
bpz: caq
bab: cyu cdl
rpj: rzg bre bxl bnv crt can chn
czt: cqw ihw izu
aly: ato inn hka
kkr: kfq kqd kqs cav cas
khh: kmi rbw buy crf
kwe: kvy kzf bvf bem bfm ciy
bct: bza bup cku
bdh: cae chw clm
bfw: bot
blw: bvk beb
akh: aym alr ium
rzu: brj bzd bow cld
kpf: kmf kql kuv rhn rpy bjn bvu
raq: rit bhb cim cgo
ibk: izd hrh
kaq: kmr ktu rku bdl
rov: biy blk bjk cbm
kee: kqs rbk ruw brv caq
bqv: bur cwx
cvq: abz aho ans aqz ilw ims imq itg
bil: bvr bzm buw ccq cdr
rex: bby bca bwf
ifg: izl iqr
asf: atb aot ibd iyx iwc
bzt: cyb
ifc: iug
cur: avh ash azi ipc ipf
icb: iwf iej iem ixq
khy: knq rwm rfy clb
aeg: axw ivp iql iqq
imk: itk
byx: bdi bqm clr cgw cgm
rya: rpi rnn bki bal cil cgj
agk: aqw ick inj
rho: rnu
kka: klb rih rmx blg bfp bte
ajv: azo ikw iup
cjp: cxd avs asl ixf imq ifo hky
cnz: adr avo ibh iwf inh
kec: kxa kuy rkj rgf rnq bxc btz bol cdh
ang: afg iax igm iqu
ipa: hkd
acn: aow ikf ibe
czi: cql axx ams amp aow ikn ipd
iyq: iea hrl
rpe: bgl bpb bnj
bwu: bjv
cfn: ahy auo ibc icq ivu hkk
bef: box
axx: ief imj ine ioo hrd
bds: cgn
bjl: bvg cro
acy: awz adq ajf axx atx
rct: rpw bcc bmw cif
bfh: buj
ibj: ihp iht
aqd: aqo
cjo: csa csi ack axu ivk ioi
cuy: iiq izh
bso: buq
rom: cki cbk cbw
bud: cim
axh: aog iyj iyz ish
alv: afc aqi izt
ahh: aty irh ivg ifs
kgr: bgw bgd bdy btz cgr cwp
kjy: kjp kvw kzn rbo baq bhf bvw bxo bzy bqg crh
kvx: bgy bqj
ikk: ikg ivl
aqy: ikx icr iyo
azi: aqh ihz itl
rrk: rxg cby
kmv: rlk rdw rvs rtn bgf bwf bjx
bly: bnt
krz: ryp rpr ruk biv beq cav
acm: aty ifi izu
ifw: izb
bgj: bea cid chs
khk: bcy bhw bwd bvv bsr bmw bui cwc
rye: rdk rvg rmu byv cio
ikg: iza iqe
rqx: bhe cbz
rqc: rqt ccs
afj: iwv
rdg: bkh byb btb
rnr: bwx cwz cdi
baa: bjp chw
cnv: aak anx aqc igi iof
iae: iwo
ron: bdi beu cgz cdr
ktw: rbz rbu rlj bzi bqe
iks: ibz iyp ifo
iru: ivc inz
rha: rlv ros bib bmm
bie: bjy bpm bmk
aip: auz icc igf
aqu: igf idc ijp isl
agv: and
rwo: rqf crr clk
czl: ain ael anu afh afn idf iev
rsd: rzs bqd btj
cfq: cza anh aqj ihe ien ixg
bqb: crx chs
rgf: rsv bwx bzi
kwk: kuu rvl rsc rpd rqv rts bhz cat
koi: rdv rvs ref bad
kyz: rle rdd rfo rzh rtm bya bjd bfg ckm
irf: ieb iug
bhg: bga bmy bne bzh
axf: anl ikb igi
ajp: and iwm iwq ivo
bkm: bjg cwu
rjj: rps rzv bar
kmg: rcc rzt bfc boj cyc
bda: bxl cgm cgq
akd: abx aww adk adp asq amc irf iwc
kts: rap bgs ccl cag
kbj: kpo rii rld rjq bxz
iaz: iiw ixn hke
ikf: ifp iui
agc: aou igj
abw: ayc axq ani ikh iyt iws iqf
ard: aac alt ano iek ipg
bij: bhb bmw
rwy: rzm bdu
roh: bdo
iqi: iqm hrb hry
kzp: bjt bpl chd
auu: iki ipq
byy: bjw
cpy: akp ahb idp iua
agw: iiv ilv iqt
awk: axb iwx
ksa: ryq bzp cah
kbp: kll bve bpc
igq: idz
kbz: ken kov rkf rrk rdx bmb bfr
kvg: rje rzd cab cga
apc: and atw aum iqp
ikh: iij iwx ivw ixe inc iok
ayb: afw itu
kgi: kts rco ryy rfc bcz bjq bfb cin
bdt: bny
bfl: ccb cym
cto: acn aif awl awe ajw isj ixt
iea: iee
kwo: kpc rqk bea
kon: rag rzm biq
rfg: bgz bfj
rxx: bii bdj bfc
khd: rao ryr rjw bai bwd bdl cwt
btg: bob cbe
ksm: kso brb bbs bix bns
ife: iok
cna: ayv apm azp iwg ifd hki hkq
bjx: cbo
bbr: bbt bwk bxr
ils: isy iof
biq: bhg cko cii
cvh: csk cmd cty aly adg ajb ajx auy
afq: ihx iyz ilm hrc
rhj: brs blz bgo bxs bma bqv cgt
kds: kol rlw rjk cgn
rfo: bic bsg bzb cwc
ijn: ivl ipi iqp
klc: rik rse bkx bch blp cwj
rzs: bnb
rcj: rdn rjr bap bli
rka: bro bup crz cbu cij cli
cqw: aze ikj igs
asl: apo afp irz ipj
adp: avu ane afd aoy idb ist ixw imu
kut: byg bju
roj: ccy
kqz: koi rlj rqw bhg clq clt
rhl: bfh cch cgf
rak: rsa chm cdk
atb: ilp
kog: rnj bib bfl chg
kub: rrp rij rqe brw beo bmn
bzg: ckq clx
rbb: rfu bae bed bun bof cba clx clo
aiw: avb asx ica iid ihw iqg
ryq: ruc bly bdx bnv cao
iww: ing
cou: ark alg agx afx
bks: bai cld
bmk: cle cwg
rgp: rox bka ckd ccv
aps: ire ijb ifk
rhm: rvg bxm bxf cbk cgi
cnn: aou ivg
rdz: bbt bdj bvn crp
cvk: aaf ayp ajt apu atm irx igj ieg
kvj: rxh rxp bwh cbp
khq: rev bmz crz
ayc: ala amj imq
akp: ash apk aqz hkn
rhe: rvy rpr bjc bej cic
bbf: bwo bfe
rmb: bls bwv bjp cco
iaj: isa ixo
kqk: rrh rau rwg cwl cwn
rqg: cwu
amy: azu ijq isq ifg
rwk: bps bfc chc
bpn: ccj
cek: cqm aty auj itk itx iod
kbr: klq bkg bwx bfv
arn: ajj ihg iyv inu
aam: awk auh ian idi hkn
bqk: bux cdy
ctr: ctp awj icj iwj isi
iho: iun
boa: ckw crt cgd
ced: asn igh inp
abi: asi azr iao ipo
ian: igv idb iqd hku
klo: rap rij bfr bfe cyi
bqu: cbb
ams: iwv ifu iza
cfu: cuq akt arr isn
bbn: bim bue
rqb: bff ckk crs cbt
rsm: rec cri
kvu: rou baq bio blo bfi cry
aef: axw atn aut iku izc
irz: iuz
bqg: cak cim cwf
bnp: ckh caz
kwp: kxe kmi rin rdk rpv buj bou
bng: cio
rfh: rox bbu blt bsb bno
kuj: rnx bsj bzq bty
cvb: ceb cxn ahq awi awu ajx ano atp iyi iez
rnb: bik bme
rub: bgm buu clv
cpw: cfb ajp avh axb iax isl ieb
aui: ike ivl iet
axc: amg
bbq: bpn caw
ree: bli bmu
kjw: kut rvd bhu crk
rqy: rqu roa
rng: rzb bax clv cgc
ivk: iug
klq: rdt rfv ruh bgj
cvw: czs aah icn idy
kom: rdx rpc rof bha ckj clq
czx: cot alu amk ive isw itz iod
ifn: itc
ciz: cyf
krk: kmx rhc rdh bcb
cxn: ajh asr aoj ipj ifw
idf: int
rah: rje bfu bzg
cxw: cuk ilq ido imu iqe
kat: ksp rjf bqr crl
ktl: ryl rwn crt
igf: ivu
bcw: bsd chd
kof: cyc
iyw: ige iec
iem: hrw
aof: ije ijp ieu ioe
kpm: rmo rnx rua biq byn bxh bmo bou cgt
ivn: ize itb
azd: aql ikr ira ifk iqk
bye: bjx bod
rqr: bhg bub
kbo: kzu kos rrp ris bxj
bxr: cra
bbe: bhe byq bsf chp cgo cwg
kvc: kuy rbe rpb bty
cnq: ayb ayc aqr aoa iwy iju iee
ihp: ivk izr
iys: iwm ieh ieo iuo
bpg: bpv
csm: cxs all ajo axu ami anp itk itd
rwv: rdf rsi rma rzf bbk
itg: itq
azh: aok aoj
bfb: bup cas
rrz: bdu bxr bmg cbb cyb
rnh: cyz
cbc: cyg
aey: ivv isv ixb izn iua
bla: bql cbb
iuw: hkf
ijq: imf ifp
rat: rnt
bdw: btt
bzu: chc
res: rqf
bex: ciy
rla: rsw rti brb
kqe: raj rgc bhs bwr bor cgn cwl
cud: cuo arv aan iam izi izj
iqt: iov
apk: igj ied ixy
cap: cat cgb
kvo: knv kuy rrc rtl bkq bpm cbd
auv: irt ibt igq imd hkl
kfj: reu brr cic
apj: azg iva ixr ipk
rcv: rwu rjr rnb bqy cye
icq: itv
awg: amr aok izq iqa
ill: iuc
igo: idj imw
iwi: imx izl iqk
kgd: kdv rrk rwh rmk ruq bxe bov
bkf: bro bpu ckw ccy cyg
rab: rnc bhj bgh cay
aen: aoj iba
aod: ikx iof
ahr: irb ilk
kjz: rpf bjg ciy
ish: isx
cnx: ake abp ijx ivu
ixu: hry
rrc: rpx bip cbh
ago: ikj ilj ivr
rgq: rfn bdf crb
kvb: rrc bbn bdc btw
rlu: rur brr byj bsu
bon: cgl
ada: asb atj iaj iuf
alz: aja amz ikc ibo ivo ino itq hra
afv: itb ioa
cfi: azb ikr ice iam itt
cjk: cxb iaw ijr isy
bcl: bfn
knz: rgd rdz bsv bma cai
kbn: rbu rgp rvj byf
cvn: cen iha ivw ieb iqd hkt
cvi: ald agm ams aqv igt
rbq: rcr rwk bry bpi
kyj: kss kzr bsz bpx ccc cyv
bjs: cbo
reu: bku bhb cam clb
apq: ibb iat iem
cnp: arb azy ikm irx ibk ioi
bap: bwl bdz
rrj: rwp req rmq biw bec bol
kpn: ktc kuw rwh brb bcl bjt bmj crg
imy: ifc
rgk: rjo rva rnc rob bvq bpo
bcq: bsp
rlf: reg rpe btj
ags: ada ajr azv ida
kgj: rwg rmi bel
rto: bhg cyr clo
kle: kju bbs beg bxc
cny: awc aos irw iez ipw hkq
ihb: iwv iqj
rss: rnb rtn brj bal bei ccz cia
